,imdb_id,movie_name,release_year,audience_banded_rating_count,audience_rating_count,audience_liked_count,audience_not_liked_count,audience_review_count,audience_avg_rating,audience_score,tomato_banded_rating_count,tomato_rating_count,tomato_liked_count,tomato_not_liked_count,tomato_review_count,tomato_avg_rating,tomato_score
0,tt1694542,Tanu Weds Manu,2011,Fewer than 50,4,3,1,1,,,,0,0,0,0,,
1,tt0366450,Five Children and It,2004,"10,000+",12728,212,290,231,3.1,42.0,,8,5,3,8,5.40,63.0
2,tt5465142,The Lawnmower Man,1993,"25,000+",47187,616,1374,777,2.8,31.0,,41,15,26,41,4.80,37.0
3,tt0085706,I Am the Cheese,1983,500+,676,14,26,20,2.9,35.0,,3,0,3,3,,
4,tt1198186,Ayat-Ayat Cinta,2008,"1,000+",1124,89,30,77,3.9,75.0,,0,0,0,0,,
5,tt0099021,Always Remember I Love You,1990,0,0,0,0,0,,,,0,0,0,0,,
6,tt0096237,Tears in the Rain,1988,500+,588,14,7,9,3.4,67.0,,0,0,0,0,,
7,tt0816530,Imprint,2007,500+,514,62,44,51,3.5,58.0,,0,0,0,0,,
8,tt1095442,Goodbye Solo,2008,"2,500+",4940,919,206,389,3.9,82.0,,108,101,7,108,7.80,94.0
9,tt0371746,Iron Man,2008,"250,000+",1086677,223568,22505,83035,4.3,91.0,,281,263,18,281,7.70,94.0
10,tt1278180,Kenny Begins,2009,100+,158,9,23,10,2.9,28.0,,1,1,0,1,,
11,tt0100722,Sweet 15,1990,500+,657,10,25,15,2.4,29.0,,0,0,0,0,,
12,tt0171804,Boys Don't Cry,1999,Fewer than 50,37,7,1,0,4.1,88.0,,0,0,0,0,,
13,tt0110818,Pet Shop,1994,50+,55,12,7,9,3.4,63.0,,0,0,0,0,,
14,tt0465494,Hitman,2007,"250,000+",306589,25605,19653,18993,3.4,57.0,,105,17,88,105,3.90,16.0
15,tt0079278,Head Over Heels,1979,100+,128,19,2,6,4.1,90.0,,10,9,1,10,6.60,90.0
16,tt0262810,Tata Manavadu,1972,0,0,0,0,0,,,,0,0,0,0,,
17,tt0960792,Spirit of the Marathon,2007,500+,661,152,17,89,4.2,90.0,,8,7,1,8,6.60,88.0
18,tt1291051,Bam Margera Presents: Where the #$&% Is Santa?,2008,500+,725,117,102,82,3.3,53.0,,1,0,1,1,,
19,tt0299135,The Civilization of Maxwell Bright,2005,500+,510,43,19,33,3.7,69.0,,3,1,2,3,,
20,tt0281941,Juan Colorado,1966,0,0,0,0,0,,,,0,0,0,0,,
21,tt0259393,Lantana,2001,"5,000+",7504,1134,247,403,3.9,82.0,,106,96,10,106,7.50,91.0
22,tt1133993,Serious Moonlight,2009,"2,500+",3261,274,815,352,2.5,25.0,,38,9,29,38,4.00,24.0
23,tt1107816,Giallo,2009,"1,000+",1121,66,406,196,2.1,14.0,,1,0,1,1,,
24,tt0057162,The Householder,1963,100+,103,12,7,11,3.6,63.0,,2,1,1,2,,
25,tt0494864,Tenderness,2009,"1,000+",1779,159,557,231,2.5,22.0,,15,6,9,15,5.10,40.0
26,tt1674708,Ivory Tower,2010,50+,50,10,6,4,3.5,62.0,,0,0,0,0,,
27,tt0811007,Perarasu,2006,0,0,0,0,0,,,,0,0,0,0,,
28,tt0436091,Backstage,2005,"1,000+",1067,45,30,17,3.4,60.0,,21,15,6,21,6.20,71.0
29,tt1378320,Poi Solla Porom,2008,0,0,0,0,0,,,,0,0,0,0,,
30,tt0246460,Die Another Day,2002,"250,000+",430570,6940,10191,12247,3,41.0,,226,124,102,226,6.00,55.0
31,tt0282628,Jan Dara,2001,500+,619,43,82,42,2.9,34.0,,2,0,2,2,,
32,tt0760188,When Nietzsche Wept,2007,"1,000+",1268,205,152,138,3.3,57.0,,1,0,1,1,,
33,tt0106936,Fong Sai-Yuk,1993,"10,000+",11430,870,171,216,4,84.0,,9,8,1,9,7.20,89.0
34,tt0094746,Biloxi Blues,1988,"10,000+",10053,679,408,259,3.5,62.0,,28,21,7,28,6.50,75.0
35,tt0448179,Wild Things: Diamonds in the Rough,2005,"2,500+",3098,82,260,123,2.5,24.0,,3,1,2,3,,
36,tt0103111,Hard to Die,1990,"1,000+",1669,33,29,36,3.3,53.0,,4,2,2,4,,
37,tt0313911,Agent Cody Banks,2003,"250,000+",418396,1461,3173,4533,2.7,32.0,,103,39,64,103,5.20,38.0
38,tt0318680,Sethupathi I.P.S,1994,0,0,0,0,0,,,,0,0,0,0,,
39,tt0292123,Moonnam Mura,1988,0,0,0,0,0,,,,0,0,0,0,,
40,tt0073901,The Wilby Conspiracy,1975,"1,000+",1005,34,41,21,3.2,45.0,,6,4,2,6,6.00,67.0
41,tt0246460,Die Another Day,2002,"250,000+",430570,6940,10191,12247,3,41.0,,226,124,102,226,6.00,55.0
42,tt1500815,Jag Jeondeyan De Mele,2009,Fewer than 50,19,4,0,0,,,,0,0,0,0,,
43,tt0114857,Virtuosity,1995,"25,000+",30329,639,1391,629,2.8,31.0,,34,11,23,34,4.30,32.0
44,tt0225434,Coven,2000,100+,166,19,32,22,2.8,37.0,,7,3,4,7,5.40,43.0
45,tt0291311,Lil' Pimp,2005,"2,500+",2753,115,27,54,4.1,81.0,,1,0,1,1,,
46,tt0106307,Arizona Dream,1993,"25,000+",25476,4095,646,746,4.2,86.0,,15,13,2,15,6.80,87.0
47,tt0924262,Okkadunnadu,2007,100+,154,3,1,0,,,,0,0,0,0,,
48,tt0215679,Cowboys and Angels,2000,250+,311,23,15,8,3.6,61.0,,0,0,0,0,,
49,tt0076798,Tarantulas: The Deadly Cargo,1977,100+,201,4,26,9,2.3,13.0,,2,0,2,2,,
50,tt0468489,Half Nelson,2006,"50,000+",56645,12355,2627,5426,3.9,82.0,,159,145,14,159,7.60,91.0
51,tt0314938,Zakhmi Sipahi,1995,0,0,0,0,0,,,,0,0,0,0,,
52,tt0100904,Watchers II,1990,500+,506,9,33,19,2.4,21.0,,3,0,3,3,,
53,tt0113530,Karuththamma,1994,0,0,0,0,0,,,,0,0,0,0,,
54,tt1975210,Malai Malai,2008,0,0,0,0,0,,,,0,0,0,0,,
55,tt1178642,Cyrano Fernández,2007,0,0,0,0,0,,,,0,0,0,0,,
56,tt0338216,Lucky You,2007,"100,000+",207260,1701,4378,2937,2.7,28.0,,141,40,101,141,5.00,28.0
57,tt0343788,The Hillz,2004,"2,500+",3433,58,115,107,2.3,34.0,,0,0,0,0,,
58,tt0120703,How Stella Got Her Groove Back,1998,"25,000+",31369,991,511,630,3.7,66.0,,50,25,25,50,5.50,50.0
59,tt0102164,Johnny Stecchino,1991,"2,500+",4247,618,108,179,4.1,85.0,,13,6,7,13,5.20,46.0
60,tt0871867,Half Past Dead 2,2007,"2,500+",3207,113,125,104,3.1,47.0,,0,0,0,0,,
61,tt1891755,Billa 2,2012,250+,335,117,95,47,3.4,55.0,,0,0,0,0,,
62,tt0114089,Parallel Sons,1995,250+,296,5,10,4,2.8,33.0,,3,1,2,3,,
63,tt0984204,Love Lies Bleeding,2008,"1,000+",1756,99,218,155,2.8,31.0,,3,2,1,3,,
64,tt1043787,A Beautiful Life,2008,250+,472,109,54,36,3.6,67.0,,3,2,1,3,,
65,tt0085656,Heart Like a Wheel,1983,"1,000+",2173,72,16,35,4.1,82.0,,10,10,0,10,7.10,100.0
66,tt0065775,Getting Straight,1970,100+,131,11,16,9,3,41.0,,9,3,6,9,4.90,33.0
67,tt0091972,Slow Burn,1986,0,0,0,0,0,,,,0,0,0,0,,
68,tt0819810,Traffic Signal,2007,Fewer than 50,12,1,3,1,,,,2,1,1,2,,
69,tt0077921,The Medusa Touch,1978,"1,000+",1396,154,58,71,3.8,73.0,,4,3,1,4,,
70,tt4192214,Rang Milanti,2011,0,0,0,0,0,,,,0,0,0,0,,
71,tt0367136,13 Dead Men,2003,100+,138,9,4,7,2.9,69.0,,0,0,0,0,,
72,tt0103626,Afterburn,1992,100+,229,13,10,4,3.4,57.0,,1,0,1,1,,
73,tt2158504,Kimmy Dora and the Temple of Kiyeme,2012,Fewer than 50,31,7,9,5,3,44.0,,0,0,0,0,,
74,tt0073172,Inserts,1975,500+,613,46,37,29,3.2,55.0,,13,9,4,13,5.80,69.0
75,tt0238463,Timequest,2000,250+,486,5,3,4,3.2,62.0,,0,0,0,0,,
76,tt0054717,Canción de juventud,1962,0,0,0,0,0,,,,0,0,0,0,,
77,tt0090683,Babes in Toyland,1986,"2,500+",4808,273,273,208,3.3,50.0,,0,0,0,0,,
78,tt0118577,An Alan Smithee Film: Burn Hollywood Burn,1997,"1,000+",1838,23,133,62,1.8,15.0,,38,3,35,38,3.30,8.0
79,tt0840322,Forever Strong,2008,"5,000+",9904,938,320,368,3.9,75.0,,21,6,15,21,4.60,29.0
80,tt0369516,Hawa,2003,100+,102,2,6,2,2.4,25.0,,0,0,0,0,,
81,tt0058467,Phoolon Ki Sej,1964,0,0,0,0,0,,,,0,0,0,0,,
82,tt0138946,The Yards,2000,"5,000+",9006,734,696,288,3.3,51.0,,98,63,35,98,5.90,64.0
83,tt0098383,Staying Together,1989,"1,000+",1293,29,25,17,3.4,54.0,,5,4,1,5,5.90,80.0
84,tt0082474,The Great Muppet Caper,1981,"25,000+",35265,1688,467,801,3.9,78.0,,27,21,6,27,6.50,78.0
85,tt0790721,Normal Adolescent Behavior,2007,100+,136,13,30,6,2.9,30.0,,0,0,0,0,,
86,tt0088454,Zombie Island Massacre,1984,500+,873,6,36,20,2,14.0,,1,0,1,1,,
87,tt0079136,Fast Break,1979,100+,144,22,16,6,3.5,58.0,,4,2,2,4,,
88,tt1606392,Win Win,2011,0,0,0,0,0,,,,0,0,0,0,,
89,tt0080645,Don't Answer the Phone!,1980,"1,000+",1726,21,98,63,2.3,18.0,,1,0,1,1,,
90,tt0112495,Beyond Rangoon,1995,"5,000+",8047,263,106,111,3.7,71.0,,34,12,22,34,5.00,35.0
91,tt0318155,Looney Tunes: Back in Action,2003,"50,000+",63703,3701,3734,1384,3.3,50.0,,136,78,58,136,6.10,57.0
92,tt0091338,Killer Party,1986,250+,452,35,58,39,2.8,38.0,,1,0,1,1,,
93,tt0119506,Lawn Dogs,1997,"5,000+",5385,562,105,239,4,84.0,,18,13,5,18,6.50,72.0
94,tt0072181,Slipstream,1973,0,0,0,0,0,,,,0,0,0,0,,
95,tt0846308,Kit Kittredge: An American Girl,2008,"50,000+",52531,1405,642,891,3.7,69.0,,105,84,21,105,6.70,80.0
96,tt1185266,Stan Helsing,2009,"5,000+",6043,224,1011,419,2,18.0,,21,3,18,21,2.90,14.0
97,tt0066463,The Todd Killings,1971,Fewer than 50,2,1,1,1,,,,0,0,0,0,,
98,tt0131624,UFO: Target Earth,1974,50+,51,2,12,8,2.1,14.0,,1,0,1,1,,
99,tt0095532,Little Nikita,1988,"5,000+",5204,134,163,81,3.2,45.0,,15,8,7,15,5.50,53.0
100,tt0246722,Kaliyoonjal,1997,0,0,0,0,0,,,,0,0,0,0,,
101,tt1267319,Home Movie,2008,0,0,0,0,0,,,,0,0,0,0,,
102,tt0443272,Lincoln,2012,"100,000+",246125,48406,11719,8736,4,81.0,,288,258,30,288,8.00,90.0
103,tt0063426,Petulia,1968,500+,952,149,37,72,3.9,80.0,,14,12,2,14,7.80,86.0
104,tt0056142,King Kong vs. Godzilla,1963,"10,000+",10827,929,749,686,3.5,55.0,,21,11,10,21,5.10,52.0
105,tt0086066,The Outsiders,1983,"100,000+",138625,12268,2743,6349,4.1,82.0,,50,35,15,50,6.30,70.0
106,tt0475255,Dog Days of Summer,2007,100+,179,8,10,9,2.9,44.0,,0,0,0,0,,
107,tt0168794,The Five Senses,1999,"1,000+",1422,149,39,54,3.9,79.0,,34,25,9,34,6.80,74.0
108,tt0054446,Visit to a Small Planet,1960,Fewer than 50,18,7,5,2,3.1,58.0,,0,0,0,0,,
109,tt1440345,This Must Be the Place,2011,"5,000+",9594,1886,1371,494,3.3,58.0,,88,58,30,88,6.20,66.0
110,tt0055892,David and Lisa,1962,"1,000+",1061,145,38,67,3.9,79.0,,13,11,2,13,6.90,85.0
111,tt0113691,Losing Isaiah,1995,"10,000+",10162,741,276,377,3.9,73.0,,29,13,16,29,5.10,45.0
112,tt0111280,Star Trek: Generations,1994,"50,000+",70661,4437,3368,2481,3.4,57.0,,64,31,33,64,5.50,48.0
113,tt0861770,Fire Creek,2006,50+,82,5,6,3,3.6,45.0,,1,0,1,1,,
114,tt1657448,The Drummond Will,2010,100+,135,24,12,5,3.6,67.0,,2,1,1,2,,
115,tt0284525,Suddenly Naked,2001,100+,166,12,7,7,3.6,63.0,,6,3,3,6,5.80,50.0
116,tt1327601,Something Wicked,2014,0,0,0,0,0,,,,0,0,0,0,,
117,tt0109408,Cheyenne Warrior,1994,"1,000+",1826,14,5,8,3.8,74.0,,1,0,1,1,,
118,tt1772422,Outside Bet,2012,50+,65,7,17,5,2.6,29.0,,9,0,9,9,3.40,0.0
119,tt0101268,Across the Tracks,1990,"1,000+",2426,64,94,33,3.1,41.0,,0,0,0,0,,
120,tt1632708,Friends with Benefits,2011,"50,000+",81040,24090,12741,5235,3.6,65.0,,171,118,53,171,6.20,69.0
121,tt1965057,Run for Your Wife,2012,100+,137,14,33,17,2.1,30.0,,15,0,15,15,2.80,0.0
122,tt0202521,Passport to Paris,1999,"50,000+",54811,1107,1081,834,3.3,51.0,,3,0,3,3,,
123,tt0055902,The Devil's Hand,1961,Fewer than 50,22,2,12,4,2.5,14.0,,1,1,0,1,,
124,tt0156460,Defying Gravity,1997,500+,926,59,44,47,3.5,57.0,,6,4,2,6,5.90,67.0
125,tt0098692,Wicked City,1987,"5,000+",7252,355,178,168,3.6,67.0,,2,1,1,2,,
126,tt0117287,The Paper Brigade,1996,500+,931,159,75,61,3.7,68.0,,0,0,0,0,,
127,tt1273235,A Serbian film,2010,"5,000+",6086,1317,1776,1024,2.8,43.0,,31,14,17,31,5.20,45.0
128,tt0168122,Pirates of Silicon Valley,1999,Fewer than 50,33,27,6,6,4.3,82.0,,9,8,1,9,7.20,89.0
129,tt0064939,Satan's Sadists,1969,"1,000+",1508,22,20,18,3.2,52.0,,0,0,0,0,,
130,tt0262432,George Washington,2000,"5,000+",6215,957,172,382,4.1,85.0,,63,53,10,63,7.40,84.0
131,tt0320244,Party Monster,2003,"25,000+",36846,3617,1198,1973,3.9,75.0,,78,23,55,78,4.50,29.0
132,tt0076574,Providence,1977,500+,793,128,19,31,4.1,87.0,,10,8,2,10,8.10,80.0
133,tt0356803,Kunjikkoonan,2002,0,0,0,0,0,,,,0,0,0,0,,
134,tt0425350,Perumazhakkalam,2004,0,0,0,0,0,,,,0,0,0,0,,
135,tt0425350,Perumazhakkalam,2004,0,0,0,0,0,,,,0,0,0,0,,
136,tt0355742,Manmadhudu,2002,0,0,0,0,0,,,,1,1,0,1,,
137,tt1907668,Flight,2012,"100,000+",153606,39005,13290,6750,3.8,75.0,,242,187,55,242,7.00,77.0
138,tt0175756,Humjoli,1970,Fewer than 50,27,2,1,2,,,,0,0,0,0,,
139,tt0114246,Red Ribbon Blues,1996,0,0,0,0,0,,,,0,0,0,0,,
140,tt0094612,Action Jackson,1988,"10,000+",11101,243,506,291,2.9,32.0,,15,2,13,15,4.00,13.0
141,tt0485956,Outlaw Trail: The Treasure of Butch Cassidy,2006,500+,584,25,25,25,3.3,51.0,,2,2,0,2,,
142,tt0058384,Muscle Beach Party,1964,250+,297,20,31,22,2.9,39.0,,2,1,1,2,,
143,tt0098066,Parent Trap III,1989,500+,647,43,34,14,3.4,56.0,,2,1,1,2,,
144,tt0485183,Alli Arjuna,2002,0,0,0,0,0,,,,0,0,0,0,,
145,tt0409043,Grilled,2006,"5,000+",5046,115,418,246,2.5,21.0,,4,1,3,4,,
146,tt0059431,Marriage on the Rocks,1965,100+,243,23,23,16,3.1,50.0,,1,0,1,1,,
147,tt1153043,The Least Among You,2009,50+,87,7,12,4,3.1,37.0,,0,0,0,0,,
148,tt0054038,The Lost World,1960,250+,483,27,104,56,2.6,21.0,,3,0,3,3,,
149,tt0106204,Aankhen,1993,100+,222,7,12,4,2.9,37.0,,0,0,0,0,,
150,tt1535566,The Bleeding,2011,500+,612,7,87,27,1.7,7.0,,1,0,1,1,,
151,tt0327919,I Am David,2003,"5,000+",7245,1059,205,518,4.1,84.0,,33,13,20,33,5.20,39.0
152,tt0274959,Thodarum,1999,0,0,0,0,0,,,,0,0,0,0,,
153,tt0214931,Mast,1999,250+,290,11,15,1,2.8,42.0,,0,0,0,0,,
154,tt0072172,The Sister in Law,1974,Fewer than 50,48,1,12,6,2.7,8.0,,0,0,0,0,,
155,tt0292300,Ulladakkam,1991,0,0,0,0,0,,,,0,0,0,0,,
156,tt0420740,A Little Trip to Heaven,2005,"1,000+",2480,156,222,147,3,41.0,,6,2,4,6,4.70,33.0
157,tt0091278,Iron Eagle,1986,"10,000+",21217,600,464,471,3.5,57.0,,5,1,4,5,4.00,20.0
158,tt0871426,Baby Mama,2008,"250,000+",374766,13859,11168,11098,3.4,55.0,,166,105,61,166,6.10,63.0
159,tt0362902,Nayee Padosan,2003,Fewer than 50,9,1,2,0,,,,0,0,0,0,,
160,tt0085178,Ardh Satya,1983,50+,73,15,4,3,4,79.0,,1,1,0,1,,
161,tt0114306,Rumpelstiltskin,1995,500+,595,40,101,59,2.5,28.0,,1,0,1,1,,
162,tt0281905,Double Teamed,2002,"2,500+",4411,212,160,133,3.5,57.0,,3,3,0,3,,
163,tt0444915,Tathastu,2006,100+,100,0,3,0,,,,0,0,0,0,,
164,tt0338467,Stuey,2003,"1,000+",1094,91,74,69,3.4,55.0,,4,2,2,4,,
165,tt0055134,Man-Trap,1961,0,0,0,0,0,,,,0,0,0,0,,
166,tt0055058,Konga,1961,"1,000+",1688,11,67,34,2.1,14.0,,7,3,4,7,5.00,43.0
167,tt0844761,This Filthy World,2006,"1,000+",1736,242,42,145,4.1,85.0,,24,22,2,24,6.90,92.0
168,tt0119019,Dream with the Fishes,1997,"1,000+",1358,146,25,46,4.2,85.0,,44,27,17,44,6.10,61.0
169,tt0097529,Houseboat Horror,1989,100+,131,3,11,4,2.4,21.0,,0,0,0,0,,
170,tt0399530,Pyaar Ka Saaya,1991,0,0,0,0,0,,,,0,0,0,0,,
171,tt0119013,Double Team,1997,"25,000+",41701,459,1388,691,2.4,25.0,,19,2,17,19,4.10,11.0
172,tt1389781,Mr. Troop Mom,2009,"10,000+",16797,145,147,101,3.3,50.0,,2,0,2,2,,
173,tt0110613,My Girl 2,1994,"50,000+",69727,1511,1764,1464,3.2,46.0,,15,4,11,15,4.90,27.0
174,tt1351164,Hotel Chelsea,2009,Fewer than 50,1,1,0,0,,,,0,0,0,0,,
175,tt0388795,Brokeback Mountain,2005,"250,000+",520390,41156,8824,27157,4,82.0,,251,221,30,251,8.20,88.0
176,tt1132606,Ugly Aur Pagli,2008,Fewer than 50,2,0,1,0,,,,0,0,0,0,,
177,tt0387564,Saw,2004,"250,000+",853735,67811,13182,37366,4.1,84.0,,193,96,97,193,5.60,50.0
178,tt0387564,Saw,2004,"250,000+",853735,67811,13182,37366,4.1,84.0,,193,96,97,193,5.60,50.0
179,tt0080739,First Family,1980,100+,173,2,17,9,1.9,11.0,,5,1,4,5,5.50,20.0
180,tt0350811,The Diary of Ellen Rimbauer,2003,"5,000+",5612,130,129,145,3.3,50.0,,6,1,5,6,,17.0
181,tt0106661,A Dangerous Woman,1993,"1,000+",1242,23,51,19,2.9,31.0,,13,7,6,13,6.30,54.0
182,tt0799976,The Cats of Mirikitani,2006,500+,932,197,12,76,4.4,94.0,,26,25,1,26,7.60,96.0
183,tt1438216,Oranges and Sunshine,2010,"2,500+",3541,490,212,194,3.6,70.0,,73,52,21,73,6.50,71.0
184,tt1790886,The Campaign,2012,"100,000+",123296,19843,19256,4427,3.3,51.0,,208,137,71,208,5.90,66.0
185,tt0068364,The Cheerleaders,1973,500+,619,27,24,21,3.4,53.0,,1,1,0,1,,
186,tt0098206,Road House,1989,"50,000+",60422,3726,1873,2651,3.7,67.0,,46,19,27,46,5.30,41.0
187,tt0426501,Johnny Was,2006,"1,000+",1254,73,85,80,3.1,46.0,,1,1,0,1,,
188,tt0420356,Up for Grabs,2004,100+,237,35,5,13,4,88.0,,47,44,3,47,7.70,94.0
189,tt0292265,Swanthamevide Bandhamevide,1984,0,0,0,0,0,,,,0,0,0,0,,
190,tt0110997,The River Wild,1994,"25,000+",47012,1558,1462,867,3.3,52.0,,35,20,15,35,5.90,57.0
191,tt0085295,"Careful, He Might Hear You",1983,100+,134,24,5,9,3.9,82.0,,4,4,0,4,,
192,tt0452711,Never Been Thawed,2005,100+,233,26,16,21,3.3,62.0,,24,14,10,24,6.30,58.0
193,tt0084095,Hotline,1982,Fewer than 50,35,4,3,1,3.3,57.0,,0,0,0,0,,
194,tt0257516,Cursed,2005,"50,000+",55993,1211,2827,1848,2.7,30.0,,98,15,83,98,3.70,15.0
195,tt0465407,Eye of the Dolphin,2006,"1,000+",1997,107,78,87,3.5,58.0,,17,5,12,17,4.90,29.0
196,tt0055039,Kabuliwala,1961,Fewer than 50,49,5,1,1,4.5,83.0,,0,0,0,0,,
197,tt0088763,Back to the Future,1985,"250,000+",1097197,106004,6169,39791,4.5,94.0,,110,102,8,110,8.80,93.0
198,tt0363653,Grand Slam,1978,500+,576,55,1,26,4.7,98.0,,0,0,0,0,,
199,tt1321402,The Jack of Spades,2010,Fewer than 50,3,1,0,0,,,,0,0,0,0,,
200,tt1780762,Aftershock,2012,"5,000+",7076,406,1296,303,2.5,24.0,,55,22,33,55,4.70,40.0
201,tt0089304,Hot Moves,1984,50+,77,7,14,6,3.1,33.0,,0,0,0,0,,
202,tt1274300,The Tempest,2010,Fewer than 50,30,1,4,0,2.7,20.0,,6,4,2,6,5.20,67.0
203,tt0284655,WiseGirls,2002,"2,500+",3696,164,96,125,3.7,63.0,,9,4,5,9,5.30,44.0
204,tt0814314,Seven Pounds,2008,"250,000+",636785,34622,11591,22031,3.8,75.0,,193,52,141,193,4.70,27.0
205,tt0063532,Saathi,1968,0,0,0,0,0,,,,0,0,0,0,,
206,tt0094169,Tough Guys Don't Dance,1987,500+,686,37,41,31,3.1,47.0,,23,9,14,23,4.90,39.0
207,tt0082971,Raiders of the Lost Ark,1981,"250,000+",828694,76412,3544,26536,4.5,96.0,,151,141,10,151,9.30,93.0
208,tt0077743,International Velvet,1978,500+,534,71,27,23,3.9,72.0,,1,1,0,1,,
209,tt1514041,4.3.2.1.,2010,"2,500+",4260,509,697,313,3,42.0,,30,11,19,30,4.70,37.0
210,tt0091188,Heartburn,1986,"5,000+",5312,351,415,180,3.2,46.0,,22,10,12,22,5.60,45.0
211,tt0375154,Tristan + Isolde,2006,"100,000+",220982,12156,4886,8026,3.8,71.0,,120,38,82,120,4.90,32.0
212,tt0071733,Lacombe Lucien,1974,"1,000+",1869,307,53,87,4,85.0,,10,10,0,10,8.90,100.0
213,tt0412019,Broken Flowers,2005,"50,000+",95567,10942,4728,4169,3.6,70.0,,192,167,25,192,7.50,87.0
214,tt0080569,Cruising,1980,"5,000+",6295,659,702,416,3.2,48.0,,63,32,31,63,6.20,51.0
215,tt0190281,Britannic,2000,500+,976,34,42,37,3,45.0,,1,0,1,1,,
216,tt0412019,Broken Flowers,2005,"50,000+",95567,10942,4728,4169,3.6,70.0,,192,167,25,192,7.50,87.0
217,tt0162710,Trick,1999,"5,000+",6560,657,137,298,4,83.0,,24,19,5,24,7.10,79.0
218,tt0094939,Daffy Duck's Quackbusters,1988,500+,514,87,36,32,3.7,71.0,,1,1,0,1,,
219,tt0089649,My Man Adam,1985,Fewer than 50,32,0,5,4,1.9,0.0,,0,0,0,0,,
220,tt0078856,Beyond the Poseidon Adventure,1979,"2,500+",4249,54,198,112,2.5,22.0,,9,0,9,9,3.50,0.0
221,tt0284608,VeggieTales: King George and the Ducky,2000,500+,700,90,24,15,4.2,79.0,,1,1,0,1,,
222,tt0084666,The Shadow Riders,1982,"2,500+",2779,97,41,59,3.7,70.0,,1,0,1,1,,
223,tt0120591,Armageddon,1998,"250,000+",910034,50040,18906,32453,3.8,73.0,,177,76,101,177,5.30,43.0
224,tt0058437,The Outrage,1964,250+,371,30,45,33,3.2,40.0,,5,1,4,5,3.40,20.0
225,tt0063063,Here We Go Round the Mulberry Bush,1968,100+,101,5,17,10,2.6,23.0,,1,1,0,1,,
226,tt0256524,The Curse of the Jade Scorpion,2001,"10,000+",16557,1326,1174,455,3.3,53.0,,123,55,68,123,5.20,45.0
227,tt0471030,Red Road,2006,"5,000+",8275,1207,495,705,3.6,71.0,,90,78,12,90,7.20,87.0
228,tt0098577,Vampire's Kiss,1988,"5,000+",9098,754,644,531,3.3,54.0,,31,20,11,31,6.00,65.0
229,tt0349154,Bodysong,2003,"1,000+",1279,108,27,48,3.9,80.0,,10,8,2,10,6.90,80.0
230,tt0116828,The Last Days of Frankie the Fly,1996,"1,000+",1292,28,34,21,3.1,45.0,,2,0,2,2,,
231,tt0134619,Disturbing Behavior,1998,"25,000+",45344,740,1126,706,3,40.0,,39,13,26,39,5.10,33.0
232,tt1601818,Current,2009,0,0,0,0,0,,,,0,0,0,0,,
233,tt2155227,A Mother's Story,2011,50+,88,15,8,7,3.8,65.0,,0,0,0,0,,
234,tt0059675,Sands of the Kalahari,1965,Fewer than 50,41,15,9,6,3.4,62.0,,3,1,2,3,,
235,tt0315788,Art of Revenge,2003,50+,81,2,8,5,2.6,20.0,,0,0,0,0,,
236,tt1385826,The Adjustment Bureau,2011,"100,000+",104898,28575,13907,9720,3.6,67.0,,264,189,75,264,6.60,72.0
237,tt0114367,Screamers,1995,"5,000+",9159,609,746,444,3.1,45.0,,35,10,25,35,4.60,29.0
238,tt0329429,Nizhalkkuthu,2002,0,0,0,0,0,,,,0,0,0,0,,
239,tt0125664,Man on the Moon,1999,"50,000+",94352,7887,2123,3120,3.9,79.0,,122,78,44,122,6.20,64.0
240,tt0490210,Sarkar Raj,2008,"5,000+",6795,960,367,594,3.8,72.0,,7,3,4,7,4.30,43.0
241,tt0083647,Better Late Than Never,1983,Fewer than 50,9,2,0,0,,,,1,0,1,1,,
242,tt0074503,An Evening in Paris,1967,50+,62,4,1,0,3.9,80.0,,0,0,0,0,,
243,tt0238948,Double Take,2001,"10,000+",15828,382,379,271,3.2,50.0,,78,9,69,78,3.50,12.0
244,tt1399683,Winter's Bone,2010,"50,000+",51898,14347,4648,4503,3.8,76.0,,178,167,11,178,8.30,94.0
245,tt0135621,Rakshak,1996,Fewer than 50,42,1,0,0,,,,0,0,0,0,,
246,tt1266642,Engine sentai Go-onger: Boom boom! Bang bang! GekijoBang!!,2008,0,0,0,0,0,,,,0,0,0,0,,
247,tt0120912,Men in Black II,2002,"250,000+",926454,14773,17952,17448,3.2,45.0,,198,76,122,198,5.30,38.0
248,tt0108041,Sankofa,1993,500+,705,86,11,35,4.3,89.0,,15,14,1,15,8.10,93.0
249,tt0066995,Diamonds Are Forever,1971,"50,000+",67007,5145,3812,2293,3.4,57.0,,53,34,19,53,6.10,64.0
250,tt0410400,On a Clear Day,2005,"10,000+",12463,443,172,280,3.7,72.0,,67,46,21,67,6.20,69.0
251,tt0844794,Northanger Abbey,2007,"5,000+",6178,1048,282,423,3.9,79.0,,0,0,0,0,,
252,tt0096087,Shakedown,1988,"1,000+",1456,52,79,57,3,40.0,,10,7,3,10,6.60,70.0
253,tt0118137,Werewolf,1995,"1,000+",2109,26,168,103,1.5,13.0,,1,0,1,1,,
254,tt0080149,Woyzeck,1979,"2,500+",4235,582,178,227,3.8,77.0,,14,12,2,14,7.30,86.0
255,tt1051915,Resonnances,2006,0,0,0,0,0,,,,0,0,0,0,,
256,tt9048992,Mettukudi,1996,0,0,0,0,0,,,,0,0,0,0,,
257,tt1255916,Hostel: Part III,2011,"2,500+",2551,394,1612,534,2.4,20.0,,6,4,2,6,6.30,67.0
258,tt0457496,Street Fight,2005,"2,500+",2990,351,28,142,4.2,93.0,,23,23,0,23,8.10,100.0
259,tt0120903,X-Men,2000,"250,000+",1068639,74257,14849,28290,3.9,83.0,,174,142,32,174,7.00,82.0
260,tt0065478,Blood Mania,1970,100+,185,13,59,34,2.1,18.0,,1,0,1,1,,
261,tt1528718,Born to Raise Hell,2010,250+,399,44,145,51,2.6,23.0,,1,0,1,1,,
262,tt0083658,Blade Runner,1982,"250,000+",338925,76428,7892,25153,4.4,91.0,,130,115,15,130,8.50,88.0
263,tt0814077,Devil Girl,2007,100+,130,6,6,2,2.8,50.0,,3,2,1,3,,
264,tt1684628,Circumstance,2011,"5,000+",5442,422,203,118,3.6,68.0,,79,68,11,79,7.00,86.0
265,tt0254968,Aram + Aram = Kinnaram,1985,0,0,0,0,0,,,,0,0,0,0,,
266,tt0069273,Sitting Target,1972,100+,125,10,6,6,3.7,62.0,,0,0,0,0,,
267,tt0101004,Zandalee,1991,"1,000+",1181,47,114,46,2.6,30.0,,6,2,4,6,4.30,33.0
268,tt1368151,Super Rhino,2009,100+,181,22,20,3,3.4,52.0,,0,0,0,0,,
269,tt1250777,Kick-Ass,2010,"250,000+",286028,67549,16006,19897,3.9,81.0,,268,206,62,268,7.10,77.0
270,tt1250777,Kick-Ass,2010,"250,000+",286028,67549,16006,19897,3.9,81.0,,268,206,62,268,7.10,77.0
271,tt0091846,Return to Mayberry,1986,250+,423,40,18,25,3.9,70.0,,0,0,0,0,,
272,tt0271585,Karimpin Poovinakkare,1985,0,0,0,0,0,,,,0,0,0,0,,
273,tt0073240,The Killer Elite,1975,"1,000+",2015,90,184,89,2.9,33.0,,15,9,6,15,6.10,60.0
274,tt0097123,Crimes and Misdemeanors,1989,"10,000+",23757,4666,488,1184,4.2,91.0,,51,47,4,51,7.90,92.0
275,tt1067084,Ready? OK!,2008,100+,220,35,22,25,3.5,61.0,,2,2,0,2,,
276,tt1212442,Shadows in Paradise,2010,Fewer than 50,10,2,4,1,2.2,33.0,,0,0,0,0,,
277,tt0058083,Fail Safe,1964,"5,000+",7195,930,90,359,4.2,91.0,,29,27,2,29,8.00,93.0
278,tt0202782,After the Rain,1999,0,0,0,0,0,,,,0,0,0,0,,
279,tt0076666,Saturday Night Fever,1977,"100,000+",179548,6231,2483,3520,3.8,72.0,,55,45,10,55,7.50,82.0
280,tt2742196,Mafia Raaj,1998,0,0,0,0,0,,,,0,0,0,0,,
281,tt0099194,Buster's Bedroom,1991,Fewer than 50,12,1,0,0,,,,1,1,0,1,,
282,tt1836883,Payanam,2011,50+,62,24,2,9,4.1,92.0,,0,0,0,0,,
283,tt0407998,The Mistress of Spices,2005,"5,000+",8012,541,743,574,3,42.0,,9,1,8,9,3.90,11.0
284,tt0877709,Shake Rattle and Roll 8,2006,100+,126,4,5,3,2.9,44.0,,0,0,0,0,,
285,tt1313104,The Cove,2009,"25,000+",25773,6330,409,2295,4.4,94.0,,133,126,7,133,8.00,95.0
286,tt1535970,The Ledge,2011,"2,500+",4923,810,892,338,3.2,48.0,,29,4,25,29,4.20,14.0
287,tt0443527,The Hamiltons,2006,"5,000+",6577,511,839,751,2.8,38.0,,3,2,1,3,,
288,tt0173714,Cats,1998,0,0,0,0,0,,,,0,0,0,0,,
289,tt0156757,Mad About Mambo,2000,"1,000+",2276,96,90,67,3.4,52.0,,14,8,6,14,5.20,57.0
290,tt0097416,Kadhalan,1994,Fewer than 50,1,1,0,0,,,,0,0,0,0,,
291,tt0077394,Damien: Omen II,1978,"50,000+",50769,1307,1385,874,3.3,49.0,,26,12,14,26,5.10,46.0
292,tt0185431,Little Nicky,2000,"250,000+",460579,9034,7258,11345,3.3,55.0,,114,25,89,114,3.90,22.0
293,tt0349889,Unstoppable,2004,"2,500+",3282,54,173,50,2.6,24.0,,1,0,1,1,,
294,tt0230783,Signs & Wonders,2000,100+,205,10,17,10,3,37.0,,29,19,10,29,5.90,66.0
295,tt0397313,Eight Below,2006,"250,000+",374385,7570,2074,10295,3.9,79.0,,153,111,42,153,6.50,73.0
296,tt0207745,"A Girl, Three Guys, and a Gun",2000,50+,52,2,2,0,,,,1,0,1,1,,
297,tt0056056,Hands of a Stranger,1962,100+,171,4,31,20,2.4,11.0,,2,2,0,2,,
298,tt0936501,Taken,2008,"250,000+",739455,283441,51748,47648,4.2,85.0,,177,105,72,177,5.80,59.0
299,tt0290057,Scooby-Doo and the Cyber Chase,2001,"10,000+",10910,320,164,188,3.8,66.0,,5,3,2,5,5.80,60.0
300,tt0063094,Hot Millions,1968,250+,427,59,21,31,3.8,74.0,,6,4,2,6,6.40,67.0
301,tt0100911,"Welcome Home, Roxy Carmichael",1990,"5,000+",5209,184,211,98,3.3,46.0,,10,5,5,10,5.20,50.0
302,tt0078836,Bear Island,1979,250+,262,13,29,11,2.9,31.0,,1,1,0,1,,
303,tt0060424,The Fortune Cookie,1966,"2,500+",4709,506,128,205,3.8,80.0,,28,27,1,28,7.60,96.0
304,tt0091369,Labyrinth,1986,"250,000+",373768,49609,8204,28104,4.2,86.0,,51,38,13,51,6.50,75.0
305,tt0113849,A Month by the Lake,1995,"1,000+",2154,61,44,32,3.4,58.0,,17,12,5,17,6.10,71.0
306,tt0100911,"Welcome Home, Roxy Carmichael",1990,"5,000+",5209,184,211,98,3.3,46.0,,10,5,5,10,5.20,50.0
307,tt0122151,Lethal Weapon 4,1998,"250,000+",254816,6230,3527,4445,3.6,64.0,,67,35,32,67,5.90,52.0
308,tt0370904,Lucky 7,2003,"5,000+",5501,475,145,214,3.9,77.0,,1,1,0,1,,
309,tt0144640,Three to Tango,1999,"25,000+",36675,811,862,604,3.2,48.0,,66,19,47,66,4.40,29.0
310,tt0887745,How About You...,2007,"1,000+",1544,125,107,88,3.4,54.0,,25,16,9,25,5.90,64.0
311,tt0144640,Three to Tango,1999,"25,000+",36675,811,862,604,3.2,48.0,,66,19,47,66,4.40,29.0
312,tt1582507,House at the End of the Street,2012,"50,000+",57522,6689,9716,2117,3,41.0,,69,8,61,69,3.80,12.0
313,tt0290664,Hysterical Blindness,2002,"2,500+",3908,241,143,128,3.5,63.0,,12,9,3,12,5.40,75.0
314,tt0353962,Rånarna,2003,0,0,0,0,0,,,,0,0,0,0,,
315,tt1183733,War of the Worlds 2: The Next Wave,2008,"1,000+",1023,24,243,147,1.3,9.0,,0,0,0,0,,
316,tt0367677,Dracula 3000,2004,"5,000+",9514,63,355,250,1.6,15.0,,3,0,3,3,,
317,tt0078089,Planet of Dinosaurs,1977,"1,000+",1320,34,73,67,2.8,32.0,,2,0,2,2,,
318,tt0082656,Liar's Moon,1981,500+,717,23,16,15,3.6,59.0,,4,3,1,4,,
319,tt1270262,The Devil's Double,2011,"10,000+",14016,3477,1924,1127,3.5,64.0,,104,57,47,104,5.80,55.0
320,tt0058472,The Pink Phink,1964,0,0,0,0,0,,,,0,0,0,0,,
321,tt0373445,The Wendell Baker Story,2005,"10,000+",16340,597,889,560,3,40.0,,42,17,25,42,5.10,40.0
322,tt1311699,Dead Man Running,2009,"5,000+",8638,302,284,190,3.2,52.0,,22,3,19,22,4.10,14.0
323,tt1286499,At the Edge of the World,2008,100+,185,20,22,13,3.4,48.0,,15,13,2,15,6.50,87.0
324,tt0984200,Incendiary,2008,"2,500+",3724,346,663,341,2.8,34.0,,25,5,20,25,3.80,20.0
325,tt1319716,It's a Wonderful Afterlife,2010,"5,000+",6286,113,228,136,2.8,33.0,,21,6,15,21,4.40,29.0
326,tt0079931,Something Short of Paradise,1979,50+,51,1,5,3,2.4,17.0,,1,0,1,1,,
327,tt0477252,36 China Town,2006,"5,000+",6014,211,101,127,3.7,68.0,,0,0,0,0,,
328,tt0068384,Cisco Pike,1971,500+,505,44,27,18,3.6,61.0,,4,4,0,4,,
329,tt0077355,Coma,1978,"5,000+",7724,536,278,213,3.5,66.0,,27,22,5,27,6.60,81.0
330,tt0249359,Ankuram,1993,0,0,0,0,0,,,,0,0,0,0,,
331,tt0075875,Confessions from a Holiday Camp,1977,50+,60,1,17,3,1.8,6.0,,0,0,0,0,,
332,tt0054793,The Dead One,1961,Fewer than 50,9,0,2,2,,,,0,0,0,0,,
333,tt0839949,A Perfect Day,2006,250+,441,51,73,42,3,41.0,,0,0,0,0,,
334,tt1029241,Vinyan,2008,"1,000+",1797,164,345,251,2.6,32.0,,19,10,9,19,5.60,53.0
335,tt0338690,Aag,1994,0,0,0,0,0,,,,0,0,0,0,,
336,tt0109537,Family Album,1994,100+,109,5,5,5,3.7,50.0,,1,1,0,1,,
337,tt0956038,Nights in Rodanthe,2008,"100,000+",103711,3397,3185,3065,3.3,52.0,,136,41,95,136,4.80,30.0
338,tt0417944,Manuale d'amore,2005,"2,500+",3094,301,106,71,3.8,74.0,,2,1,1,2,,
339,tt0293113,Dracula: Pages from a Virgin's Diary,2002,"2,500+",2756,159,59,80,3.7,73.0,,61,53,8,61,7.60,87.0
340,tt0091351,Knights of the City,1986,250+,284,2,4,3,2.5,33.0,,0,0,0,0,,
341,tt0276830,Blueberry,2004,"5,000+",5287,383,398,282,3.1,49.0,,9,2,7,9,3.90,22.0
342,tt0074459,Echoes of a Summer,1976,100+,156,12,10,6,3.1,55.0,,0,0,0,0,,
343,tt0246177,Punnami Naagu,1980,0,0,0,0,0,,,,0,0,0,0,,
344,tt0068853,The Life and Times of Judge Roy Bean,1972,"2,500+",3730,249,87,105,3.7,74.0,,10,8,2,10,6.30,80.0
345,tt1365500,Roja Kootam,2002,0,0,0,0,0,,,,0,0,0,0,,
346,tt0452766,Curse of the Maya,2004,250+,333,7,27,15,1.8,21.0,,2,0,2,2,,
347,tt0323100,The Lone Ranger,2003,"50,000+",95655,17,18,7,3.3,49.0,,0,0,0,0,,
348,tt0433588,Lies My Mother Told Me,2005,500+,695,86,28,34,3.9,75.0,,0,0,0,0,,
349,tt0338466,Stuck on You,2003,"100,000+",133696,2039,3765,2502,2.9,35.0,,157,96,61,157,6.00,61.0
350,tt0077760,Jaganmohini,1978,0,0,0,0,0,,,,0,0,0,0,,
351,tt0120716,Jakob the Liar,1999,"10,000+",17763,921,546,403,3.5,63.0,,72,21,51,72,4.70,29.0
352,tt0371795,Livin' tha Life,2003,Fewer than 50,11,1,0,0,,,,0,0,0,0,,
353,tt0188461,Border Line,1999,0,0,0,0,0,,,,0,0,0,0,,
354,tt0251127,How to Lose a Guy in 10 Days,2003,"250,000+",802544,55753,16490,26717,3.9,77.0,,150,63,87,150,5.10,42.0
355,tt1238304,Table for Three,2009,"10,000+",14066,124,369,175,2.7,25.0,,3,1,2,3,,
356,tt0081114,Maniac,1980,"5,000+",6849,690,503,506,3.4,58.0,,20,8,12,20,5.00,40.0
357,tt0151285,Lahu Ke Do Rang,1979,0,0,0,0,0,,,,0,0,0,0,,
358,tt0887254,Ennavale,2001,0,0,0,0,0,,,,0,0,0,0,,
359,tt0112427,An Awfully Big Adventure,1995,"5,000+",5015,175,136,142,3.3,56.0,,15,6,9,15,5.30,40.0
360,tt0066049,A Man Called Horse,1970,"5,000+",9714,215,142,145,3.5,60.0,,14,12,2,14,6.90,86.0
361,tt0101597,Closet Land,1991,"1,000+",2302,267,45,158,4.2,85.0,,9,4,5,9,4.60,44.0
362,tt0067636,Pyar Ki Kahani,1971,Fewer than 50,20,2,0,0,,,,0,0,0,0,,
363,tt0095379,Intruder,1989,"2,500+",2697,257,235,205,3.2,52.0,,2,2,0,2,,
364,tt0801526,The Tracey Fragments,2007,"5,000+",5637,1102,925,1030,3.2,54.0,,38,16,22,38,5.10,42.0
365,tt1049402,Howl,2010,"5,000+",8900,1274,922,589,3.4,58.0,,109,69,40,109,6.30,63.0
366,tt0373416,Underclassman,2005,"25,000+",39600,254,487,279,2.7,34.0,,83,5,78,83,3.00,6.0
367,tt0806130,My Sexiest Year,2007,100+,125,4,2,0,3.8,67.0,,0,0,0,0,,
368,tt1111948,Soul Men,2008,"50,000+",54268,1146,844,861,3.5,58.0,,100,45,55,100,5.00,45.0
369,tt0118055,Up Close & Personal,1996,"10,000+",16538,891,460,401,3.7,66.0,,37,12,25,37,5.20,32.0
370,tt0114069,Outbreak,1995,"100,000+",105177,3555,2842,1904,3.4,56.0,,64,38,26,64,5.70,59.0
371,tt0084917,The World According to Garp,1982,"10,000+",20700,1691,470,673,3.9,78.0,,21,15,6,21,6.20,71.0
372,tt0105256,Rich in Love,1992,100+,124,10,16,8,3.1,38.0,,13,9,4,13,6.10,69.0
373,tt0111503,True Lies,1994,"250,000+",266240,13510,4187,7765,3.8,76.0,,54,38,16,54,6.60,70.0
374,tt1323977,What's the Matter with Kansas?,2009,100+,166,33,24,19,3.4,58.0,,15,9,6,15,6.00,60.0
375,tt0081698,Used Cars,1980,"5,000+",7896,756,346,331,3.7,69.0,,30,23,7,30,6.60,77.0
376,tt0099377,Deadbeat at Dawn,1988,"1,000+",1611,87,33,72,3.9,72.0,,2,1,1,2,,
377,tt0089932,Romance on the Orient Express,1985,100+,129,3,2,0,3.2,60.0,,0,0,0,0,,
378,tt0462359,Incubus,2006,"1,000+",1011,21,132,101,1.9,14.0,,3,0,3,3,,
379,tt1433514,A Boy Called Dad,2009,100+,214,39,30,24,3.5,57.0,,10,5,5,10,5.00,50.0
380,tt0092904,Dogs in Space,1986,"1,000+",1185,187,41,94,4.1,82.0,,8,5,3,8,7.90,63.0
381,tt0430576,The Secret Life of Words,2005,"5,000+",7232,1417,227,487,4.1,86.0,,39,27,12,39,6.20,69.0
382,tt0102996,Strictly Business,1991,"2,500+",3484,142,111,74,3.5,56.0,,10,1,9,10,4.40,10.0
383,tt0267116,Wild Zero,1999,"5,000+",6324,754,169,498,4.1,82.0,,6,6,0,6,7.60,100.0
384,tt0070794,The Thief Who Came to Dinner,1973,50+,50,9,7,4,3.5,56.0,,4,1,3,4,,
385,tt0099991,The Last of the Finest,1990,100+,109,8,22,5,2.8,27.0,,3,1,2,3,,
386,tt0064448,House of Cards,1968,Fewer than 50,1,1,0,0,,,,0,0,0,0,,
387,tt0434179,Marebito,2004,"10,000+",10624,299,300,249,3.2,50.0,,28,10,18,28,5.10,36.0
388,tt0302808,El monasterio de los buitres,1973,0,0,0,0,0,,,,0,0,0,0,,
389,tt2002718,Machete Kills,2013,"25,000+",36620,3351,6358,1291,2.9,34.0,,126,37,89,126,4.60,29.0
390,tt0104115,Doctor Mordrid,1992,250+,356,27,49,32,2.9,36.0,,1,1,0,1,,
391,tt0064674,Mr. Freedom,1968,250+,419,59,50,51,3.2,54.0,,3,1,2,3,,
392,tt0273982,Poolhall Junkies,2002,"10,000+",20265,2574,370,1155,4.2,87.0,,43,14,29,43,4.50,33.0
393,tt0267693,In Love and War,2001,50+,94,4,4,3,3.6,50.0,,1,1,0,1,,
394,tt0422779,Murder-Set-Pieces,2004,"1,000+",2266,81,244,211,2.2,25.0,,10,3,7,10,4.80,30.0
395,tt0071230,Blazing Saddles,1974,"100,000+",218752,32137,3358,11995,4.3,91.0,,68,60,8,68,8.10,88.0
396,tt0186894,Bounce,2000,"10,000+",21849,521,1085,394,2.9,32.0,,108,57,51,108,5.60,53.0
397,tt0194773,Corrupt,1999,50+,69,1,8,1,1.6,11.0,,2,0,2,2,,
398,tt0061809,In Cold Blood,1967,"5,000+",8675,1235,170,412,4.1,88.0,,43,35,8,43,8.20,81.0
399,tt1650557,Neelathamara,2009,0,0,0,0,0,,,,0,0,0,0,,
400,tt0068611,Frenzy,1972,"10,000+",12719,2228,644,820,3.8,78.0,,43,39,4,43,7.30,91.0
401,tt0293929,Silent Cry,2002,250+,253,6,2,4,3.3,75.0,,0,0,0,0,,
402,tt1563725,Logorama,2009,500+,506,222,41,49,4,84.0,,0,0,0,0,,
403,tt0072271,The Texas Chain Saw Massacre,1974,"100,000+",203339,12866,2876,7167,4,82.0,,71,63,8,71,8.20,89.0
404,tt0100613,Side Out,1990,"1,000+",1557,80,55,44,3.4,59.0,,4,0,4,4,,
405,tt0480025,This Is England,2006,"50,000+",54840,17456,2049,7346,4.2,90.0,,96,89,7,96,7.70,93.0
406,tt0497539,Uro,2006,500+,881,79,114,29,3,41.0,,3,2,1,3,,
407,tt0156136,Tik Tik Tik,1981,0,0,0,0,0,,,,0,0,0,0,,
408,tt0437179,See No Evil,2006,"100,000+",116648,2827,2852,3828,3.2,50.0,,57,5,52,57,3.30,9.0
409,tt0096159,"Splash, Too",1988,250+,442,30,38,18,2.9,44.0,,0,0,0,0,,
410,tt0415778,End Game,2006,100+,141,6,30,20,1.6,17.0,,0,0,0,0,,
411,tt0062883,The Detective,1968,500+,848,60,65,49,3.2,48.0,,8,8,0,8,7.00,100.0
412,tt1728975,Elevator,2012,0,0,0,0,0,,,,0,0,0,0,,
413,tt0076327,Looking for Mr. Goodbar,1977,"2,500+",4408,304,107,164,3.7,74.0,,31,19,12,31,6.40,61.0
414,tt0340112,Fateh,1991,0,0,0,0,0,,,,0,0,0,0,,
415,tt0318605,Raajavin Paarvayile,1995,0,0,0,0,0,,,,0,0,0,0,,
416,tt0182000,The Caveman's Valentine,2001,"5,000+",6166,264,252,182,3.2,51.0,,84,38,46,84,5.20,45.0
417,tt0318586,Ponnumani,1993,Fewer than 50,33,0,1,0,,,,0,0,0,0,,
418,tt0286855,Now You Know,2002,"1,000+",2395,160,95,130,3.4,63.0,,0,0,0,0,,
419,tt14787872,Vaanavil,2000,0,0,0,0,0,,,,0,0,0,0,,
420,tt1845866,Teen spirit,2011,250+,346,79,115,21,3.1,41.0,,0,0,0,0,,
421,tt1275494,3 saisons,2009,Fewer than 50,23,0,3,1,,,,0,0,0,0,,
422,tt2084939,Sivappathikaaram,2006,100+,195,1,4,3,2.6,20.0,,0,0,0,0,,
423,tt1634121,Intruders,2011,Fewer than 50,8,4,3,1,3.4,57.0,,1,1,0,1,,
424,tt1905071,Toomelah,2011,100+,123,18,7,12,3.6,72.0,,5,5,0,5,7.30,100.0
425,tt0110308,The Last Seduction,1994,"5,000+",6544,864,278,348,3.7,76.0,,52,49,3,52,7.90,94.0
426,tt0881894,Attagasam,2004,Fewer than 50,1,0,1,0,,,,0,0,0,0,,
427,tt0412808,The Hawk Is Dying,2006,"1,000+",2359,88,119,102,3.1,43.0,,23,7,16,23,4.60,30.0
428,tt0086006,Never Say Never Again,1983,"50,000+",52685,1461,2471,1258,3,37.0,,55,39,16,55,5.60,71.0
429,tt0180052,The Adventures of Pluto Nash,2002,"25,000+",32715,380,1549,636,2,20.0,,91,5,86,91,3.00,5.0
430,tt1282041,Anton Chekhov's The Duel,2010,250+,321,50,26,24,3.6,66.0,,37,30,7,37,6.90,81.0
431,tt0109816,Floundering,1994,"1,000+",1142,58,46,23,3.4,56.0,,12,8,4,12,6.00,67.0
432,tt0154587,"Hey There, It's Yogi Bear",1964,"2,500+",2702,33,28,25,3.6,54.0,,2,2,0,2,,
433,tt0080881,The Hollywood Knights,1980,"2,500+",3214,222,92,103,3.9,71.0,,7,1,6,7,5.70,14.0
434,tt0482495,Doll Graveyard,2005,"1,000+",1658,15,71,59,2.2,17.0,,3,1,2,3,,
435,tt0089645,Mussolini and I,1985,50+,95,7,10,1,3.2,41.0,,0,0,0,0,,
436,tt1099942,Centigrade,2007,0,0,0,0,0,,,,0,0,0,0,,
437,tt0460721,The Big Bad Swim,2006,"1,000+",1000,159,55,113,3.7,75.0,,4,3,1,4,,
438,tt0122233,Saaz,1997,Fewer than 50,6,0,1,0,,,,0,0,0,0,,
439,tt0418279,Transformers,2007,"250,000+",2385106,418733,71080,392143,4.1,85.0,,229,131,98,229,5.80,57.0
440,tt0422720,Marie Antoinette,2006,"250,000+",262709,16716,13121,13661,3.3,56.0,,217,125,92,217,6.10,58.0
441,tt0471005,Home of the Giants,2007,250+,332,27,32,18,3.2,46.0,,0,0,0,0,,
442,tt0069803,The Blockhouse,1973,100+,126,8,3,8,3.9,73.0,,1,1,0,1,,
443,tt0076686,The Serpent's Egg,1977,"2,500+",2505,211,167,86,3.3,56.0,,20,4,16,20,4.80,20.0
444,tt1784538,Miss Representation,2011,500+,606,327,83,71,4,80.0,,4,4,0,4,,
445,tt0430922,Role Models,2008,"250,000+",278742,22870,8026,11128,3.7,74.0,,163,125,38,163,6.50,77.0
446,tt0319813,Mannan,1992,Fewer than 50,1,1,0,0,,,,0,0,0,0,,
447,tt0339918,Wolves of Wall Street,2002,250+,275,9,19,9,2.7,32.0,,2,0,2,2,,
448,tt0813548,Godavari,2006,100+,101,17,2,4,4.3,89.0,,0,0,0,0,,
449,tt0865907,Into the Blue 2: The Reef,2009,"50,000+",68043,120,547,341,2.4,18.0,,6,1,5,6,3.80,17.0
450,tt0089038,Dont Open Till Christmas,1984,100+,183,11,67,30,2.3,14.0,,3,2,1,3,,
451,tt0053994,Kidnapped,1960,250+,379,33,29,18,3.3,53.0,,1,1,0,1,,
452,tt1045658,Silver Linings Playbook,2012,"250,000+",261141,84041,13606,10599,4.1,86.0,,263,241,22,263,8.20,92.0
453,tt0097576,Indiana Jones and the Last Crusade,1989,"250,000+",770018,64641,4003,24704,4.4,94.0,,136,114,22,136,8.00,84.0
454,tt0271693,Oru Abhibhashakante Case Diary,1995,0,0,0,0,0,,,,0,0,0,0,,
455,tt0495044,Saravana,2006,100+,108,4,9,3,2.9,31.0,,0,0,0,0,,
456,tt0405121,Love in Nepal,2004,0,0,0,0,0,,,,0,0,0,0,,
457,tt0059166,The Family Jewels,1965,"1,000+",1860,103,40,53,3.8,72.0,,5,4,1,5,6.60,80.0
458,tt0274415,Carmen: A Hip Hopera,2001,"5,000+",8747,364,154,223,3.9,70.0,,6,3,3,6,3.80,50.0
459,tt0103074,Thelma & Louise,1991,"100,000+",170527,10331,2255,3591,4,82.0,,153,132,21,153,8.00,86.0
460,tt0088071,Second Sight: A Love Story,1984,0,0,0,0,0,,,,0,0,0,0,,
461,tt0068997,The New Centurions,1972,250+,262,47,28,28,3.6,63.0,,4,3,1,4,,
462,tt0450367,Puzzlehead,2005,500+,796,73,80,89,3.1,48.0,,7,7,0,7,6.90,100.0
463,tt0112579,The Bridges of Madison County,1995,"25,000+",48351,6702,1013,2309,4.2,87.0,,61,55,6,61,7.40,90.0
464,tt2185084,From Sydney with Love,2012,0,0,0,0,0,,,,0,0,0,0,,
465,tt0064857,Pyar Hi Pyar,1969,Fewer than 50,24,1,1,0,,,,0,0,0,0,,
466,tt0938303,The Final Winter,2007,250+,364,45,17,37,3.6,73.0,,0,0,0,0,,
467,tt0317919,Mission: Impossible III,2006,"250,000+",509659,24630,10893,18677,3.6,69.0,,224,159,65,224,6.60,71.0
468,tt0255702,Wishcraft,2002,500+,746,20,58,18,2.4,26.0,,0,0,0,0,,
469,tt0102979,Stepping Out,1991,250+,370,58,24,20,3.7,71.0,,4,2,2,4,,
470,tt0095368,The Incredible Hulk Returns,1988,"2,500+",3090,92,132,72,3.2,41.0,,6,3,3,6,5.00,50.0
471,tt0071337,Closed Mondays,1974,Fewer than 50,8,6,2,1,3.8,75.0,,0,0,0,0,,
472,tt0076636,Rollercoaster,1977,"1,000+",2104,126,130,112,3.3,49.0,,17,9,8,17,6.50,53.0
473,tt0315327,Bruce Almighty,2003,"250,000+",33024215,71768,53574,1347748,3.3,57.0,,190,91,99,190,5.70,48.0
474,tt1082853,Management,2008,"50,000+",62768,1029,2413,1161,2.8,30.0,,95,44,51,95,5.30,46.0
475,tt0091920,Seize the Day,1986,500+,611,43,46,38,3.2,48.0,,1,0,1,1,,
476,tt0087313,Garbo Talks,1984,250+,317,30,30,21,3.2,50.0,,21,12,9,21,5.50,57.0
477,tt0125211,I Woke Up Early the Day I Died,1998,100+,216,10,10,7,3.3,50.0,,11,3,8,11,4.10,27.0
478,tt0415160,Minotaur,2006,"1,000+",1692,45,255,126,2,15.0,,1,1,0,1,,
479,tt0091256,Ijaazat,1987,500+,798,62,2,19,4.5,97.0,,0,0,0,0,,
480,tt1427844,Chased,2009,0,0,0,0,0,,,,0,0,0,0,,
481,tt0286788,What a Girl Wants,2003,"250,000+",453716,18010,11117,11776,3.5,62.0,,109,39,70,109,4.80,36.0
482,tt0117999,Two Deaths,1995,100+,106,8,6,9,3.5,57.0,,8,3,5,8,5.10,38.0
483,tt0070569,The Proud and Damned,1972,250+,494,0,9,6,1.9,0.0,,0,0,0,0,,
484,tt0068215,Annadata,1972,0,0,0,0,0,,,,0,0,0,0,,
485,tt0054877,Five Golden Hours,1961,Fewer than 50,43,3,2,2,3.2,60.0,,3,0,3,3,,
486,tt0055133,Man in the Moon,1960,50+,56,4,4,1,3.3,50.0,,1,1,0,1,,
487,tt0913445,Young People Fucking,2007,"5,000+",7755,1517,957,1101,3.4,61.0,,22,9,13,22,5.50,41.0
488,tt0239235,Anji,2004,Fewer than 50,1,1,0,0,,,,0,0,0,0,,
489,tt0406951,Suburban Secrets,2004,0,0,0,0,0,,,,0,0,0,0,,
490,tt0321442,The Big Empty,2003,"2,500+",4037,179,192,131,3.3,48.0,,6,4,2,6,6.20,67.0
491,tt0096462,Woodchipper Massacre,1988,Fewer than 50,40,2,10,5,2.4,17.0,,1,0,1,1,,
492,tt1151928,Cyborg Soldier,2008,100+,118,18,100,69,2.2,15.0,,0,0,0,0,,
493,tt0246986,Thiruvilayadal,1965,0,0,0,0,0,,,,0,0,0,0,,
494,tt0253754,Star Trek: Nemesis,2002,"50,000+",75278,4332,4569,3058,3.2,49.0,,173,66,107,173,5.20,38.0
495,tt0104941,Muqabla,1993,Fewer than 50,34,2,2,0,,,,0,0,0,0,,
496,tt0814331,Spring Breakdown,2009,"1,000+",1926,164,427,235,2.7,28.0,,12,6,6,12,5.80,50.0
497,tt1039780,Dear Friends,2007,0,0,0,0,0,,,,0,0,0,0,,
498,tt2387495,Jalpari: The Desert Mermaid,2012,0,0,0,0,0,,,,0,0,0,0,,
499,tt0073624,Return to Macon County,1975,50+,69,12,8,3,3.8,60.0,,3,1,2,3,,
500,tt0282667,Kung Phooey!,2003,500+,711,46,41,42,3.2,53.0,,3,2,1,3,,
501,tt0062482,Welcome to Hard Times,1967,100+,116,17,23,12,2.9,42.0,,1,0,1,1,,
502,tt0092022,Streets of Gold,1986,100+,128,9,11,9,3.2,45.0,,13,4,9,13,4.50,31.0
503,tt0064100,Bob & Carol & Ted & Alice,1969,"1,000+",1703,245,127,120,3.5,66.0,,61,50,11,61,7.50,82.0
504,tt0065700,Entertaining Mr Sloane,1970,100+,212,20,10,14,3.6,67.0,,3,2,1,3,,
505,tt0384376,No Regrets,2004,0,0,0,0,0,,,,0,0,0,0,,
506,tt1212909,Broken Hill,2009,250+,312,55,36,28,3.5,60.0,,6,3,3,6,5.30,50.0
507,tt0102685,Point Break,1991,"100,000+",134030,12419,3387,5207,3.9,79.0,,75,53,22,75,6.20,71.0
508,tt0170416,Shikari: The Hunter,1991,0,0,0,0,0,,,,0,0,0,0,,
509,tt1600207,The Eye of the Storm,2011,"5,000+",5323,88,103,47,3.1,46.0,,54,33,21,54,5.90,61.0
510,tt0118930,The Dark Side of the Sun,1988,"1,000+",2496,72,112,41,2.8,39.0,,3,0,3,3,,
511,tt0059868,A Very Special Favor,1965,Fewer than 50,37,5,7,2,3,42.0,,1,0,1,1,,
512,tt0892791,Shrek Forever After,2010,"250,000+",353770,22763,19216,9703,3.4,54.0,,200,114,86,200,5.90,57.0
513,tt0255798,The Animal,2001,"100,000+",203686,1430,3723,2550,2.6,28.0,,84,25,59,84,4.30,30.0
514,tt0119313,Hope Floats,1998,"50,000+",61117,4013,1559,1872,3.9,72.0,,33,9,24,33,4.90,27.0
515,tt0416463,Akale,2004,0,0,0,0,0,,,,0,0,0,0,,
516,tt0077617,Go Tell the Spartans,1978,250+,417,40,27,32,3.4,60.0,,6,4,2,6,5.90,67.0
517,tt0251182,The Legend of Alfred Packer,1980,Fewer than 50,6,1,1,0,,,,0,0,0,0,,
518,tt0328099,Malibu's Most Wanted,2003,"50,000+",51726,2187,1888,1646,3.3,54.0,,93,29,64,93,4.70,31.0
519,tt0455767,Sivakaasi,2005,250+,356,26,9,9,4,74.0,,0,0,0,0,,
520,tt11542440,Harichandra,1998,0,0,0,0,0,,,,0,0,0,0,,
521,tt1391092,Marwencol,2010,"1,000+",2442,743,113,173,4.1,87.0,,63,62,1,63,8.40,98.0
522,tt1720616,Friends with Kids,2011,"25,000+",34167,4859,5043,1498,3.2,49.0,,152,101,51,152,6.50,66.0
523,tt0342300,Dopamine,2003,"1,000+",1164,72,65,51,3.3,53.0,,52,26,26,52,5.50,50.0
524,tt1231587,Hot Tub Time Machine,2010,"100,000+",167234,19274,15128,9292,3.4,56.0,,213,136,77,213,6.10,64.0
525,tt2039339,Flicka: Country Pride,2012,50+,77,18,13,4,3.5,58.0,,0,0,0,0,,
526,tt0195994,Pirates of the Plain,1999,Fewer than 50,21,3,3,0,3,50.0,,1,0,1,1,,
527,tt0250224,Crazy/Beautiful,2001,"50,000+",64428,3189,1444,1869,3.8,69.0,,99,62,37,99,5.70,63.0
528,tt0118710,Beyond the Pale,2000,Fewer than 50,36,1,1,0,,,,2,2,0,2,,
529,tt0086336,Something Wicked This Way Comes,1983,"5,000+",9345,613,349,399,3.5,64.0,,33,20,13,33,6.40,61.0
530,tt1255953,Incendies,2010,"10,000+",18182,5746,471,1331,4.3,92.0,,124,113,11,124,7.90,91.0
531,tt0212304,Lethal Vows,1999,500+,574,22,17,17,3.5,56.0,,0,0,0,0,,
532,tt0259996,Ek Hi Bhool,1981,0,0,0,0,0,,,,0,0,0,0,,
533,tt0099700,Gremlins 2: The New Batch,1990,"250,000+",268814,5020,3528,4877,3.5,59.0,,66,47,19,66,6.70,71.0
534,tt0109193,The Babymaker: The Dr. Cecil Jacobson Story,1994,50+,88,1,2,2,,,,0,0,0,0,,
535,tt0388377,River Queen,2005,"2,500+",2777,158,181,160,3.1,46.0,,5,2,3,5,4.80,40.0
536,tt1661461,What a Man,2011,0,0,0,0,0,,,,0,0,0,0,,
537,tt0117737,Stealing Beauty,1996,"10,000+",20857,2237,751,754,3.9,75.0,,52,26,26,52,6.00,50.0
538,tt0178050,Sunset Strip,2000,"1,000+",1381,50,52,27,3.3,49.0,,3,0,3,3,,
539,tt1579764,Evadi Gola Vadide,2005,0,0,0,0,0,,,,0,0,0,0,,
540,tt0073600,Race with the Devil,1975,"2,500+",3241,219,180,189,3.4,55.0,,14,9,5,14,5.50,64.0
541,tt0485161,Totally Awesome,2006,"2,500+",4358,245,153,230,3.5,62.0,,3,2,1,3,,
542,tt0142192,The Corruptor,1999,"5,000+",9711,472,629,244,3.1,43.0,,48,23,25,48,5.30,48.0
543,tt1381512,Robo-geisha,2009,"1,000+",1143,150,167,142,3.1,47.0,,2,2,0,2,,
544,tt0906005,Freakshow,2007,"1,000+",1102,20,107,85,1.9,16.0,,0,0,0,0,,
545,tt1084955,Falling Up,2009,500+,616,63,137,55,2.9,32.0,,1,1,0,1,,
546,tt0478329,The Gray Man,2007,250+,368,41,75,49,3,35.0,,0,0,0,0,,
547,tt0080947,The Jayne Mansfield Story,1980,250+,354,4,28,6,2.4,12.0,,0,0,0,0,,
548,tt0807943,Dhee,2007,0,0,0,0,0,,,,0,0,0,0,,
549,tt0116707,Joe's Apartment,1996,"25,000+",36542,639,880,855,3,42.0,,27,5,22,27,3.90,19.0
550,tt1027806,Copperhead,2008,100+,113,7,20,11,2.5,26.0,,0,0,0,0,,
551,tt0099349,Dancin' Thru the Dark,1990,500+,620,65,5,40,4.7,93.0,,0,0,0,0,,
552,tt0084228,Laberinto de pasiones,1982,0,0,0,0,0,,,,0,0,0,0,,
553,tt0924229,Jagadam,2007,100+,185,3,2,0,3.8,60.0,,0,0,0,0,,
554,tt0096511,Zombi 3,1988,"2,500+",3634,71,231,129,2.5,24.0,,4,2,2,4,,
555,tt8948586,Ettupatti Rasa,1997,0,0,0,0,0,,,,0,0,0,0,,
556,tt0251448,Turbulence 3: Heavy Metal,2001,"1,000+",1751,20,71,32,2.3,22.0,,2,0,2,2,,
557,tt0061683,Frankenstein Created Woman,1967,"1,000+",1169,130,99,82,3.4,57.0,,13,8,5,13,6.00,62.0
558,tt1519402,Taqwacore: The Birth of Punk Islam,2009,50+,75,21,10,9,3.7,68.0,,6,3,3,6,5.90,50.0
559,tt1130964,The 5th Quarter,2010,"1,000+",1089,236,141,98,3.6,62.0,,7,4,3,7,6.10,57.0
560,tt0091541,The Money Pit,1986,"50,000+",52750,2590,1887,1516,3.5,58.0,,22,11,11,22,4.90,50.0
561,tt0453453,Beer League,2006,"10,000+",23992,1330,979,571,3.4,58.0,,14,4,10,14,4.30,29.0
562,tt0087032,Cannonball Run II,1984,"10,000+",20551,422,513,327,3.2,45.0,,16,2,14,16,3.00,13.0
563,tt0837803,Sex and Breakfast,2005,"2,500+",4096,166,613,288,2.4,21.0,,12,1,11,12,3.50,8.0
564,tt0486551,Beerfest,2006,"100,000+",199079,18916,6169,8496,3.9,75.0,,107,43,64,107,5.10,40.0
565,tt0245120,The Forsaken,2001,"10,000+",10944,293,430,308,3,41.0,,56,4,52,56,3.30,7.0
566,tt1173687,The Bang Bang Club,2010,"2,500+",3587,571,383,180,3.5,60.0,,49,24,25,49,5.80,49.0
567,tt1217634,Innathe Chinthavishayam,2008,50+,75,0,5,0,2.5,0.0,,0,0,0,0,,
568,tt0963966,The Sorcerer's Apprentice,2010,"100,000+",142693,13750,12356,6676,3.3,53.0,,173,69,104,173,5.20,40.0
569,tt1148204,Orphan,2009,"250,000+",873360,16366,9515,11186,3.5,63.0,,161,94,67,161,5.60,58.0
570,tt1153040,Haeundae,2009,"1,000+",1269,210,222,188,3.2,49.0,,3,0,3,3,,
571,tt0081480,Seems Like Old Times,1980,"5,000+",6199,400,225,194,3.7,64.0,,20,14,6,20,6.10,70.0
572,tt1515205,Paju,2009,Fewer than 50,14,3,2,0,3.4,60.0,,0,0,0,0,,
573,tt0271604,Kuch Khatti Kuch Meethi,2001,500+,724,20,36,11,2.9,36.0,,0,0,0,0,,
574,tt2385073,Endukante... Premanta,2012,Fewer than 50,1,1,0,0,,,,0,0,0,0,,
575,tt0093873,Rock 'n' Roll Nightmare,1987,Fewer than 50,31,4,21,6,1.9,16.0,,1,0,1,1,,
576,tt0489235,My Name Is Bruce,2007,"5,000+",8619,1222,1295,1286,3.2,49.0,,39,15,24,39,4.90,38.0
577,tt0800226,Superman: Brainiac Attacks,2006,"2,500+",4870,394,260,125,3.7,60.0,,2,2,0,2,,
578,tt0065737,Fragment of Fear,1970,Fewer than 50,19,4,6,4,3.2,40.0,,1,0,1,1,,
579,tt1767382,Silent House,2011,"25,000+",42342,2349,5508,1579,2.7,30.0,,135,57,78,135,5.20,42.0
580,tt0372237,Guess Who,2005,"250,000+",269642,5363,5648,4881,3.2,49.0,,150,62,88,150,5.40,41.0
581,tt1640548,Rampart,2011,"10,000+",12354,1675,3070,965,2.8,35.0,,149,110,39,149,6.60,74.0
582,tt0268531,Pettson och Findus - Kattonauten,2000,50+,91,0,3,0,,,,0,0,0,0,,
583,tt0086203,Rock & Rule,1983,"2,500+",3798,322,130,212,3.8,71.0,,4,2,2,4,,
584,tt1156148,Karzzzz,2008,250+,286,21,49,36,2.6,30.0,,3,0,3,3,,
585,tt0492619,The Foot Fist Way,2006,"2,500+",4891,943,1097,996,3.1,46.0,,84,45,39,84,5.50,54.0
586,tt0405022,House of Boys,2009,100+,179,41,44,17,3.3,48.0,,8,4,4,8,6.40,50.0
587,tt0070449,Nirmalyam,1973,0,0,0,0,0,,,,0,0,0,0,,
588,tt0082146,Caveman,1981,"5,000+",9558,401,337,357,3.4,54.0,,21,7,14,21,4.70,33.0
589,tt0220596,Khauff,2000,100+,203,3,5,1,2.8,38.0,,0,0,0,0,,
590,tt0054164,Pay or Die!,1960,Fewer than 50,18,3,7,2,3.2,30.0,,1,1,0,1,,
591,tt0406310,Van Helsing: The London Assignment,2004,"50,000+",55888,622,544,427,3.3,53.0,,0,0,0,0,,
592,tt0114666,The Tie That Binds,1995,"1,000+",1294,21,42,14,2.8,32.0,,12,1,11,12,2.80,8.0
593,tt0072826,Cousin cousine,1975,250+,350,36,18,12,3.6,67.0,,5,5,0,5,7.80,100.0
594,tt0404031,Evil Eyes,2004,100+,236,3,16,7,2.2,16.0,,0,0,0,0,,
595,tt0309912,Nicholas Nickleby,2002,"2,500+",2739,1071,349,507,3.8,75.0,,129,101,28,129,6.90,78.0
596,tt0115536,El amor perjudica seriamente la salud,1996,0,0,0,0,0,,,,0,0,0,0,,
597,tt0455545,Idhaya Thirudan,2006,0,0,0,0,0,,,,0,0,0,0,,
598,tt1570732,Vettaikaaran,2009,0,0,0,0,0,,,,0,0,0,0,,
599,tt1047007,Young @ Heart,2007,"5,000+",5408,1660,160,1065,4.3,91.0,,104,94,10,104,7.60,90.0
600,tt0056048,Gypsy,1962,"5,000+",6422,417,143,215,3.9,74.0,,14,9,5,14,6.30,64.0
601,tt0102798,Robin Hood: Prince of Thieves,1991,"250,000+",334945,11770,4545,10346,3.8,72.0,,57,29,28,57,5.60,51.0
602,tt0072953,Eskimo Nell,1975,50+,52,3,6,3,2.7,33.0,,0,0,0,0,,
603,tt0083550,Amityville II: The Possession,1982,"10,000+",16830,342,613,404,2.8,36.0,,21,5,16,21,4.20,24.0
604,tt2165933,Let It Shine,2012,"1,000+",1742,416,80,68,4.3,84.0,,4,3,1,4,,
605,tt0301405,Hinugot sa langit,1985,0,0,0,0,0,,,,0,0,0,0,,
606,tt0084786,They Call Me Bruce,1982,"2,500+",3678,73,84,90,3.2,46.0,,1,0,1,1,,
607,tt0960770,Holding Trevor,2007,250+,460,37,87,49,2.6,30.0,,8,2,6,8,3.90,25.0
608,tt0093822,Raising Arizona,1987,"50,000+",89432,13758,2480,4574,4,85.0,,63,57,6,63,7.80,90.0
609,tt0126260,The Delicate Art of the Rifle,1996,Fewer than 50,4,3,0,0,,,,4,4,0,4,,
610,tt0271345,Aavanazhi,1986,0,0,0,0,0,,,,0,0,0,0,,
611,tt0064855,Putney Swope,1969,"1,000+",1446,245,81,119,3.9,75.0,,16,11,5,16,5.70,69.0
612,tt1388434,Dhaam Dhoom,2008,0,0,0,0,0,,,,0,0,0,0,,
613,tt0325597,The Captives,2001,250+,320,32,36,28,2.9,47.0,,13,10,3,13,6.50,77.0
614,tt0097527,The Horror Show,1989,"1,000+",1444,49,131,72,2.7,27.0,,8,0,8,8,2.80,0.0
615,tt0340191,Kailangan kita,2002,50+,88,7,1,4,3.8,88.0,,0,0,0,0,,
616,tt0057225,Kings of the Sun,1963,100+,117,14,27,16,2.9,34.0,,0,0,0,0,,
617,tt0059398,Looking for Love,1964,Fewer than 50,7,3,1,2,,,,1,1,0,1,,
618,tt0062479,The Way West,1967,250+,326,25,33,17,3.1,43.0,,7,2,5,7,5.20,29.0
619,tt0246290,Trinetrudu,1988,0,0,0,0,0,,,,0,0,0,0,,
620,tt0111068,Sangharsh,1999,0,0,0,0,0,,,,0,0,0,0,,
621,tt0365478,Man with the Screaming Brain,2005,"5,000+",7819,382,500,464,3.1,43.0,,12,4,8,12,4.80,33.0
622,tt0099582,Flatliners,1990,"50,000+",62990,3062,2154,1511,3.4,59.0,,54,27,27,54,5.80,50.0
623,tt0261243,Rockford,1999,100+,218,28,10,10,4,74.0,,0,0,0,0,,
624,tt0307901,25th Hour,2002,"50,000+",80393,14430,2568,4053,4,85.0,,175,138,37,175,7.20,79.0
625,tt0120915,Star Wars: Episode I - The Phantom Menace,1999,"250,000+",1212405,154969,107399,40262,3.5,59.0,,237,123,114,237,5.90,52.0
626,tt0120915,Star Wars: Episode I - The Phantom Menace,1999,"250,000+",1212405,154969,107399,40262,3.5,59.0,,237,123,114,237,5.90,52.0
627,tt0250460,Kappalottiya Thamizhan,1961,0,0,0,0,0,,,,0,0,0,0,,
628,tt0374536,Bewitched,2005,"100,000+",215542,2842,7294,5776,2.6,28.0,,187,45,142,187,4.60,24.0
629,tt0808148,AmericanEast,2008,50+,87,6,12,8,3,33.0,,0,0,0,0,,
630,tt0067828,A Taste of Evil,1971,0,0,0,0,0,,,,0,0,0,0,,
631,tt0065088,"They Shoot Horses, Don't They?",1969,"5,000+",5596,984,124,320,4.1,89.0,,34,28,6,34,7.60,82.0
632,tt0201128,Silk Hope,1999,100+,119,4,2,1,4.2,67.0,,0,0,0,0,,
633,tt0912597,L: Change the World,2008,"2,500+",4393,862,494,628,3.6,64.0,,0,0,0,0,,
634,tt0456165,Salaam Namaste,2005,"5,000+",7635,801,271,349,3.9,75.0,,6,5,1,6,6.50,83.0
635,tt1279935,Date Night,2010,"100,000+",230628,21896,18002,9893,3.4,55.0,,233,155,78,233,6.10,67.0
636,tt0084071,The Highest Honor,1982,Fewer than 50,15,1,0,1,,,,0,0,0,0,,
637,tt0304729,Soap Girl,2002,0,0,0,0,0,,,,2,1,1,2,,
638,tt0490021,Warchild,2006,0,0,0,0,0,,,,2,2,0,2,,
639,tt0085365,Cordélia,1980,0,0,0,0,0,,,,0,0,0,0,,
640,tt0099729,Hamoun,1990,250+,396,61,9,11,4.2,87.0,,1,1,0,1,,
641,tt1606300,Nee Sneham,2002,0,0,0,0,0,,,,0,0,0,0,,
642,tt0162903,Catfish in Black Bean Sauce,1999,500+,943,28,16,26,3.7,64.0,,15,7,8,15,5.30,47.0
643,tt0119525,Levitation,1997,50+,79,3,0,3,,,,0,0,0,0,,
644,tt0442070,D' Anothers,2005,0,0,0,0,0,,,,0,0,0,0,,
645,tt1349482,Bring It On: Fight to the Finish,2009,"2,500+",4421,652,376,220,3.7,63.0,,0,0,0,0,,
646,tt0127282,Shrieker,1998,"1,000+",1235,7,17,9,2.6,29.0,,1,0,1,1,,
647,tt0055283,Payroll,1961,50+,53,7,0,3,4.1,100.0,,1,0,1,1,,
648,tt0079894,The Shape of Things to Come,1979,"1,000+",1371,5,28,19,1.8,15.0,,4,1,3,4,,
649,tt0100143,Miami Blues,1990,"2,500+",4856,258,205,150,3.4,56.0,,27,23,4,27,6.60,85.0
650,tt0107755,Ordinary Magic,1993,250+,251,11,5,5,3.5,69.0,,1,0,1,1,,
651,tt0430779,Everyone's Hero,2006,"50,000+",76631,661,834,725,3.2,44.0,,68,28,40,68,5.10,41.0
652,tt0425996,G.I. Joe: Valor vs. Venom,2004,"1,000+",1996,23,31,20,3.1,43.0,,0,0,0,0,,
653,tt0296711,Kiss the Bride,2002,"1,000+",2236,60,87,63,3,41.0,,6,2,4,6,5.40,33.0
654,tt0072735,Breakheart Pass,1975,"1,000+",2238,156,109,80,3.5,59.0,,18,12,6,18,6.60,67.0
655,tt0369672,A Love Song for Bobby Long,2004,"10,000+",22449,2884,723,1115,4,80.0,,98,43,55,98,5.50,44.0
656,tt1135090,Katt Williams: American Hustle,2007,"2,500+",3834,691,97,275,4.4,88.0,,1,1,0,1,,
657,tt0489070,Hard Luck,2006,"1,000+",2489,59,184,93,2.6,24.0,,1,0,1,1,,
658,tt1045772,I Love You Phillip Morris,2009,"50,000+",88953,10100,6451,4031,3.4,61.0,,161,115,46,161,6.60,71.0
659,tt1172991,The Company Men,2010,"25,000+",33952,3599,2895,1484,3.3,55.0,,169,115,54,169,6.40,68.0
660,tt0218182,An Everlasting Piece,2000,"1,000+",1729,119,36,60,3.9,77.0,,46,22,24,46,5.40,48.0
661,tt0119167,Funny Games,1997,"10,000+",22462,4545,946,1782,4,83.0,,39,28,11,39,7.20,72.0
662,tt0377445,Balettan,2003,0,0,0,0,0,,,,0,0,0,0,,
663,tt0106241,The Sound and the Silence,1991,0,0,0,0,0,,,,1,1,0,1,,
664,tt0366616,Inkaar,1977,Fewer than 50,44,0,1,0,,,,0,0,0,0,,
665,tt0098555,Unconquered,1989,0,0,0,0,0,,,,0,0,0,0,,
666,tt0058430,Onibaba,1964,"5,000+",5695,977,109,366,4.1,90.0,,20,18,2,20,7.20,90.0
667,tt0327679,Ella Enchanted,2004,"250,000+",340713,9891,7466,9325,3.4,57.0,,116,59,57,116,5.60,51.0
668,tt0122603,Legion of Fire: Killer Ants!,1998,100+,179,7,28,9,2.1,20.0,,0,0,0,0,,
669,tt0056657,La viaccia,1961,Fewer than 50,13,6,0,0,3.9,100.0,,1,0,1,1,,
670,tt0035423,Kate & Leopold,2001,"100,000+",189928,7922,4857,4681,3.5,62.0,,134,70,64,134,5.40,52.0
671,tt0101862,Father of the Bride,1991,"250,000+",375305,6589,2831,5997,3.7,70.0,,44,31,13,44,6.00,70.0
672,tt0101862,Father of the Bride,1991,"250,000+",375305,6589,2831,5997,3.7,70.0,,44,31,13,44,6.00,70.0
673,tt0095774,Off Limits,1988,"1,000+",1687,29,63,33,2.9,32.0,,11,5,6,11,4.90,45.0
674,tt1278469,Temple Grandin,2010,"5,000+",5326,2713,165,821,4.4,94.0,,30,30,0,30,8.70,100.0
675,tt0066301,Rio Lobo,1970,"5,000+",7531,444,183,181,3.7,71.0,,23,16,7,23,6.10,70.0
676,tt0094739,Big Business,1988,"10,000+",20111,814,377,458,3.8,69.0,,22,11,11,22,5.00,50.0
677,tt0093296,Jane and the Lost City,1987,50+,75,2,5,2,2.3,29.0,,2,0,2,2,,
678,tt0078087,Piranha,1978,"10,000+",12450,945,911,546,3.4,51.0,,29,21,8,29,6.50,72.0
679,tt0093727,Personal Services,1987,500+,814,97,24,47,3.9,80.0,,6,4,2,6,6.70,67.0
680,tt1350498,Mega Shark vs. Giant Octopus,2009,"50,000+",52864,350,1419,997,2,20.0,,21,4,17,21,3.50,19.0
681,tt0082084,Bloody Birthday,1981,"1,000+",2119,104,186,103,2.9,36.0,,7,5,2,7,5.20,71.0
682,tt0115895,Chronicle of a Disappearance,1996,500+,641,39,6,7,4,87.0,,6,5,1,6,7.50,83.0
683,tt0322589,Honey,2003,"250,000+",466442,22956,9408,16226,3.8,71.0,,117,24,93,117,4.20,21.0
684,tt0401792,Sin City,2005,"250,000+",32222563,100139,28325,941202,3.3,78.0,,257,195,62,257,7.40,76.0
685,tt0055633,The Young Savages,1961,100+,160,35,32,15,3.3,52.0,,10,5,5,10,5.90,50.0
686,tt0242572,Kandukondain Kandukondain,2000,Fewer than 50,5,5,0,0,4.4,100.0,,1,1,0,1,,
687,tt0094155,Tin Men,1987,"5,000+",5008,276,157,119,3.6,64.0,,23,18,5,23,7.00,78.0
688,tt0279493,Undercover Brother,2002,"50,000+",56280,2904,1601,1727,3.6,64.0,,131,102,29,131,6.70,78.0
689,tt0119311,Hoodlum,1997,"10,000+",10011,654,343,294,3.7,66.0,,21,9,12,21,5.60,43.0
690,tt0102288,Let Him Have It,1991,"1,000+",1126,195,35,80,4,85.0,,38,32,6,38,7.60,84.0
691,tt0080678,The Elephant Man,1980,Fewer than 50,48,14,2,1,3.9,88.0,,0,0,0,0,,
692,tt0361715,Duma,2005,"10,000+",20953,821,199,411,3.9,80.0,,61,58,3,61,7.60,95.0
693,tt0119951,Private Parts,1997,"25,000+",36446,2033,936,899,3.6,68.0,,52,38,14,52,6.30,73.0
694,tt0064506,Ittefaq,1969,100+,157,7,1,5,4,88.0,,0,0,0,0,,
695,tt0961088,While the Children Sleep,2007,250+,456,26,87,35,2.8,23.0,,0,0,0,0,,
696,tt0416315,Wolf Creek,2005,"50,000+",95145,3948,4084,4844,3.1,49.0,,120,65,55,120,5.70,54.0
697,tt1323030,Mending Fences,2009,Fewer than 50,30,4,5,4,2.9,44.0,,0,0,0,0,,
698,tt0093496,Run for Your Life,1988,0,0,0,0,0,,,,0,0,0,0,,
699,tt0395251,The Producers,2005,"250,000+",281355,8996,5347,8829,3.5,63.0,,155,79,76,155,5.90,51.0
700,tt0095593,Married to the Mob,1988,"5,000+",8118,464,485,193,3.3,49.0,,49,43,6,49,7.30,88.0
701,tt0976238,Old Dogs,2009,"100,000+",182938,5594,7137,3930,3,44.0,,110,6,104,110,2.70,5.0
702,tt0061617,Eight on the Lam,1967,50+,89,14,6,4,3.6,70.0,,2,0,2,2,,
703,tt0279967,Mulan II,2004,"50,000+",52446,1652,2193,1445,3,43.0,,5,0,5,5,3.90,0.0
704,tt0094678,Arthur 2: On the Rocks,1988,"5,000+",7503,94,221,109,2.7,30.0,,23,3,20,23,3.70,13.0
705,tt1459034,Deepavali,2007,0,0,0,0,0,,,,0,0,0,0,,
706,tt0053793,Elmer Gantry,1960,"2,500+",3422,439,68,193,4,87.0,,32,30,2,32,7.70,94.0
707,tt0057180,The Incredible Journey,1963,500+,549,146,48,45,3.9,75.0,,9,8,1,9,7.30,89.0
708,tt0080725,Fatty Finn,1980,100+,145,16,5,14,4,76.0,,0,0,0,0,,
709,tt0209095,Leprechaun 5: In the Hood,2000,"10,000+",10354,337,731,487,2.6,32.0,,9,3,6,9,3.80,33.0
710,tt0971183,August Underground's Penance,2007,500+,539,51,50,44,2.9,50.0,,0,0,0,0,,
711,tt0058724,The Visit,1964,250+,269,39,7,16,4,85.0,,0,0,0,0,,
712,tt1423455,The Providence Effect,2009,50+,51,6,2,1,3.6,75.0,,15,7,8,15,6.20,47.0
713,tt0065542,The Cheyenne Social Club,1970,"2,500+",2537,117,55,64,3.7,68.0,,4,4,0,4,,
714,tt0057905,Bullet for a Badman,1964,Fewer than 50,6,3,2,1,3.4,60.0,,0,0,0,0,,
715,tt0097243,A Dry White Season,1989,"2,500+",2580,184,59,63,3.8,76.0,,73,60,13,73,7.40,82.0
716,tt1181795,Bunraku,2010,"2,500+",4527,905,920,450,3.2,50.0,,22,4,18,22,4.20,18.0
717,tt1507325,Machakkaaran,2007,0,0,0,0,0,,,,0,0,0,0,,
718,tt0369436,Four Christmases,2008,"250,000+",254786,10748,12030,8203,3.2,47.0,,145,36,109,145,4.30,25.0
719,tt1621983,Thulluvadho Ilamai,2002,0,0,0,0,0,,,,0,0,0,0,,
720,tt0499603,10 Items or Less,2006,"10,000+",23909,1436,779,1037,3.5,65.0,,59,38,21,59,6.20,64.0
721,tt0074258,Burnt Offerings,1976,"2,500+",4307,286,387,282,3.1,43.0,,15,8,7,15,5.40,53.0
722,tt0462579,The Treatment,2006,"1,000+",1662,56,114,76,2.8,33.0,,41,28,13,41,6.20,68.0
723,tt0119109,Fathers' Day,1997,"10,000+",17081,291,853,226,2.6,25.0,,61,15,46,61,4.20,25.0
724,tt1606600,DC Showcase: Jonah Hex,2010,250+,312,106,44,39,3.7,71.0,,0,0,0,0,,
725,tt0096378,Vibes,1988,"1,000+",1563,179,113,130,3.6,61.0,,23,3,20,23,3.60,13.0
726,tt0782047,Irreversi,2010,Fewer than 50,9,1,0,1,,,,0,0,0,0,,
727,tt0125980,Passion in the Desert,1997,500+,703,35,19,34,3.5,65.0,,20,14,6,20,6.10,70.0
728,tt0826756,Watercolors,2008,250+,254,41,29,21,3.4,59.0,,3,2,1,3,,
729,tt0246674,Harikrishnans,1998,0,0,0,0,0,,,,0,0,0,0,,
730,tt0109975,Half-Cocked,1994,100+,215,5,5,7,3.4,50.0,,2,2,0,2,,
731,tt0090270,Vision Quest,1985,"5,000+",7023,793,222,344,4,78.0,,15,9,6,15,5.60,60.0
732,tt0075214,Shout at the Devil,1976,250+,456,30,63,25,3.1,32.0,,8,4,4,8,5.60,50.0
733,tt1150934,Anacondas 4: Trail of Blood,2009,"25,000+",25222,91,366,165,2.1,20.0,,1,0,1,1,,
734,tt0072095,Romance with a Double Bass,1975,Fewer than 50,15,2,2,3,,,,1,1,0,1,,
735,tt0104267,Final Impact,1992,250+,403,7,20,11,2.7,26.0,,0,0,0,0,,
736,tt0079501,Mad Max,1979,"100,000+",142500,12440,5346,4060,3.7,70.0,,65,58,7,65,7.70,89.0
737,tt0312409,Bad Eggs,2003,"1,000+",1707,127,38,73,3.8,77.0,,0,0,0,0,,
738,tt0081738,The Watcher in the Woods,1980,"5,000+",5713,388,291,313,3.5,57.0,,24,12,12,24,5.10,50.0
739,tt0105275,Romper Stomper,1992,"25,000+",44020,3752,1392,1563,3.7,73.0,,29,23,6,29,6.40,79.0
740,tt0113526,Karan Arjun,1995,"2,500+",3132,211,94,71,3.8,69.0,,0,0,0,0,,
741,tt0974554,Elegy,2008,"50,000+",72724,2148,1388,1456,3.4,61.0,,122,91,31,122,6.70,75.0
742,tt0393616,Proud,2004,Fewer than 50,48,4,12,6,2.8,25.0,,2,2,0,2,,
743,tt0106611,Cool Runnings,1993,"250,000+",533161,17330,4080,15537,4,81.0,,41,31,10,41,6.10,76.0
744,tt0082968,Race for the Yankee Zephyr,1981,50+,70,3,11,4,2.5,21.0,,0,0,0,0,,
745,tt0258816,The Reckoning,2003,"2,500+",4748,256,197,161,3.4,56.0,,88,34,54,88,5.50,39.0
746,tt0095894,Pound Puppies and the Legend of Big Paw,1988,50+,99,12,34,21,2.2,26.0,,2,0,2,2,,
747,tt1278449,Sound of Noise,2010,"1,000+",2266,502,149,123,3.8,77.0,,24,23,1,24,7.20,96.0
748,tt0055214,The Naked Edge,1961,50+,70,11,9,7,3.3,55.0,,2,1,1,2,,
749,tt0425112,Hot Fuzz,2007,"250,000+",566483,125590,14933,63869,4.2,89.0,,204,186,18,204,7.70,91.0
750,tt0399146,A History of Violence,2005,"250,000+",280290,18602,5833,11056,3.7,76.0,,216,189,27,216,7.90,88.0
751,tt0084199,Khud-Daar,1982,0,0,0,0,0,,,,0,0,0,0,,
752,tt1523939,Answers to Nothing,2011,"1,000+",1651,71,127,66,2.8,36.0,,23,2,21,23,3.30,9.0
753,tt0910971,Wallace & Gromit: The Curse of the Were-Rabbit,2005,"10,000+",14758,11684,3074,9105,3.9,79.0,,183,174,9,183,8.10,95.0
754,tt1459467,Micro Men,2009,50+,62,19,3,9,4,86.0,,1,1,0,1,,
755,tt0375997,Nandha,2001,100+,127,7,6,3,3.7,54.0,,0,0,0,0,,
756,tt0073765,Sunday Too Far Away,1975,100+,122,27,7,12,3.8,79.0,,3,2,1,3,,
757,tt0077321,The Cheap Detective,1978,"1,000+",1529,119,91,79,3.4,57.0,,17,9,8,17,5.70,53.0
758,tt0383717,Wilby Wonderful,2004,"1,000+",1906,165,88,114,3.6,65.0,,7,5,2,7,6.30,71.0
759,tt0363589,Elephant,2003,"50,000+",59262,9458,2579,4097,3.8,79.0,,164,122,42,164,7.10,74.0
760,tt0118117,The War at Home,1996,"1,000+",1589,98,33,36,4,75.0,,15,9,6,15,5.80,60.0
761,tt0214388,100 Girls,2000,"25,000+",39843,1011,1016,707,3.2,50.0,,5,3,2,5,5.90,60.0
762,tt0310910,Confidence,2003,"10,000+",17734,1726,753,743,3.7,70.0,,156,107,49,156,6.30,69.0
763,tt1341188,How Do You Know,2010,"25,000+",42113,2476,7602,2317,2.5,25.0,,150,46,104,150,4.90,31.0
764,tt0780516,Flawless,2007,"10,000+",12604,1618,1349,1240,3.3,55.0,,95,53,42,95,5.70,56.0
765,tt0063054,The Helicopter Spies,1968,50+,51,2,6,2,3,25.0,,0,0,0,0,,
766,tt0103006,Sunset Heat,1992,Fewer than 50,19,0,5,1,2.3,0.0,,0,0,0,0,,
767,tt0103242,What Ever Happened to Baby Jane?,1991,50+,72,8,4,2,3.5,67.0,,1,1,0,1,,
768,tt0234697,Server Sundaram,1964,Fewer than 50,38,3,0,0,,,,0,0,0,0,,
769,tt0115676,Big Bully,1996,"5,000+",9779,110,432,165,2.4,20.0,,8,0,8,8,3.40,0.0
770,tt2005374,The Frozen Ground,2013,"10,000+",15710,3004,2989,625,3.3,50.0,,57,35,22,57,5.20,61.0
771,tt0067881,The Trojan Women,1971,500+,607,27,24,21,3.3,53.0,,2,2,0,2,,
772,tt0080638,Do Aur Do Paanch,1980,Fewer than 50,37,11,4,2,3.9,73.0,,0,0,0,0,,
773,tt0105411,Simple Men,1992,"2,500+",3610,374,47,105,4.1,89.0,,11,10,1,11,7.10,91.0
774,tt0109552,Darkman II: The Return of Durant,1995,"10,000+",11534,96,394,172,2.6,20.0,,6,2,4,6,4.50,33.0
775,tt0079815,Rockers,1978,"2,500+",3122,421,23,162,4.5,95.0,,7,6,1,7,5.80,86.0
776,tt0074926,Mrigayaa,1977,0,0,0,0,0,,,,0,0,0,0,,
777,tt0091790,Pretty in Pink,1986,"100,000+",213563,20147,4674,8202,4,81.0,,56,42,14,56,6.40,75.0
778,tt0120008,The Replacement Killers,1998,"25,000+",34320,1081,1234,684,3.2,47.0,,38,14,24,38,5.30,37.0
779,tt0271369,Artham,1989,0,0,0,0,0,,,,0,0,0,0,,
780,tt0255378,Minnaram,1994,0,0,0,0,0,,,,0,0,0,0,,
781,tt0101452,Bill & Ted's Bogus Journey,1991,"100,000+",230744,5635,4492,4943,3.4,56.0,,54,30,24,54,6.00,56.0
782,tt0063661,Sweet November,1968,50+,89,18,11,9,3.4,62.0,,2,1,1,2,,
783,tt0070435,A Name for Evil,1973,"1,000+",1132,5,11,5,2.8,31.0,,0,0,0,0,,
784,tt0783585,Snow Blind,2006,250+,378,1,0,1,,,,5,1,4,5,4.80,20.0
785,tt0365270,Wild Things 2,2004,"5,000+",9874,138,493,195,2.4,22.0,,4,0,4,4,,
786,tt1889440,Teen Maar,2011,100+,117,36,13,9,3.9,73.0,,0,0,0,0,,
787,tt0076144,High Rolling,1977,0,0,0,0,0,,,,0,0,0,0,,
788,tt0064599,The Lonely Profession,1969,0,0,0,0,0,,,,0,0,0,0,,
789,tt0058212,How to Murder Your Wife,1965,"2,500+",3580,287,167,155,3.6,63.0,,14,9,5,14,6.20,64.0
790,tt0163025,Jurassic Park III,2001,"250,000+",527776,9980,17276,14437,3,37.0,,186,91,95,186,5.30,49.0
791,tt0107302,Kalifornia,1993,"25,000+",46947,3445,1932,1364,3.5,64.0,,31,18,13,31,6.10,58.0
792,tt0955306,Noah's Arc: Jumping the Broom,2008,500+,656,116,41,65,3.9,74.0,,12,5,7,12,5.70,42.0
793,tt0106827,Ernest Rides Again,1993,"1,000+",1635,91,127,59,3.1,42.0,,7,1,6,7,3.80,14.0
794,tt0103184,V.I. Warshawski,1991,"5,000+",5495,44,149,60,2.6,23.0,,29,7,22,29,3.60,24.0
795,tt0059354,Khandan,1965,Fewer than 50,27,2,1,0,,,,0,0,0,0,,
796,tt0069134,Pulp,1972,500+,582,51,85,51,3.1,38.0,,13,10,3,13,6.40,77.0
797,tt0089885,Re-Animator,1985,"25,000+",37373,5167,1157,2034,4,82.0,,63,59,4,63,7.80,94.0
798,tt0756288,Blood Debts,1985,Fewer than 50,26,7,8,7,3.1,47.0,,0,0,0,0,,
799,tt0353675,Love Birds,1996,Fewer than 50,7,0,2,0,,,,0,0,0,0,,
800,tt0899269,Chinnodu,2006,0,0,0,0,0,,,,0,0,0,0,,
801,tt0989622,The Bodyguard 2,2007,Fewer than 50,39,2,7,1,2.6,22.0,,3,3,0,3,,
802,tt0814131,Hank and Mike,2008,500+,639,117,102,103,3.2,53.0,,3,0,3,3,,
803,tt0415856,Hounddog,2007,"10,000+",15372,499,554,411,3.1,47.0,,52,8,44,52,3.80,15.0
804,tt0308353,Happily N'Ever After,2006,"100,000+",244360,2423,4636,3627,2.7,34.0,,81,5,76,81,3.30,6.0
805,tt0070654,Scream Bloody Murder,1973,Fewer than 50,48,2,4,1,2.4,33.0,,0,0,0,0,,
806,tt0067921,Valdez Is Coming,1971,"1,000+",1445,70,35,46,3.5,67.0,,4,2,2,4,,
807,tt0324554,Wicker Park,2004,"50,000+",55484,6552,1759,2902,4,79.0,,135,36,99,135,4.40,27.0
808,tt0457275,Altered,2006,"2,500+",3600,336,450,354,2.9,43.0,,4,2,2,4,,
809,tt1068961,Midnight Son,2011,"1,000+",1592,186,130,86,3.4,59.0,,22,21,1,22,6.40,95.0
810,tt0101821,Ernest Scared Stupid,1991,"25,000+",48973,935,897,1224,3.3,51.0,,6,1,5,6,3.50,17.0
811,tt0887793,Yogi,2007,Fewer than 50,1,1,0,0,,,,0,0,0,0,,
812,tt0482603,Space Chimps,2008,"100,000+",124342,1114,2311,1552,2.8,33.0,,91,30,61,91,4.60,33.0
813,tt0283015,Stranded,2001,"1,000+",1482,45,21,38,3.7,68.0,,1,1,0,1,,
814,tt0790676,The Good Life,2007,Fewer than 50,20,8,2,3,3.9,80.0,,1,1,0,1,,
815,tt0361515,Do Jasoos,1975,0,0,0,0,0,,,,0,0,0,0,,
816,tt0158449,Aadmi Aur Insaan,1969,100+,136,3,1,0,,,,0,0,0,0,,
817,tt0118892,Dangerous Beauty,1998,"5,000+",9280,1654,283,620,4.2,85.0,,30,21,9,30,6.40,70.0
818,tt0861350,Header,2006,Fewer than 50,32,5,9,6,2.4,36.0,,1,1,0,1,,
819,tt1029285,The Errand of Angels,2008,100+,220,30,9,9,3.8,76.0,,4,3,1,4,,
820,tt0165994,Treehouse Hostage,1999,Fewer than 50,13,3,5,2,3,38.0,,0,0,0,0,,
821,tt0112893,Down Came a Blackbird,1995,Fewer than 50,17,3,0,1,,,,0,0,0,0,,
822,tt0396938,Witches of the Caribbean,2005,100+,132,3,8,6,2,27.0,,0,0,0,0,,
823,tt0079482,Long Weekend,1978,"1,000+",1407,159,77,95,3.5,67.0,,9,8,1,9,7.80,89.0
824,tt0104225,Falling from Grace,1992,500+,564,13,17,12,3.1,43.0,,9,7,2,9,7.00,78.0
825,tt0330977,Thamizhan,2002,50+,75,0,4,0,,,,0,0,0,0,,
826,tt0095652,Monkey Shines,1988,"5,000+",7473,376,546,299,3.1,41.0,,32,17,15,32,5.40,53.0
827,tt0060463,The Glass Bottom Boat,1966,"2,500+",4639,238,84,127,3.9,74.0,,7,4,3,7,5.70,57.0
828,tt1563704,Legendary,2010,"2,500+",3561,683,466,238,3.5,59.0,,45,9,36,45,4.80,20.0
829,tt1753549,Buck,2011,"2,500+",4783,1212,155,318,4.2,89.0,,105,94,11,105,7.50,90.0
830,tt0342172,Capturing the Friedmans,2003,"5,000+",9786,1870,240,681,4.1,89.0,,153,149,4,153,8.50,97.0
831,tt1190617,An American Carol,2008,"10,000+",15786,790,875,847,3,48.0,,49,6,43,49,3.30,12.0
832,tt0864761,The Duchess,2008,"50,000+",68976,7479,3731,4464,3.6,67.0,,170,106,64,170,6.30,62.0
833,tt0086508,Uncommon Valor,1983,"5,000+",6895,322,203,151,3.5,61.0,,10,6,4,10,6.10,60.0
834,tt0072761,Capone,1975,250+,486,24,69,24,2.7,26.0,,2,1,1,2,,
835,tt0097958,National Lampoon's Christmas Vacation,1989,"100,000+",223386,16524,2634,8998,4.2,86.0,,54,38,16,54,6.20,70.0
836,tt0091559,Mouna Ragam,1986,0,0,0,0,0,,,,0,0,0,0,,
837,tt0362696,Haasil,2003,250+,259,31,14,13,3.7,69.0,,1,1,0,1,,
838,tt0213065,The Lorax,1972,"1,000+",1968,584,120,103,4.2,83.0,,1,1,0,1,,
839,tt0120435,Velocity Trap,1999,500+,613,6,19,12,2.2,24.0,,3,0,3,3,,
840,tt0914364,Deadwater,2008,50+,70,1,11,5,1.9,8.0,,0,0,0,0,,
841,tt1319707,Deeper and Deeper,2010,0,0,0,0,0,,,,0,0,0,0,,
842,tt0095875,Plain Clothes,1988,100+,140,17,11,9,3.6,61.0,,1,0,1,1,,
843,tt1000774,Sex and the City,2008,"250,000+",464040,49518,14744,30564,4,77.0,,183,91,92,183,5.60,50.0
844,tt0059314,Inside Daisy Clover,1965,500+,687,96,92,58,3.4,51.0,,17,5,12,17,5.10,29.0
845,tt0101700,Delicatessen,1991,"25,000+",47312,10847,1076,3021,4.2,91.0,,58,52,6,58,7.80,90.0
846,tt0097781,Lords of the Deep,1989,Fewer than 50,35,3,17,10,1.6,15.0,,0,0,0,0,,
847,tt0391304,A Lot Like Love,2005,"50,000+",76789,8612,2581,3586,3.9,77.0,,124,51,73,124,5.00,41.0
848,tt4887722,Bhoopadathil Illatha Oridam,2012,0,0,0,0,0,,,,0,0,0,0,,
849,tt0107983,Romeo Is Bleeding,1993,"5,000+",7599,584,365,287,3.6,61.0,,41,11,30,41,4.70,27.0
850,tt1078904,The Last Hurrah,2009,Fewer than 50,17,6,2,0,4.1,75.0,,0,0,0,0,,
851,tt0356124,Three Men Army,1995,0,0,0,0,0,,,,0,0,0,0,,
852,tt2073138,Vedi,2011,Fewer than 50,12,4,4,0,2.8,50.0,,0,0,0,0,,
853,tt0234354,Novocaine,2001,"5,000+",7462,323,539,234,3,38.0,,107,41,66,107,4.70,38.0
854,tt0239625,Mermaid,2000,"1,000+",1736,50,25,24,3.7,67.0,,0,0,0,0,,
855,tt0090934,Desert Bloom,1986,500+,810,24,11,13,3.6,69.0,,13,9,4,13,6.90,69.0
856,tt0120070,Savior,1998,"2,500+",4438,394,98,141,4,80.0,,9,5,4,9,6.60,56.0
857,tt1158936,Eden à l'Ouest,2009,0,0,0,0,0,,,,0,0,0,0,,
858,tt0154390,Des Pardes,1978,Fewer than 50,47,1,0,0,,,,0,0,0,0,,
859,tt0093260,Innerspace,1987,"25,000+",35567,2057,1098,942,3.5,65.0,,44,36,8,44,6.80,82.0
860,tt0069334,Swayamvaram,1972,0,0,0,0,0,,,,0,0,0,0,,
861,tt0772132,The World's Best Prom,2006,Fewer than 50,30,3,7,5,3.3,30.0,,2,1,1,2,,
862,tt1579975,Mitrudu,2009,0,0,0,0,0,,,,0,0,0,0,,
863,tt0085121,10 to Midnight,1983,"10,000+",12404,176,168,135,3.3,51.0,,10,4,6,10,5.30,40.0
864,tt0430702,Tumsa Nahin Dekha,2004,0,0,0,0,0,,,,0,0,0,0,,
865,tt0212380,Blow Dry,2001,"10,000+",10205,572,475,388,3.3,55.0,,64,12,52,64,4.10,19.0
866,tt0113077,Flamenco,1995,Fewer than 50,10,2,3,0,3.4,40.0,,1,1,0,1,,
867,tt0061169,Waco,1966,Fewer than 50,2,2,0,1,,,,0,0,0,0,,
868,tt0077174,Are You in the House Alone?,1978,250+,319,15,43,19,2.8,26.0,,1,1,0,1,,
869,tt0058270,Kohraa,1964,0,0,0,0,0,,,,0,0,0,0,,
870,tt1667903,Thor: Tales of Asgard,2011,"1,000+",1610,221,269,112,3.2,45.0,,2,2,0,2,,
871,tt0335013,The Company,2003,"5,000+",7664,434,451,358,3.2,49.0,,132,95,37,132,6.60,72.0
872,tt0067402,"Mary, Queen of Scots",1971,500+,656,93,76,70,3.4,55.0,,9,6,3,9,7.30,67.0
873,tt0058561,The Secret Invasion,1964,100+,120,14,6,3,3.4,70.0,,3,2,1,3,,
874,tt0067309,Klute,1971,"5,000+",6781,1160,296,398,3.8,80.0,,44,41,3,44,8.20,93.0
875,tt0061391,Bedazzled,1967,"10,000+",10512,703,252,421,3.8,74.0,,38,28,10,38,7.60,74.0
876,tt0411477,Hellboy II: The Golden Army,2008,"250,000+",822742,35389,14534,21888,3.6,71.0,,249,214,35,249,7.20,86.0
877,tt1986788,Chal Chalein,2009,0,0,0,0,0,,,,0,0,0,0,,
878,tt1444270,Politics of Love,2011,100+,135,19,24,11,3.1,44.0,,1,1,0,1,,
879,tt0456500,Kyaa Kool Hai Hum,2005,500+,535,46,34,17,3.5,58.0,,0,0,0,0,,
880,tt1320352,Nothing Personal,2009,"1,000+",1215,191,82,41,3.6,70.0,,11,9,2,11,6.70,82.0
881,tt1673697,The Sapphires,2012,"10,000+",13338,3152,993,634,3.8,76.0,,139,127,12,139,6.90,91.0
882,tt0150786,Gregory's Two Girls,1999,50+,55,1,13,4,2.4,7.0,,0,0,0,0,,
883,tt1285010,Summer's Blood,2009,"1,000+",1239,134,307,135,2.6,30.0,,2,0,2,2,,
884,tt1272006,Besa,2009,0,0,0,0,0,,,,0,0,0,0,,
885,tt0113820,Mighty Morphin Power Rangers: The Movie,1995,"50,000+",50199,2214,1701,2444,3.5,57.0,,37,12,25,37,4.40,32.0
886,tt0111149,Shallow Grave,1994,"25,000+",40003,4913,1018,1484,3.9,83.0,,52,37,15,52,6.40,71.0
887,tt0285086,Farewell to Harry,2002,500+,516,10,4,5,3.9,71.0,,0,0,0,0,,
888,tt0120831,Slums of Beverly Hills,1998,"5,000+",8906,868,406,318,3.6,68.0,,62,50,12,62,7.00,81.0
889,tt0070585,The Questor Tapes,1974,0,0,0,0,0,,,,0,0,0,0,,
890,tt0098536,Turner & Hooch,1989,"100,000+",190090,2902,2734,2758,3.3,51.0,,28,14,14,28,5.30,50.0
891,tt1477855,Hyde Park on Hudson,2012,"10,000+",10651,904,1975,501,2.9,31.0,,177,66,111,177,5.30,37.0
892,tt0087238,Fanny Pelopaja,1984,0,0,0,0,0,,,,0,0,0,0,,
893,tt0433605,Naach,2004,500+,741,33,21,23,3.2,61.0,,0,0,0,0,,
894,tt0337978,Live Free or Die Hard,2007,"250,000+",1860147,180435,29490,116609,4.1,86.0,,209,172,37,209,6.80,82.0
895,tt0462465,Outlander,2008,"25,000+",46947,2114,2634,2080,3.1,45.0,,63,23,40,63,4.90,37.0
896,tt0499501,If You Could Say It in Words,2008,0,0,0,0,0,,,,0,0,0,0,,
897,tt0088000,Revenge of the Nerds,1984,"50,000+",56584,3737,1409,1737,3.8,73.0,,41,29,12,41,6.10,71.0
898,tt0323619,Periya Idathu Penn,1963,0,0,0,0,0,,,,0,0,0,0,,
899,tt0164993,Alice in Wonderland,1999,"10,000+",24516,1076,655,574,3.5,62.0,,6,2,4,6,4.70,33.0
900,tt0378720,The Search for Animal Chin,1987,0,0,0,0,0,,,,0,0,0,0,,
901,tt0997273,We're Here to Help,2007,Fewer than 50,5,2,1,1,,,,0,0,0,0,,
902,tt1641410,Terraferma,2011,250+,293,81,62,19,3.4,57.0,,24,16,8,24,6.30,67.0
903,tt0117676,Snowboard Academy,1997,250+,427,18,46,24,2.5,28.0,,1,0,1,1,,
904,tt0374563,Captivity,2007,"250,000+",328917,1780,5911,4580,2.4,23.0,,77,7,70,77,3.30,9.0
905,tt0107096,Heaven & Earth,1993,"1,000+",1012,105,12,51,4.2,90.0,,4,3,1,4,,
906,tt0428144,Category 6: Day of Destruction,2004,"10,000+",15588,118,94,127,3.3,56.0,,2,1,1,2,,
907,tt0083115,Splendor in the Grass,1981,0,0,0,0,0,,,,0,0,0,0,,
908,tt0181536,Finding Forrester,2000,"50,000+",82127,8107,2184,2724,3.9,79.0,,129,96,33,129,6.50,74.0
909,tt1634058,Star Vehicle,2010,Fewer than 50,3,0,1,0,,,,0,0,0,0,,
910,tt0187251,Lovers Lane,2000,500+,656,14,37,19,2.5,28.0,,1,0,1,1,,
911,tt0110265,Killing Zoe,1993,"10,000+",12928,1101,611,522,3.5,64.0,,28,10,18,28,5.30,36.0
912,tt0959324,Max & Co,2007,250+,330,17,23,13,3.1,44.0,,0,0,0,0,,
913,tt0078767,The Amityville Horror,1979,"50,000+",87007,2822,2654,2385,3.3,52.0,,45,14,31,45,4.80,31.0
914,tt0078945,The Castaways on Gilligan's Island,1979,0,0,0,0,0,,,,0,0,0,0,,
915,tt0084726,Star Trek II: The Wrath of Khan,1982,"50,000+",85851,12422,1346,4917,4.3,90.0,,75,65,10,75,8.10,87.0
916,tt0117731,Star Trek: First Contact,1996,"100,000+",100899,10601,1345,4043,4.2,89.0,,68,63,5,68,7.50,93.0
917,tt0080888,Honeysuckle Rose,1980,500+,722,50,17,22,3.8,75.0,,5,3,2,5,7.00,60.0
918,tt0108253,Sunset Grill,1993,50+,82,2,11,4,2.4,15.0,,1,1,0,1,,
919,tt0213524,Bluff Master,1963,0,0,0,0,0,,,,0,0,0,0,,
920,tt0272360,Winning London,2001,"10,000+",21264,891,703,375,3.4,56.0,,1,0,1,1,,
921,tt1807892,Holiday Engagement,2011,250+,363,58,110,26,2.9,34.0,,3,1,2,3,,
922,tt1980970,Gandhi to Hitler,2011,Fewer than 50,15,2,8,2,2,20.0,,1,0,1,1,,
923,tt0070556,Poor Pretty Eddie,1975,100+,144,17,29,21,3.1,37.0,,1,1,0,1,,
924,tt0091895,Saving Grace,1986,Fewer than 50,42,12,4,9,4,75.0,,1,1,0,1,,
925,tt0187271,Masterji,1985,100+,144,0,2,1,,,,0,0,0,0,,
926,tt0082948,Private Lessons,1981,"1,000+",1923,51,101,52,2.7,34.0,,6,0,6,6,3.20,0.0
927,tt1640571,Titanic II,2010,"1,000+",1618,104,587,274,1.6,15.0,,2,1,1,2,,
928,tt0082501,Hardly Working,1980,50+,54,6,18,12,2.6,25.0,,11,1,10,11,4.00,9.0
929,tt0118884,Contact,1997,"100,000+",204139,13211,3630,6485,3.9,78.0,,69,47,22,69,6.90,68.0
930,tt0118884,Contact,1997,"100,000+",204139,13211,3630,6485,3.9,78.0,,69,47,22,69,6.90,68.0
931,tt1398428,YellowBrickRoad,2010,"1,000+",1973,191,440,184,2.5,30.0,,18,9,9,18,5.30,50.0
932,tt0079455,The Legend of the Golden Gun,1979,Fewer than 50,1,1,0,1,,,,0,0,0,0,,
933,tt2182099,Satrangi Re,2012,Fewer than 50,1,0,1,0,,,,0,0,0,0,,
934,tt0094850,Cellar Dweller,1987,250+,411,25,69,33,2.8,27.0,,3,0,3,3,,
935,tt0076512,Outlaw Blues,1977,50+,98,5,6,3,3.1,45.0,,0,0,0,0,,
936,tt0290382,A Wrinkle in Time,2003,"5,000+",7541,176,264,234,2.9,40.0,,3,2,1,3,,
937,tt0120670,Firestorm,1998,"5,000+",6393,57,155,88,2.6,27.0,,26,3,23,26,3.70,12.0
938,tt0072194,Souvenirs d'en France,1975,0,0,0,0,0,,,,2,2,0,2,,
939,tt0141098,Forces of Nature,1999,"50,000+",57671,1082,2059,936,2.9,34.0,,66,30,36,66,5.30,45.0
940,tt0119947,Prince Valiant,1997,250+,460,23,72,27,2.7,24.0,,4,0,4,4,,
941,tt0174245,Storm Damage,2000,0,0,0,0,0,,,,0,0,0,0,,
942,tt0140796,Air Bud: Golden Receiver,1998,"50,000+",85097,303,495,577,2.9,38.0,,29,6,23,29,4.30,21.0
943,tt0068235,Au Pair Girls,1972,500+,762,9,21,12,2.6,30.0,,1,1,0,1,,
944,tt0112269,Aao Pyaar Karen,1994,Fewer than 50,2,2,0,0,,,,0,0,0,0,,
945,tt0071877,Murder on the Orient Express,1974,"10,000+",20983,2447,676,832,3.8,78.0,,42,38,4,42,7.80,90.0
946,tt0234000,Kaho Naa... Pyaar Hai,2000,"5,000+",6895,522,126,229,4.1,80.0,,0,0,0,0,,
947,tt0446752,Full of It,2007,"10,000+",15511,307,367,139,3.1,45.0,,18,1,17,18,3.10,6.0
948,tt0416688,Dishdogz,2005,250+,422,29,26,14,3.3,52.0,,1,0,1,1,,
949,tt0069368,That Certain Summer,1972,Fewer than 50,1,0,1,0,,,,1,1,0,1,,
950,tt0071307,36 Ghante,1974,Fewer than 50,33,1,0,0,,,,0,0,0,0,,
951,tt1680314,Pennpattanam,2010,0,0,0,0,0,,,,0,0,0,0,,
952,tt0085838,Lianna,1983,"1,000+",1019,69,41,34,3.5,63.0,,21,17,4,21,7.20,81.0
953,tt0277774,Kakkakuyil,2001,0,0,0,0,0,,,,0,0,0,0,,
954,tt0261842,Mullet,2001,500+,619,19,25,20,3.1,43.0,,3,3,0,3,,
955,tt0305669,Bringing Down the House,2003,"250,000+",379246,2723,2816,5849,3.2,49.0,,151,51,100,151,4.80,34.0
956,tt0199727,"Love, Honour and Obey",2000,"5,000+",7403,962,154,513,4.3,86.0,,18,6,12,18,4.20,33.0
957,tt0211792,Cutaway,2000,"1,000+",1568,34,41,28,3.1,45.0,,2,1,1,2,,
958,tt0421082,Control,2007,"25,000+",48533,13960,1737,6475,4.2,89.0,,119,105,14,119,7.40,88.0
959,tt0421082,Control,2007,"25,000+",48533,13960,1737,6475,4.2,89.0,,119,105,14,119,7.40,88.0
960,tt0448552,Immini Nalloraal,2005,0,0,0,0,0,,,,0,0,0,0,,
961,tt0279017,Chattakkari,1974,0,0,0,0,0,,,,0,0,0,0,,
962,tt1449283,Winnie the Pooh,2011,"25,000+",36456,5515,1391,1462,4,80.0,,133,120,13,133,7.20,90.0
963,tt0069993,"Don't Just Lie There, Say Something!",1974,250+,264,4,4,3,3.5,50.0,,0,0,0,0,,
964,tt0366816,Ennaku 20 Unakku 18,2003,0,0,0,0,0,,,,0,0,0,0,,
965,tt0100709,Struck by Lightning,1990,0,0,0,0,0,,,,0,0,0,0,,
966,tt0093420,Lily C.A.T.,1987,100+,171,6,5,3,3.4,55.0,,1,1,0,1,,
967,tt0137937,Mary and Rhoda,2000,Fewer than 50,27,6,4,2,3.1,60.0,,0,0,0,0,,
968,tt1703942,Schuks Tshabalala's Survival Guide to South Africa,2010,0,0,0,0,0,,,,0,0,0,0,,
969,tt0338751,The Aviator,2004,"100,000+",207945,21497,5640,8025,3.8,79.0,,227,196,31,227,7.80,86.0
970,tt0095217,Ghosts... of the Civil Dead,1988,"1,000+",1219,100,35,55,3.8,74.0,,1,1,0,1,,
971,tt1421378,Scooby-Doo! And the Samurai Sword,2008,250+,302,75,59,23,3.5,56.0,,1,1,0,1,,
972,tt0058202,Minnesota Clay,1964,100+,196,13,28,13,3,32.0,,1,1,0,1,,
973,tt0954990,The Yellow Handkerchief,2008,"10,000+",13160,719,485,198,3.5,59.0,,51,33,18,51,6.00,65.0
974,tt1216520,Womb,2010,"1,000+",2496,325,388,139,3,45.0,,20,7,13,20,4.90,35.0
975,tt1334510,Afghan Star,2009,"5,000+",7887,384,116,128,3.7,77.0,,62,62,0,62,7.70,100.0
976,tt0430647,Sun Sajna,1982,0,0,0,0,0,,,,0,0,0,0,,
977,tt0475944,The Covenant,2006,"250,000+",400004,12224,7486,12980,3.5,62.0,,76,3,73,76,2.90,4.0
978,tt0248234,Ninaithathai Mudippavan,1975,0,0,0,0,0,,,,0,0,0,0,,
979,tt0098724,"Sex, Lies, and Videotape",1989,"25,000+",32696,3700,991,1071,3.9,79.0,,54,52,2,54,8.00,96.0
980,tt0469689,The Last Time,2006,"2,500+",4699,207,322,258,3,39.0,,17,6,11,17,4.90,35.0
981,tt0120131,The Lion King 2: Simba's Pride,1998,"250,000+",438844,8211,5347,10132,3.6,61.0,,12,8,4,12,6.10,67.0
982,tt0063462,The Producers,1967,"50,000+",56213,6362,1117,2618,4.1,85.0,,74,67,7,74,8.20,91.0
983,tt0968264,The Conspirator,2010,"10,000+",21226,3154,1965,1224,3.5,62.0,,173,97,76,173,6.10,56.0
984,tt2309021,We Are What We Are,2013,"10,000+",11324,1699,1724,408,3.2,50.0,,91,78,13,91,7.00,86.0
985,tt0088693,Alice in Wonderland,1985,Fewer than 50,1,1,0,0,,,,0,0,0,0,,
986,tt0172493,"Girl, Interrupted",1999,"100,000+",243011,22160,4358,8012,4.1,84.0,,116,62,54,116,5.70,53.0
987,tt0056700,The Wonderful World of the Brothers Grimm,1962,"1,000+",1733,48,29,38,3.6,62.0,,4,3,1,4,,
988,tt0308310,I Downloaded a Ghost,2002,250+,403,14,27,13,2.9,34.0,,1,1,0,1,,
989,tt0067866,El Topo,1970,"10,000+",14672,3021,579,1289,4.1,84.0,,46,37,9,46,7.10,80.0
990,tt1536048,W.E.,2011,"5,000+",5109,739,803,346,3.2,48.0,,113,14,99,113,4.20,12.0
991,tt0086999,Breakin' 2: Electric Boogaloo,1984,"5,000+",7499,542,263,389,3.8,67.0,,7,2,5,7,4.10,29.0
992,tt0817538,Drillbit Taylor,2008,"50,000+",98060,6444,8342,6203,3.1,44.0,,147,39,108,147,4.60,27.0
993,tt0288439,Bang Bang You're Dead,2002,"5,000+",8321,1057,117,471,4.3,90.0,,2,1,1,2,,
994,tt0059274,The Hill,1965,"2,500+",3986,583,51,209,4.3,92.0,,7,5,2,7,7.80,71.0
995,tt0432260,Brothers of the Head,2005,"10,000+",19385,297,150,209,3.6,66.0,,69,48,21,69,6.60,70.0
996,tt0279154,Jedermanns Fest,2002,0,0,0,0,0,,,,0,0,0,0,,
997,tt0120255,The Sweet Hereafter,1997,"10,000+",11689,2364,392,729,4.1,86.0,,60,59,1,60,8.90,98.0
998,tt0113097,Forget Paris,1995,"5,000+",9826,603,467,307,3.4,56.0,,34,17,17,34,5.40,50.0
999,tt0439753,Paid,2006,Fewer than 50,15,0,3,0,,,,0,0,0,0,,
1000,tt1655420,My Week with Marilyn,2011,"25,000+",34902,9892,4026,2628,3.6,71.0,,189,156,33,189,7.10,83.0
1001,tt0817940,Naresuan,2007,Fewer than 50,3,0,3,1,,,,1,0,1,1,,
1002,tt0088272,Tightrope,1984,"5,000+",7694,419,419,198,3.3,50.0,,13,11,2,13,6.70,85.0
1003,tt0061565,Devil's Angels,1967,50+,95,4,11,6,2.5,27.0,,1,0,1,1,,
1004,tt0119734,Music from Another Room,1998,"5,000+",6188,429,209,202,3.7,67.0,,7,3,4,7,5.20,43.0
1005,tt0103105,Toto le héros,1991,"1,000+",2379,360,32,78,4.3,92.0,,13,11,2,13,8.30,85.0
1006,tt1637725,Ted,2012,"250,000+",375895,88268,31951,14501,3.8,73.0,,223,153,70,223,6.40,69.0
1007,tt2357208,Run Baby Run,2012,Fewer than 50,34,13,5,3,4,72.0,,0,0,0,0,,
1008,tt0307535,Getting There,2002,"10,000+",11109,525,547,246,3.2,49.0,,1,0,1,1,,
1009,tt0127349,Waking the Dead,2000,"5,000+",5013,527,152,259,3.9,78.0,,56,28,28,56,5.80,50.0
1010,tt0271648,Mrigaya,1989,Fewer than 50,2,2,0,0,,,,1,1,0,1,,
1011,tt0088011,Romancing the Stone,1984,"50,000+",77758,3848,1703,1797,3.7,69.0,,56,48,8,56,7.30,86.0
1012,tt0108234,Street Knight,1993,250+,372,10,17,12,2.9,37.0,,4,0,4,4,,
1013,tt0418586,The Cake Eaters,2007,"10,000+",12631,593,640,364,3.2,48.0,,25,16,9,25,6.00,64.0
1014,tt0119989,Shadow of Doubt,1998,500+,569,4,21,7,2.4,16.0,,4,0,4,4,,
1015,tt0073008,The Fortune,1975,250+,455,35,68,34,3,34.0,,8,2,6,8,5.00,25.0
1016,tt0120751,Mighty Joe Young,1998,"100,000+",195498,1177,1727,2325,3.1,41.0,,54,29,25,54,5.90,54.0
1017,tt0133372,Annabelle's Wish,1997,"5,000+",9280,107,37,121,4,74.0,,1,1,0,1,,
1018,tt0054892,Francis of Assisi,1961,Fewer than 50,6,3,3,2,3.2,50.0,,0,0,0,0,,
1019,tt0069751,Bandhe Haath,1973,Fewer than 50,22,1,0,0,,,,0,0,0,0,,
1020,tt13979680,Vivaramana Aalu,2002,0,0,0,0,0,,,,0,0,0,0,,
1021,tt0131566,Rogue Trader,1999,"5,000+",5317,324,299,160,3.4,52.0,,23,7,16,23,4.90,30.0
1022,tt0209933,Beau travail,1999,"2,500+",2880,468,136,164,3.9,77.0,,44,38,6,44,7.80,86.0
1023,tt0072401,Where the Lilies Bloom,1974,250+,484,31,3,13,4.4,91.0,,2,2,0,2,,
1024,tt0267813,Papi Gudia,1996,0,0,0,0,0,,,,0,0,0,0,,
1025,tt0063799,What's So Bad About Feeling Good?,1968,50+,84,5,3,3,3.9,62.0,,3,3,0,3,,
1026,tt1171701,Nefes: Vatan Sagolsun,2009,250+,459,174,46,39,3.9,79.0,,0,0,0,0,,
1027,tt0392878,The Onion Movie,2008,"5,000+",7526,1243,1460,1385,3.1,46.0,,3,1,2,3,,
1028,tt0061712,The Girl the Body and the Pill,1967,Fewer than 50,10,1,1,0,,,,0,0,0,0,,
1029,tt0109759,Exotica,1994,"5,000+",8120,1172,243,334,4,83.0,,39,37,2,39,8.30,95.0
1030,tt1043851,Lakshyam,2007,100+,143,3,2,1,3.2,60.0,,0,0,0,0,,
1031,tt0105191,Pure Country,1992,"10,000+",19725,1635,176,782,4.5,90.0,,22,9,13,22,4.70,41.0
1032,tt0312305,Quantum Quest: A Cassini Space Odyssey,2010,"1,000+",1191,25,10,6,4,71.0,,0,0,0,0,,
1033,tt1127715,Sin nombre,2009,"10,000+",21331,3973,507,1272,4.1,89.0,,120,106,14,120,7.50,88.0
1034,tt0365830,Tenacious D in The Pick of Destiny,2006,"250,000+",436668,17522,8707,14529,3.7,67.0,,124,65,59,124,5.60,52.0
1035,tt0057244,The Leather Boys,1964,100+,173,24,8,11,3.7,75.0,,13,10,3,13,5.80,77.0
1036,tt0104142,Driving Me Crazy,1991,50+,79,2,10,3,2.5,17.0,,1,0,1,1,,
1037,tt0087815,Not for Publication,1984,Fewer than 50,16,2,3,0,2.9,40.0,,1,0,1,1,,
1038,tt0088734,Arch of Triumph,1984,50+,85,3,12,7,2.5,20.0,,0,0,0,0,,
1039,tt0416706,Dynasty: The Making of a Guilty Pleasure,2005,Fewer than 50,1,0,1,1,,,,0,0,0,0,,
1040,tt0106979,Full Contact,1993,250+,413,10,4,8,3.6,71.0,,2,1,1,2,,
1041,tt0092069,Terminal Entry,1987,Fewer than 50,10,0,1,0,,,,0,0,0,0,,
1042,tt0084649,The Secret of NIMH,1982,"5,000+",5162,4412,750,2062,4.1,85.0,,68,63,5,68,7.50,93.0
1043,tt1039995,U Me Aur Hum,2008,"2,500+",3298,397,330,401,3.3,55.0,,5,3,2,5,5.70,60.0
1044,tt0196069,Samsara,2001,"5,000+",6540,575,68,152,4.3,89.0,,5,5,0,5,7.30,100.0
1045,tt2078763,Vaagai Sooda Vaa,2011,Fewer than 50,7,7,0,2,4.4,100.0,,1,1,0,1,,
1046,tt0055632,The Young Doctors,1961,Fewer than 50,45,5,5,5,3.4,50.0,,3,2,1,3,,
1047,tt0907301,Hasta el viento tiene miedo,2007,250+,383,23,47,24,2.5,33.0,,0,0,0,0,,
1048,tt0367088,Spymate,2003,"1,000+",1120,58,89,65,2.8,39.0,,6,1,5,6,3.10,17.0
1049,tt0293564,Rush Hour 3,2007,"250,000+",582777,52309,31271,34088,3.5,63.0,,158,27,131,158,4.20,17.0
1050,tt0109039,Accidental Meeting,1994,Fewer than 50,30,2,1,0,,,,0,0,0,0,,
1051,tt0331509,Funky Monkey,2004,"1,000+",1647,39,42,48,3.1,48.0,,0,0,0,0,,
1052,tt0243585,Stuart Little 2,2002,"100,000+",179804,1522,2175,1546,3.1,41.0,,123,100,23,123,6.90,81.0
1053,tt1266542,The Break-Up Artist,2009,0,0,0,0,0,,,,0,0,0,0,,
1054,tt0102960,Sometimes They Come Back,1991,"10,000+",11162,652,419,230,3.7,61.0,,12,8,4,12,5.30,67.0
1055,tt0076567,The Private Files of J. Edgar Hoover,1977,100+,148,9,10,4,3.3,47.0,,4,3,1,4,,
1056,tt0492488,So Much So Fast,2006,"10,000+",12115,41,7,19,4,85.0,,23,22,1,23,8.00,96.0
1057,tt0104431,Home Alone 2: Lost in New York,1992,"250,000+",910355,15520,9564,19624,3.6,62.0,,57,20,37,57,4.50,35.0
1058,tt1642620,Hindenburg: The Last Flight,2011,Fewer than 50,14,2,7,2,2.8,22.0,,0,0,0,0,,
1059,tt0244000,American Outlaws,2001,"25,000+",44293,1458,714,824,3.7,67.0,,102,13,89,102,3.60,13.0
1060,tt0058382,Murder Ahoy,1964,250+,339,58,52,32,3.5,53.0,,4,3,1,4,,
1061,tt0314197,Imagining Argentina,2003,"2,500+",4096,257,103,116,3.6,71.0,,13,4,9,13,4.30,31.0
1062,tt0065936,Kati Patang,1970,100+,216,17,4,8,4.1,81.0,,0,0,0,0,,
1063,tt1124386,Pankh,2010,50+,50,2,13,9,1.5,13.0,,1,0,1,1,,
1064,tt0087981,Razorback,1984,"2,500+",2864,185,200,163,3.2,48.0,,12,7,5,12,5.80,58.0
1065,tt1626644,Nayakan,2010,0,0,0,0,0,,,,0,0,0,0,,
1066,tt1224454,Sirf,2008,100+,113,11,8,14,3.2,58.0,,0,0,0,0,,
1067,tt0266643,In Absentia,2000,50+,94,16,2,0,4.3,89.0,,0,0,0,0,,
1068,tt0091949,Short Circuit,1986,"100,000+",169084,4165,2053,3943,3.7,67.0,,38,23,15,38,5.30,61.0
1069,tt0086873,All of Me,1984,"10,000+",14384,944,465,431,3.6,67.0,,40,34,6,40,7.30,85.0
1070,tt0097858,Meet the Feebles,1989,"10,000+",15771,1821,682,1110,3.7,73.0,,25,18,7,25,6.60,72.0
1071,tt0393421,Larva,2005,250+,477,11,45,22,2.4,20.0,,0,0,0,0,,
1072,tt0082235,Dark Night of the Scarecrow,1981,500+,934,226,124,131,3.6,65.0,,7,4,3,7,5.60,57.0
1073,tt0385017,In My Father's Den,2004,"2,500+",4748,680,86,249,4.2,89.0,,11,11,0,11,7.10,100.0
1074,tt0363988,Secret Window,2004,"250,000+",429340,22594,12106,18168,3.6,65.0,,161,73,88,161,5.50,45.0
1075,tt0091315,KGB: The Secret War,1985,Fewer than 50,5,0,2,1,,,,0,0,0,0,,
1076,tt0066033,Macho Callahan,1970,Fewer than 50,10,0,1,0,,,,1,0,1,1,,
1077,tt0245380,Quints,2000,500+,616,85,85,26,3.2,50.0,,1,0,1,1,,
1078,tt0086036,Of Unknown Origin,1983,"1,000+",1275,61,91,66,3.1,40.0,,8,5,3,8,5.90,63.0
1079,tt0080661,Dressed to Kill,1980,"10,000+",10707,1696,605,577,3.7,74.0,,59,49,10,59,6.70,83.0
1080,tt0280460,The Banger Sisters,2002,"25,000+",44773,723,1010,646,3.1,42.0,,144,69,75,144,5.30,48.0
1081,tt0188694,An Invited Guest,1999,"1,000+",1355,108,36,48,4,75.0,,4,1,3,4,,
1082,tt0164108,The Muse,1999,"5,000+",6722,209,408,143,2.9,34.0,,79,41,38,79,5.90,52.0
1083,tt0145653,Angela's Ashes,1999,"10,000+",22710,1867,438,847,4,81.0,,85,44,41,85,5.80,52.0
1084,tt0068503,Dr. Phibes Rises Again,1972,"5,000+",6215,229,172,177,3.4,57.0,,21,12,9,21,5.90,57.0
1085,tt0069995,Don't Look Now,1973,"10,000+",18948,3268,1034,1361,3.8,76.0,,85,79,6,85,8.90,93.0
1086,tt0059017,Cat Ballou,1965,"5,000+",9195,793,279,389,3.8,74.0,,30,27,3,30,7.40,90.0
1087,tt0325537,Head of State,2003,"50,000+",55923,1179,1360,1027,3.2,46.0,,120,36,84,120,4.80,30.0
1088,tt0090180,To Live and Die in L.A.,1985,"10,000+",10626,1822,496,702,3.8,79.0,,51,45,6,51,7.30,88.0
1089,tt0298408,Laurel Canyon,2002,"5,000+",9240,819,741,450,3.3,52.0,,113,77,36,113,6.40,68.0
1090,tt0910993,Beyond the Ring,2008,"2,500+",3602,112,96,17,3.3,54.0,,0,0,0,0,,
1091,tt0080532,A Christmas Without Snow,1980,"1,000+",1378,8,12,15,2.8,40.0,,0,0,0,0,,
1092,tt0062136,Playtime,1967,"5,000+",7494,1873,225,579,4.3,89.0,,55,54,1,55,9.00,98.0
1093,tt0117332,Phat Beach,1996,"1,000+",1421,43,52,44,3,45.0,,4,0,4,4,,
1094,tt0988047,Traitor,2008,"50,000+",64245,4856,2749,3420,3.5,64.0,,170,110,60,170,6.20,65.0
1095,tt0063067,Nobody Runs Forever,1968,Fewer than 50,49,4,3,5,3.4,57.0,,1,1,0,1,,
1096,tt0061749,The Happiest Millionaire,1967,"2,500+",3326,199,48,129,4.2,81.0,,6,3,3,6,5.70,50.0
1097,tt0446765,Punk: Attitude,2005,"2,500+",3119,261,29,104,4.1,90.0,,2,2,0,2,,
1098,tt29362459,Overdrawn at the Memory Bank,1984,500+,567,19,94,59,1.9,17.0,,5,1,4,5,4.70,20.0
1099,tt2140373,Saving Mr. Banks,2013,"100,000+",111748,29946,5784,3921,4,84.0,,264,209,55,264,7.00,79.0
1100,tt0105327,School Ties,1992,"25,000+",34616,1967,903,713,3.6,69.0,,40,24,16,40,5.80,60.0
1101,tt0785007,Over Her Dead Body,2008,"100,000+",143711,3539,4872,3695,3.1,42.0,,108,15,93,108,3.70,14.0
1102,tt0119427,Judaai,1997,250+,356,18,24,9,3.1,43.0,,0,0,0,0,,
1103,tt0249462,Billy Elliot,2000,"250,000+",280750,12295,1553,5390,4.2,89.0,,119,101,18,119,7.30,85.0
1104,tt1023441,Coco Chanel & Igor Stravinsky,2009,"10,000+",19542,474,632,278,3.1,43.0,,94,49,45,94,5.70,52.0
1105,tt0365020,Everyday People,2004,100+,203,18,29,16,2.8,38.0,,9,6,3,9,6.30,67.0
1106,tt0427415,Just Another Romantic Wrestling Comedy,2006,100+,120,2,8,5,1.8,20.0,,1,0,1,1,,
1107,tt0094237,Valet Girls,1986,50+,72,3,17,10,2,15.0,,0,0,0,0,,
1108,tt0287111,Wajood,1998,100+,202,9,3,0,3.5,75.0,,0,0,0,0,,
1109,tt0075923,The Death of Richie,1977,Fewer than 50,26,1,3,3,,,,0,0,0,0,,
1110,tt1680306,Best Actor,2010,Fewer than 50,27,5,3,0,3.7,62.0,,0,0,0,0,,
1111,tt1420771,Fireball,2009,500+,601,36,59,45,2.9,38.0,,13,2,11,13,3.50,15.0
1112,tt0053804,Exodus,1960,"2,500+",4279,394,175,191,3.7,69.0,,17,11,6,17,6.00,65.0
1113,tt0815236,She's Out of My League,2010,"100,000+",106386,11386,7897,4674,3.4,59.0,,135,77,58,135,5.60,57.0
1114,tt0427528,Mercenary for Justice,2006,"2,500+",3425,72,191,82,2.5,27.0,,1,0,1,1,,
1115,tt1079448,Snow Buddies,2008,"2,500+",3743,547,316,341,3.7,63.0,,4,2,2,4,,
1116,tt0382011,Ghost Lake,2004,"2,500+",2519,17,82,54,1.8,17.0,,1,0,1,1,,
1117,tt0086592,The Winter of Our Discontent,1983,0,0,0,0,0,,,,0,0,0,0,,
1118,tt0095631,Midnight Run,1988,"25,000+",25195,4430,660,1329,4.1,87.0,,57,54,3,57,8.00,95.0
1119,tt0444983,Woh Chokri,1994,Fewer than 50,20,2,1,0,,,,0,0,0,0,,
1120,tt0093756,Police Academy 4: Citizens on Patrol,1987,"50,000+",56248,872,1432,747,2.9,38.0,,20,0,20,20,2.70,0.0
1121,tt0059143,The Early Bird,1965,500+,695,65,13,38,4,83.0,,1,0,1,1,,
1122,tt0774030,48 Angels,2007,250+,337,16,29,22,2.6,36.0,,0,0,0,0,,
1123,tt0445953,Disgrace,2008,"1,000+",2110,447,276,264,3.4,62.0,,60,50,10,60,6.90,83.0
1124,tt0362873,Monobloc,2005,0,0,0,0,0,,,,0,0,0,0,,
1125,tt0411204,Cactuses,2006,0,0,0,0,0,,,,0,0,0,0,,
1126,tt2186933,Luv Shuv Tey Chicken Khurana,2012,500+,952,71,46,27,3.3,61.0,,3,2,1,3,,
1127,tt0453188,Priyasakhi,2005,0,0,0,0,0,,,,0,0,0,0,,
1128,tt0149964,Broken Vessels,1998,"1,000+",1602,26,12,14,3.6,68.0,,16,11,5,16,6.00,69.0
1129,tt0082783,My Dinner with Andre,1981,"5,000+",7195,1408,246,521,4.1,85.0,,25,23,2,25,7.80,92.0
1130,tt0479500,Nancy Drew,2007,"100,000+",150477,7984,5568,6219,3.4,59.0,,138,69,69,138,5.50,50.0
1131,tt0085936,Mickey's Christmas Carol,1983,"2,500+",3342,687,73,243,4.3,90.0,,8,8,0,8,8.00,100.0
1132,tt0110027,Highlander III: The Sorcerer,1994,"25,000+",39191,496,1252,618,2.6,28.0,,20,1,19,20,2.80,5.0
1133,tt2187972,Shirin Farhad Ki Toh Nikal Padi,2012,100+,171,16,48,16,2.7,25.0,,2,1,1,2,,
1134,tt0067650,Raid on Rommel,1971,250+,442,22,50,23,2.8,31.0,,2,0,2,2,,
1135,tt0078976,City on Fire,1979,50+,65,7,23,6,2.4,23.0,,2,0,2,2,,
1136,tt0065778,Gidget Grows Up,1969,0,0,0,0,0,,,,0,0,0,0,,
1137,tt0058620,Strait-Jacket,1964,"1,000+",2124,219,116,142,3.6,66.0,,9,8,1,9,6.60,89.0
1138,tt0055774,Barabbas,1961,"1,000+",2154,146,71,60,3.7,67.0,,9,8,1,9,6.80,89.0
1139,tt0102585,Omen IV: The Awakening,1991,"10,000+",10124,151,495,252,2.3,23.0,,6,1,5,6,3.30,17.0
1140,tt0255013,Boeing Boeing,1985,0,0,0,0,0,,,,1,0,1,1,,
1141,tt2224455,Superman vs. The Elite,2012,"1,000+",2197,1471,475,278,3.9,76.0,,6,5,1,6,7.20,83.0
1142,tt0117891,A Thin Line Between Love and Hate,1996,"10,000+",14716,780,239,376,4,77.0,,26,4,22,26,3.70,15.0
1143,tt0438393,Saving Milly,2005,0,0,0,0,0,,,,0,0,0,0,,
1144,tt0059557,Our Man Flint,1966,"2,500+",4264,310,149,168,3.6,67.0,,32,24,8,32,6.50,75.0
1145,tt1736552,Breakaway,2011,0,0,0,0,0,,,,0,0,0,0,,
1146,tt0100002,Lekin...,1990,100+,125,5,2,1,3.9,71.0,,0,0,0,0,,
1147,tt0092863,Deep Space,1988,100+,107,7,29,14,2.2,19.0,,1,0,1,1,,
1148,tt0905329,El Greco,2007,0,0,0,0,0,,,,0,0,0,0,,
1149,tt0064952,The Secret of Santa Vittoria,1969,250+,481,99,20,30,4.1,83.0,,11,8,3,11,6.30,73.0
1150,tt1051241,Made for Each Other,2009,250+,395,31,100,34,2.4,24.0,,3,1,2,3,,
1151,tt0154565,Haqeeqat,1964,0,0,0,0,0,,,,0,0,0,0,,
1152,tt0427309,The Great Debaters,2007,"100,000+",116852,8940,1453,4782,4.1,86.0,,133,106,27,133,7.00,80.0
1153,tt1209319,Everyman's War,2009,100+,242,18,60,23,2.6,23.0,,0,0,0,0,,
1154,tt0066579,Women in Love,1969,"2,500+",2793,302,105,149,3.8,74.0,,23,19,4,23,7.50,83.0
1155,tt0304204,Isi Ka Naam Zindagi,1992,100+,149,0,5,2,1.1,0.0,,0,0,0,0,,
1156,tt0096193,Sunset,1988,"2,500+",2693,44,105,45,2.8,30.0,,14,3,11,14,3.70,21.0
1157,tt0090859,Cobra,1986,"25,000+",44253,1707,2256,1370,3.1,43.0,,22,4,18,22,3.40,18.0
1158,tt0429732,Candy Land: The Great Lollipop Adventure,2005,Fewer than 50,1,1,0,1,,,,0,0,0,0,,
1159,tt0273300,Jump Tomorrow,2001,500+,838,151,20,72,4.2,88.0,,55,45,10,55,6.70,82.0
1160,tt0109791,Felidae,1994,500+,603,190,38,81,3.9,83.0,,2,2,0,2,,
1161,tt0057111,Goldilocks and the Three Bares,1963,Fewer than 50,2,1,1,0,,,,0,0,0,0,,
1162,tt0211465,Knockaround Guys,2001,"25,000+",39600,1142,1110,691,3.3,51.0,,101,21,80,101,4.30,21.0
1163,tt0122515,The Acid House,1998,"5,000+",7944,565,258,240,3.6,69.0,,20,9,11,20,5.90,45.0
1164,tt1742650,I Don't Know How She Does It,2011,"10,000+",23449,1601,3453,718,2.8,32.0,,114,19,95,114,4.00,17.0
1165,tt1523267,Arctic Blast,2010,500+,504,44,144,53,2.3,23.0,,0,0,0,0,,
1166,tt0799934,Be Kind Rewind,2008,"100,000+",205354,19386,15394,17584,3.3,56.0,,130,84,46,130,6.30,65.0
1167,tt1743711,Red Eagle,2010,Fewer than 50,35,7,13,7,3.2,35.0,,0,0,0,0,,
1168,tt0095183,The Fruit Machine,1988,100+,109,15,9,8,3.6,62.0,,7,5,2,7,6.00,71.0
1169,tt0146516,Buddy Boy,1999,"1,000+",1782,64,31,45,3.6,67.0,,8,5,3,8,6.00,63.0
1170,tt0091829,Rawhead Rex,1986,"2,500+",3224,134,212,158,3,39.0,,10,3,7,10,4.40,30.0
1171,tt0479709,Mapado,2005,0,0,0,0,0,,,,0,0,0,0,,
1172,tt1874601,Lessons in Forgetting,2013,Fewer than 50,2,1,0,0,,,,1,1,0,1,,
1173,tt0064437,The Honeymoon Killers,1970,"1,000+",2390,249,114,122,3.6,69.0,,21,20,1,21,8.00,95.0
1174,tt0295925,"Death, Deceit & Destiny Aboard the Orient Express",2001,0,0,0,0,0,,,,0,0,0,0,,
1175,tt0477139,Wristcutters: A Love Story,2006,"25,000+",32520,7871,1722,3969,3.9,82.0,,93,62,31,93,6.20,67.0
1176,tt0329374,Mickey's House of Villains,2001,"5,000+",7917,77,74,67,3.3,51.0,,4,4,0,4,,
1177,tt0477139,Wristcutters: A Love Story,2006,"25,000+",32520,7871,1722,3969,3.9,82.0,,93,62,31,93,6.20,67.0
1178,tt0144604,Shadrach,1998,250+,413,23,13,9,3.6,64.0,,16,8,8,16,5.90,50.0
1179,tt1348324,A Touch of Grey,2009,Fewer than 50,11,4,3,2,3,57.0,,1,0,1,1,,
1180,tt0477139,Wristcutters: A Love Story,2006,"25,000+",32520,7871,1722,3969,3.9,82.0,,93,62,31,93,6.20,67.0
1181,tt0069876,La choca,1974,Fewer than 50,6,0,3,1,,,,0,0,0,0,,
1182,tt1198101,Kites,2010,"10,000+",14825,779,703,567,3.2,53.0,,29,21,8,29,6.10,72.0
1183,tt0107357,Lake Consequence,1993,250+,310,10,31,10,2.4,24.0,,1,0,1,1,,
1184,tt0230011,Atlantis: The Lost Empire,2001,"250,000+",365965,4332,3637,5172,3.4,54.0,,144,70,74,144,5.50,49.0
1185,tt0088258,This Is Spinal Tap,1984,"100,000+",127319,18807,1583,7941,4.4,92.0,,67,64,3,67,8.60,96.0
1186,tt0077288,La Cage aux folles,1978,"5,000+",6418,839,149,244,4,85.0,,24,23,1,24,7.80,96.0
1187,tt0115644,Bed of Roses,1996,"10,000+",20028,946,474,494,3.8,67.0,,16,3,13,16,5.20,19.0
1188,tt0230011,Atlantis: The Lost Empire,2001,"250,000+",365965,4332,3637,5172,3.4,54.0,,144,70,74,144,5.50,49.0
1189,tt0808232,A Dog Year,2009,250+,456,82,141,75,3,37.0,,1,1,0,1,,
1190,tt1190080,2012,2009,"250,000+",508796,32258,37091,29574,3.1,47.0,,246,97,149,246,5.20,39.0
1191,tt2145949,The Toy That Saved Christmas,1996,50+,63,4,2,0,3.4,67.0,,0,0,0,0,,
1192,tt1213825,Love Hurts,2009,0,0,0,0,0,,,,0,0,0,0,,
1193,tt0094074,Superman IV: The Quest for Peace,1987,"50,000+",66205,962,5001,2198,2,16.0,,52,5,47,52,3.00,10.0
1194,tt0271271,Zenon: The Zequel,2001,"5,000+",5134,193,224,85,3.2,46.0,,1,0,1,1,,
1195,tt0312549,Veronica Guerin,2003,"5,000+",8923,1117,491,450,3.6,69.0,,141,75,66,141,5.90,53.0
1196,tt0079000,The Corn Is Green,1979,100+,103,9,6,7,3.5,60.0,,1,1,0,1,,
1197,tt0120122,Shooting Fish,1997,"5,000+",6473,534,171,213,3.8,76.0,,28,16,12,28,5.80,57.0
1198,tt0069002,The Night Strangler,1973,100+,235,50,8,26,3.8,86.0,,6,6,0,6,6.70,100.0
1199,tt1331115,Pianomania,2009,250+,351,42,11,13,3.8,79.0,,23,18,5,23,7.20,78.0
1200,tt0059825,The Train,1964,"2,500+",4343,616,76,203,4.2,89.0,,18,17,1,18,8.50,94.0
1201,tt0077716,Ice Castles,1978,"5,000+",6883,343,154,209,3.8,69.0,,9,4,5,9,5.30,44.0
1202,tt0118798,Bulworth,1998,"10,000+",20656,1432,683,572,3.6,68.0,,68,52,16,68,7.10,76.0
1203,tt0364551,Nasihat,1986,0,0,0,0,0,,,,0,0,0,0,,
1204,tt0089530,Mad Max Beyond Thunderdome,1985,"50,000+",68230,3887,4011,2062,3.2,49.0,,54,44,10,54,6.50,81.0
1205,tt1419950,Riverworld,2010,250+,305,38,100,37,2.5,28.0,,2,0,2,2,,
1206,tt0095169,For Keeps?,1988,"5,000+",9292,554,230,271,3.8,71.0,,12,2,10,12,4.80,17.0
1207,tt4315506,Jaggubhai,2010,0,0,0,0,0,,,,0,0,0,0,,
1208,tt0883398,Dark Reel,2008,250+,292,15,51,38,2.2,23.0,,1,0,1,1,,
1209,tt0055184,The Misfits,1961,"5,000+",9472,1247,353,493,3.9,78.0,,31,30,1,31,8.10,97.0
1210,tt0056800,55 Days at Peking,1963,"2,500+",3753,120,90,58,3.5,57.0,,7,4,3,7,5.40,57.0
1211,tt0059930,Young Cassidy,1965,Fewer than 50,20,6,7,4,3.5,46.0,,2,1,1,2,,
1212,tt0106341,Bad Boy Bubby,1993,"5,000+",8080,1519,214,756,4.2,88.0,,10,10,0,10,7.90,100.0
1213,tt0762142,Les 3 p'tits cochons,2007,"2,500+",3846,623,171,330,3.9,79.0,,0,0,0,0,,
1214,tt0114753,Two Bits,1995,"1,000+",1722,52,82,29,3.1,39.0,,10,4,6,10,5.00,40.0
1215,tt0113399,In Pursuit of Honor,1995,100+,228,44,8,14,4,85.0,,0,0,0,0,,
1216,tt0120647,Deep Impact,1998,"250,000+",340978,6343,8340,7758,3.1,43.0,,97,44,53,97,5.80,45.0
1217,tt0085408,Deadline Auto Theft,1983,"5,000+",5173,11,7,7,3.4,61.0,,2,0,2,2,,
1218,tt0113832,Mixed Blessings,1995,0,0,0,0,0,,,,0,0,0,0,,
1219,tt0212235,Shriek If You Know What I Did Last Friday the Thirteenth,2000,"10,000+",19910,351,790,589,2.6,31.0,,7,1,6,7,2.90,14.0
1220,tt0094602,Above the Law,1988,"25,000+",45256,889,958,717,3.3,48.0,,20,10,10,20,5.20,50.0
1221,tt0387877,The Black Dahlia,2006,"50,000+",97715,3693,10060,6085,2.6,27.0,,192,61,131,192,4.80,32.0
1222,tt0255195,The Goddess of 1967,2000,500+,782,128,34,47,4,79.0,,4,1,3,4,,
1223,tt1252488,Haal-e-Dil,2008,100+,222,11,10,8,3.1,52.0,,1,0,1,1,,
1224,tt0089221,Heavenly Pursuits,1986,Fewer than 50,30,1,6,3,3,14.0,,1,1,0,1,,
1225,tt2255735,Angus Buchan's Ordinary People,2012,Fewer than 50,23,3,6,1,2.9,33.0,,0,0,0,0,,
1226,tt0439714,Mumbai Express,2005,100+,171,4,9,2,3,31.0,,1,0,1,1,,
1227,tt0058440,Pajama Party,1964,"1,000+",1407,18,35,24,2.9,34.0,,9,3,6,9,4.40,33.0
1228,tt0265459,One Hour Photo,2002,"100,000+",177899,7226,3952,6463,3.5,65.0,,199,161,38,199,7.00,81.0
1229,tt1447793,My Girlfriend's Boyfriend,2010,"1,000+",1988,407,463,192,3.1,47.0,,4,4,0,4,,
1230,tt0317334,Deiva Vaakku,1992,0,0,0,0,0,,,,0,0,0,0,,
1231,tt0186045,Drowning Mona,2000,"10,000+",15314,588,679,442,3.1,46.0,,77,22,55,77,4.40,29.0
1232,tt1526323,Arya 2,2009,50+,95,43,9,7,4,83.0,,0,0,0,0,,
1233,tt0084021,Grease 2,1982,"250,000+",393920,4287,3870,11933,3.2,53.0,,43,15,28,43,4.30,35.0
1234,tt0129992,High Voltage,1998,"1,000+",1293,5,14,9,2.8,22.0,,0,0,0,0,,
1235,tt0314366,Megamalhar,2001,0,0,0,0,0,,,,0,0,0,0,,
1236,tt0120201,Starship Troopers,1997,"100,000+",224831,15779,6729,10107,3.7,70.0,,81,58,23,81,6.50,72.0
1237,tt0426568,Now You See It...,2005,"5,000+",7139,264,153,147,3.7,63.0,,1,1,0,1,,
1238,tt1840388,Rosewood Lane,2011,250+,358,58,221,76,2.3,21.0,,2,0,2,2,,
1239,tt1066327,London Betty,2009,Fewer than 50,20,4,1,4,4,80.0,,2,0,2,2,,
1240,tt0271678,No: 20 Madras Mail,1990,0,0,0,0,0,,,,0,0,0,0,,
1241,tt1804623,Pasanga,2009,50+,65,18,1,7,4.2,95.0,,0,0,0,0,,
1242,tt0298798,Cherish,2002,"1,000+",2091,138,113,90,3.4,55.0,,84,43,41,84,5.80,51.0
1243,tt0058230,The Incredible Mr. Limpet,1964,"5,000+",7896,310,204,248,3.5,60.0,,10,4,6,10,5.70,40.0
1244,tt0087355,Grand Canyon: The Hidden Secrets,1984,Fewer than 50,12,3,2,1,3.6,60.0,,3,3,0,3,,
1245,tt0336675,Juan & Ted: Wanted,2000,0,0,0,0,0,,,,0,0,0,0,,
1246,tt0914863,Unthinkable,2010,"10,000+",14050,4042,2072,1758,3.5,66.0,,4,2,2,4,,
1247,tt0057449,The Raven,1963,"2,500+",4688,433,248,233,3.6,64.0,,18,15,3,18,6.60,83.0
1248,tt0106850,Extreme Justice,1993,"1,000+",1190,16,36,17,3,31.0,,1,0,1,1,,
1249,tt0083197,Threshold,1981,Fewer than 50,47,1,2,1,,,,0,0,0,0,,
1250,tt1912981,A Haunting in Salem,2011,250+,328,21,136,40,2.1,13.0,,0,0,0,0,,
1251,tt0254110,Apariencias,2000,50+,82,4,12,2,2.9,25.0,,0,0,0,0,,
1252,tt0101605,The Commitments,1991,"25,000+",28433,3105,361,1218,4.2,90.0,,48,43,5,48,7.40,90.0
1253,tt9002028,Kannukku Kannaga,2000,0,0,0,0,0,,,,0,0,0,0,,
1254,tt0089382,Joshilaay,1989,0,0,0,0,0,,,,0,0,0,0,,
1255,tt0094941,Dance 'Til Dawn,1988,"1,000+",2410,98,32,58,3.9,75.0,,0,0,0,0,,
1256,tt0452609,Decadent Evil,2005,"1,000+",1400,7,33,23,2.1,18.0,,2,0,2,2,,
1257,tt0947810,Green Zone,2010,"100,000+",152683,11844,9032,6320,3.4,57.0,,191,101,90,191,6.00,53.0
1258,tt0120087,The Second Jungle Book: Mowgli & Baloo,1997,500+,557,18,52,27,2.5,26.0,,3,0,3,3,,
1259,tt0082001,All Night Long,1981,"1,000+",1604,16,54,19,2.6,23.0,,9,3,6,9,5.40,33.0
1260,tt0105654,The Tune,1992,100+,102,23,7,8,3.9,76.0,,5,5,0,5,6.40,100.0
1261,tt1328875,Santa Buddies,2009,"1,000+",2239,238,187,128,3.4,56.0,,5,1,4,5,3.80,20.0
1262,tt0094006,Some Kind of Wonderful,1987,"25,000+",38025,3658,895,1523,4,80.0,,45,34,11,45,6.60,76.0
1263,tt0096402,Voyage of the Rock Aliens,1984,250+,453,22,19,22,3.4,54.0,,2,1,1,2,,
1264,tt4322022,Easan,2010,0,0,0,0,0,,,,0,0,0,0,,
1265,tt0231226,Bundal Baaz,1976,0,0,0,0,0,,,,0,0,0,0,,
1266,tt0201732,Life in a Day,1999,0,0,0,0,0,,,,0,0,0,0,,
1267,tt0129884,Dog Park,1998,"2,500+",2613,39,101,51,2.7,28.0,,25,9,16,25,4.50,36.0
1268,tt0279250,Murder on the Orient Express,2001,"5,000+",5712,35,36,45,3.1,49.0,,1,1,0,1,,
1269,tt0117973,True Blue,1996,100+,102,5,9,5,3.2,36.0,,0,0,0,0,,
1270,tt0059447,Mickey One,1965,100+,246,34,32,19,3.2,52.0,,7,5,2,7,6.80,71.0
1271,tt0119899,Pippi Longstocking,1997,"5,000+",6899,84,70,68,3.5,55.0,,7,3,4,7,5.10,43.0
1272,tt1517489,Spy Kids 4: All the Time in the World,2011,"25,000+",30757,1551,2681,778,2.8,37.0,,61,14,47,61,3.90,23.0
1273,tt0113247,La haine,1995,"25,000+",41023,9780,553,2370,4.4,95.0,,70,67,3,70,8.00,96.0
1274,tt0387164,Dhoop,2003,0,0,0,0,0,,,,0,0,0,0,,
1275,tt1340773,Elektra Luxx,2010,"2,500+",3046,134,547,128,2.4,20.0,,33,8,25,33,4.60,24.0
1276,tt0072926,The Eiger Sanction,1975,"5,000+",7903,546,465,288,3.3,54.0,,21,14,7,21,6.40,67.0
1277,tt1340773,Elektra Luxx,2010,"2,500+",3046,134,547,128,2.4,20.0,,33,8,25,33,4.60,24.0
1278,tt0099088,Back to the Future: Part III,1990,"250,000+",695452,34892,9712,16731,3.9,78.0,,46,37,9,46,6.70,80.0
1279,tt0059181,Firelight,1964,100+,123,1,6,1,2.2,14.0,,0,0,0,0,,
1280,tt0322005,The Deviants,2004,250+,494,4,11,9,2.8,27.0,,0,0,0,0,,
1281,tt1337057,Rampage,2009,"2,500+",3143,852,836,562,3.2,50.0,,2,2,0,2,,
1282,tt0478137,Desert of Blood,2008,100+,123,1,13,6,1.8,7.0,,0,0,0,0,,
1283,tt0492947,"Clear Cut: The Story of Philomath, Oregon",2006,Fewer than 50,39,7,2,5,4.1,78.0,,5,5,0,5,7.10,100.0
1284,tt0906778,Black Butterflies,2011,500+,887,85,52,26,3.5,62.0,,13,9,4,13,5.60,69.0
1285,tt0317952,"Novia, esposa y amante",1981,0,0,0,0,0,,,,0,0,0,0,,
1286,tt0080870,"High Noon, Part II: The Return of Will Kane",1980,50+,61,2,3,4,2.6,40.0,,0,0,0,0,,
1287,tt0082062,The Best Little Girl in the World,1981,Fewer than 50,49,10,2,1,3.9,83.0,,0,0,0,0,,
1288,tt0125556,Tohfa,1984,Fewer than 50,1,1,0,0,,,,0,0,0,0,,
1289,tt0301050,Bolivia,1999,500+,507,75,16,24,3.9,82.0,,12,12,0,12,7.80,100.0
1290,tt1483025,Planet Hulk,2010,"2,500+",2612,704,548,362,3.4,56.0,,1,1,0,1,,
1291,tt1213838,Valu,2008,50+,65,6,2,2,3.8,75.0,,1,1,0,1,,
1292,tt1294699,Merlin and the War of the Dragons,2008,250+,418,21,83,44,2.1,20.0,,0,0,0,0,,
1293,tt0074417,Do Anjaane,1976,100+,102,2,2,0,,,,0,0,0,0,,
1294,tt0861704,Emotional Arithmetic,2007,250+,430,63,66,50,3.2,49.0,,9,2,7,9,5.20,22.0
1295,tt0306882,Ganeshana Madhuve,1990,0,0,0,0,0,,,,0,0,0,0,,
1296,tt0109661,Dragonworld,1994,500+,758,39,26,15,3.6,60.0,,0,0,0,0,,
1297,tt0100817,Tripwire,1989,250+,283,1,6,0,2.5,14.0,,0,0,0,0,,
1298,tt0316219,Manhood,2003,100+,114,5,5,3,3.3,50.0,,1,1,0,1,,
1299,tt0101761,The Doors,1991,"50,000+",60753,8077,2145,3285,4,79.0,,61,34,27,61,5.90,56.0
1300,tt0158811,Muppets from Space,1999,"25,000+",45546,1484,1067,1111,3.5,58.0,,56,35,21,56,6.10,63.0
1301,tt0106521,Carnosaur,1993,"5,000+",6502,61,203,140,2.2,23.0,,11,2,9,11,4.20,18.0
1302,tt0366180,Stalin,2006,Fewer than 50,1,1,0,1,,,,0,0,0,0,,
1303,tt0892782,Monsters vs. Aliens,2009,Fewer than 50,31,20,11,8,3.9,65.0,,0,0,0,0,,
1304,tt0106950,Fortress,1992,"10,000+",10065,386,586,313,3,40.0,,16,6,10,16,4.70,38.0
1305,tt1538819,Ejder Kapani,2010,50+,53,10,11,1,3.2,48.0,,0,0,0,0,,
1306,tt1384590,Green Lantern: First Flight,2009,"2,500+",4039,1274,543,596,3.6,70.0,,7,4,3,7,6.00,57.0
1307,tt1102308,Pulijanmam,2006,0,0,0,0,0,,,,0,0,0,0,,
1308,tt0056565,The Tell-Tale Heart,1960,"1,000+",1388,5,27,16,2.8,16.0,,1,1,0,1,,
1309,tt0358273,Walk the Line,2005,"250,000+",545856,53064,5679,27778,4.2,90.0,,209,172,37,209,7.20,82.0
1310,tt0068327,Cabaret,1972,"25,000+",36210,4661,720,1765,4.2,87.0,,48,44,4,48,8.40,92.0
1311,tt0118660,Auzaar,1997,100+,196,2,6,1,2.5,25.0,,0,0,0,0,,
1312,tt0120363,Toy Story 2,1999,"250,000+",1001677,52831,8152,23570,4.2,87.0,,172,172,0,172,8.70,100.0
1313,tt0101524,By the Sword,1991,"1,000+",1002,53,18,28,3.8,75.0,,2,0,2,2,,
1314,tt0101702,Delta Force 3: The Killing Game,1991,"5,000+",5247,17,50,18,2.4,25.0,,0,0,0,0,,
1315,tt1809387,The War You Don't See,2010,100+,172,64,8,15,4.2,89.0,,5,4,1,5,7.20,80.0
1316,tt0100604,Short Time,1990,250+,332,44,39,25,3.3,53.0,,7,2,5,7,4.60,29.0
1317,tt0098194,The Return of the Musketeers,1989,500+,977,36,70,28,2.9,34.0,,5,3,2,5,5.60,60.0
1318,tt0313964,Devathai,1997,0,0,0,0,0,,,,0,0,0,0,,
1319,tt0118954,Deconstructing Harry,1997,"10,000+",22277,3050,668,709,3.9,82.0,,37,27,10,37,7.20,73.0
1320,tt1619880,Sharktopus,2010,"1,000+",1090,152,479,269,2.3,24.0,,6,3,3,6,7.00,50.0
1321,tt0272101,Gallavants,1984,Fewer than 50,16,5,3,3,3.6,62.0,,0,0,0,0,,
1322,tt0282589,I Saw Mommy Kissing Santa Claus,2001,"10,000+",10344,89,99,114,3.2,47.0,,0,0,0,0,,
1323,tt0081763,Witches' Brew,1980,Fewer than 50,18,2,3,2,2.8,40.0,,0,0,0,0,,
1324,tt0460592,Udayon,2005,0,0,0,0,0,,,,0,0,0,0,,
1325,tt1121931,Crank: High Voltage,2009,"250,000+",257290,8177,8537,7663,3.1,49.0,,73,46,27,73,5.90,63.0
1326,tt0373283,Saints and Soldiers,2003,"10,000+",13812,1874,548,941,3.9,77.0,,35,23,12,35,6.50,66.0
1327,tt0093771,A Prayer for the Dying,1987,"2,500+",2770,121,107,57,3.4,53.0,,12,6,6,12,4.90,50.0
1328,tt0095296,Hero and the Terror,1988,"2,500+",4190,68,112,79,2.9,38.0,,6,0,6,6,3.60,0.0
1329,tt0254872,Wishmaster 4: The Prophecy Fulfilled,2002,"5,000+",8089,82,270,137,2.4,23.0,,4,1,3,4,,
1330,tt0103036,Talent for the Game,1991,500+,815,14,26,10,2.9,35.0,,3,0,3,3,,
1331,tt0100502,RoboCop 2,1990,"50,000+",90165,2057,3586,1867,3,36.0,,40,11,29,40,4.70,28.0
1332,tt0410696,Stuck in the Suburbs,2004,"5,000+",8920,437,266,219,3.6,62.0,,1,0,1,1,,
1333,tt0068403,Come Back Charleston Blue,1972,Fewer than 50,21,4,4,2,3.6,50.0,,2,2,0,2,,
1334,tt1830890,Uthama Puthiran,2010,0,0,0,0,0,,,,0,0,0,0,,
1335,tt0066384,Skullduggery,1970,0,0,0,0,0,,,,0,0,0,0,,
1336,tt1185235,The Collective,2008,100+,131,3,21,11,2.3,12.0,,0,0,0,0,,
1337,tt0079514,Malibu High,1979,100+,116,12,31,24,2.7,29.0,,1,0,1,1,,
1338,tt15145976,Vaanchinathan,2001,0,0,0,0,0,,,,0,0,0,0,,
1339,tt0952693,Your Mommy Kills Animals!,2007,"1,000+",2299,67,27,35,3.6,71.0,,33,30,3,33,7.60,91.0
1340,tt0109413,A Child's Cry for Help,1994,0,0,0,0,0,,,,0,0,0,0,,
1341,tt0067277,Johnny Got His Gun,1971,"5,000+",5820,952,147,377,4.2,87.0,,21,14,7,21,6.70,67.0
1342,tt0123324,Why Do Fools Fall in Love,1998,"5,000+",8824,506,157,235,4,76.0,,58,30,28,58,5.90,52.0
1343,tt0389860,Click,2006,"250,000+",875140,52594,27170,45867,3.6,66.0,,172,58,114,172,4.80,34.0
1344,tt0389860,Click,2006,"250,000+",875140,52594,27170,45867,3.6,66.0,,172,58,114,172,4.80,34.0
1345,tt0092925,Dragnet,1987,"25,000+",35228,988,1420,664,3.1,41.0,,36,18,18,36,5.20,50.0
1346,tt1625340,The Client List,2010,500+,773,174,235,70,3.1,43.0,,6,5,1,6,5.50,83.0
1347,tt1625340,The Client List,2010,500+,773,174,235,70,3.1,43.0,,6,5,1,6,5.50,83.0
1348,tt0118705,A Better Place,1997,"1,000+",1363,62,19,43,3.8,76.0,,4,4,0,4,,
1349,tt0408790,Flightplan,2005,"250,000+",497024,7625,8385,16082,3.2,48.0,,177,65,112,177,5.30,37.0
1350,tt0306841,The Lizzie McGuire Movie,2003,"250,000+",393303,4366,4580,7611,3.2,49.0,,102,41,61,102,5.30,40.0
1351,tt0108442,Undercover Blues,1993,"5,000+",9290,432,213,270,3.7,67.0,,19,7,12,19,5.10,37.0
1352,tt0314412,My Life Without Me,2003,"10,000+",21500,3180,490,1052,4.1,87.0,,100,65,35,100,6.30,65.0
1353,tt0443506,Film Geek,2005,500+,911,66,128,95,2.8,34.0,,22,14,8,22,6.30,64.0
1354,tt1249453,Humanity's End,2008,100+,163,2,37,22,1.6,5.0,,0,0,0,0,,
1355,tt0902270,Constantine's Sword,2007,500+,775,173,51,100,3.8,77.0,,31,27,4,31,6.90,87.0
1356,tt0488120,Fracture,2007,0,0,0,0,0,,,,0,0,0,0,,
1357,tt0082639,"Ladies and Gentlemen, the Fabulous Stains",1982,"1,000+",1628,211,115,126,3.6,65.0,,12,8,4,12,7.00,67.0
1358,tt0096464,A World Apart,1988,"1,000+",1247,55,13,20,4,81.0,,11,10,1,11,8.10,91.0
1359,tt0865957,WarGames: The Dead Code,2008,"2,500+",2563,170,516,321,2.4,25.0,,3,1,2,3,,
1360,tt1095027,Rock Monster,2008,250+,349,15,47,35,2.4,24.0,,0,0,0,0,,
1361,tt0084111,I'm Dancing as Fast as I Can,1982,"1,000+",1090,8,7,13,3.5,53.0,,6,2,4,6,5.00,33.0
1362,tt1789902,Shake Rattle and Roll 12,2010,0,0,0,0,0,,,,0,0,0,0,,
1363,tt0115560,Apollo 11,1996,Fewer than 50,9,3,0,0,,,,0,0,0,0,,
1364,tt0117603,Set It Off,1996,"50,000+",55131,4096,490,1637,4.4,89.0,,35,25,10,35,6.40,71.0
1365,tt0103850,Bob Roberts,1992,"5,000+",7630,823,227,286,3.8,78.0,,44,41,3,44,7.50,93.0
1366,tt0326600,Maine Dil Tujhko Diya,2002,250+,398,12,13,4,3,48.0,,0,0,0,0,,
1367,tt0059724,Situation Hopeless -- But Not Serious,1965,100+,179,0,3,2,,,,0,0,0,0,,
1368,tt0338013,Eternal Sunshine of the Spotless Mind,2004,"250,000+",572817,152999,9510,46632,4.5,94.0,,256,236,20,256,8.50,92.0
1369,tt0352500,Kudumba Puranam,1988,0,0,0,0,0,,,,0,0,0,0,,
1370,tt0475224,Belle toujours,2006,"1,000+",2144,32,39,23,3.1,45.0,,41,29,12,41,6.30,71.0
1371,tt1645089,Inside Job,2010,"25,000+",29695,8202,820,2251,4.3,91.0,,148,145,3,148,8.20,98.0
1372,tt1587357,To Whom It May Concern: Ka Shen's Journey,2010,Fewer than 50,28,1,3,3,,,,0,0,0,0,,
1373,tt0263734,Men with Brooms,2002,"5,000+",8539,384,192,299,3.6,67.0,,21,12,9,21,5.50,57.0
1374,tt0924129,Crossing Over,2009,"50,000+",50428,1202,1272,1014,3.2,49.0,,110,17,93,110,4.20,15.0
1375,tt0054240,Orgy of the Dead,1965,"1,000+",1306,26,89,72,2.2,23.0,,5,0,5,5,2.60,0.0
1376,tt0262210,Adanggaman,2000,100+,238,8,5,2,3.7,62.0,,10,9,1,10,6.70,90.0
1377,tt1438534,Primal,2010,500+,570,82,249,120,2.6,25.0,,9,6,3,9,5.50,67.0
1378,tt0100150,Miller's Crossing,1990,"50,000+",50688,10378,1120,3192,4.2,90.0,,70,65,5,70,8.20,93.0
1379,tt2041488,Thunderstruck,2012,"5,000+",5595,727,315,124,3.9,70.0,,11,3,8,11,4.40,27.0
1380,tt0059039,"Clarence, the Cross-Eyed Lion",1965,100+,160,9,7,7,3.6,56.0,,1,1,0,1,,
1381,tt0094265,La vie est belle,1987,0,0,0,0,0,,,,1,1,0,1,,
1382,tt0082763,Modern Problems,1981,"2,500+",3592,95,212,105,2.8,31.0,,4,0,4,4,,
1383,tt0108162,Sliver,1993,"10,000+",17567,415,1091,430,2.7,27.0,,27,4,23,27,3.80,15.0
1384,tt0402590,The Wooden Camera,2003,250+,290,39,8,15,3.9,83.0,,1,0,1,1,,
1385,tt1161404,Blood Night: The Legend of Mary Hatchet,2009,500+,716,44,202,105,2.4,18.0,,0,0,0,0,,
1386,tt1131749,Poison Ivy: The Secret Society,2008,500+,537,27,109,35,2.4,20.0,,2,0,2,2,,
1387,tt0486985,Promise Me This,2005,"1,000+",2459,377,151,137,3.8,71.0,,3,1,2,3,,
1388,tt0899145,Don't Fade Away,2011,Fewer than 50,49,5,11,2,2.6,31.0,,0,0,0,0,,
1389,tt0101733,Dil Hai Ki Manta Nahin,1991,"1,000+",1382,95,40,26,3.8,70.0,,0,0,0,0,,
1390,tt0101969,Grand Canyon,1991,"5,000+",7638,789,334,293,3.7,70.0,,37,29,8,37,7.00,78.0
1391,tt0976247,"Surfer, Dude",2008,"5,000+",7463,245,704,385,2.4,26.0,,18,0,18,18,3.00,0.0
1392,tt0210070,Ginger Snaps,2000,"50,000+",55055,4257,1224,2344,3.9,78.0,,59,53,6,59,7.30,90.0
1393,tt1424750,Bhagyadevatha,2009,0,0,0,0,0,,,,0,0,0,0,,
1394,tt0096054,School Daze,1988,"5,000+",8985,1134,301,504,4.1,79.0,,29,17,12,29,5.80,59.0
1395,tt0417751,Her Minor Thing,2005,"1,000+",1354,88,144,101,3.1,38.0,,0,0,0,0,,
1396,tt0054634,Aquamania,1961,Fewer than 50,2,2,0,1,,,,0,0,0,0,,
1397,tt0092582,The Arrogant,1988,Fewer than 50,14,0,5,1,1.8,0.0,,0,0,0,0,,
1398,tt0083570,Aparoopa,1982,0,0,0,0,0,,,,0,0,0,0,,
1399,tt0161612,Get Yourself a College Girl,1964,Fewer than 50,12,5,5,2,3.1,50.0,,0,0,0,0,,
1400,tt0250347,Double Whammy,2001,"1,000+",1609,55,130,55,2.8,30.0,,10,3,7,10,4.40,30.0
1401,tt0104114,The Distinguished Gentleman,1992,"10,000+",12874,312,546,170,2.9,36.0,,16,2,14,16,4.00,13.0
1402,tt0068286,Bless the Beasts & Children,1971,100+,187,29,14,17,3.7,67.0,,4,2,2,4,,
1403,tt0107653,Naked,1993,"10,000+",10547,2662,254,869,4.4,91.0,,60,53,7,60,8.30,88.0
1404,tt0104114,The Distinguished Gentleman,1992,"10,000+",12874,312,546,170,2.9,36.0,,16,2,14,16,4.00,13.0
1405,tt0060165,A Big Hand for the Little Lady,1966,250+,340,86,14,33,3.9,86.0,,2,1,1,2,,
1406,tt0165874,The Mating Habits of the Earthbound Human,1999,"2,500+",3443,299,115,179,3.7,72.0,,12,4,8,12,4.70,33.0
1407,tt0085794,The King of Comedy,1982,"25,000+",27274,5431,621,1505,4.1,90.0,,70,62,8,70,8.30,89.0
1408,tt0107944,Remote,1993,100+,176,13,19,11,3.4,41.0,,1,1,0,1,,
1409,tt0085852,Liquid Sky,1982,"2,500+",4652,407,173,247,3.7,70.0,,27,25,2,27,7.20,93.0
1410,tt0092563,Angel Heart,1987,"25,000+",30214,4151,969,1420,3.9,81.0,,34,28,6,34,7.40,82.0
1411,tt0138749,The Road to El Dorado,2000,"50,000+",62798,4164,2143,1871,3.7,66.0,,106,52,54,106,5.60,49.0
1412,tt0080979,Kagemusha,1980,"10,000+",12456,2719,247,716,4.2,92.0,,26,23,3,26,7.60,88.0
1413,tt0262242,Asha Jyoti,1984,Fewer than 50,20,1,0,0,,,,0,0,0,0,,
1414,tt0070835,The Triple Echo,1972,Fewer than 50,20,5,2,1,3.8,71.0,,5,3,2,5,5.00,60.0
1415,tt0067712,Scandalous John,1971,Fewer than 50,22,2,2,3,,,,5,1,4,5,5.00,20.0
1416,tt0137386,Billy's Hollywood Screen Kiss,1998,"2,500+",2883,144,85,84,3.6,63.0,,23,18,5,23,6.70,78.0
1417,tt1013651,The Man Who Came Back,2008,250+,272,11,46,30,2.2,19.0,,1,0,1,1,,
1418,tt0274639,Nothing So Strange,2002,Fewer than 50,41,1,0,1,,,,0,0,0,0,,
1419,tt0309987,The Dreamers,2003,"25,000+",47173,7733,2230,2638,3.9,78.0,,161,96,65,161,6.10,60.0
1420,tt0107084,The Harvest,1993,100+,108,4,13,4,2.4,24.0,,3,1,2,3,,
1421,tt0479884,Crank,2006,"250,000+",443094,31492,13066,20873,3.7,71.0,,102,63,39,102,6.10,62.0
1422,tt0318411,The Magdalene Sisters,2002,"10,000+",13372,2241,269,802,4.1,89.0,,149,135,14,149,7.70,91.0
1423,tt0057401,Paranoiac,1963,250+,398,63,27,43,3.6,70.0,,5,4,1,5,6.40,80.0
1424,tt0280609,Dog Soldiers,2002,"50,000+",58065,5072,1354,3316,3.9,79.0,,42,34,8,42,7.10,81.0
1425,tt0060120,The Appaloosa,1966,"1,000+",1241,48,56,35,3.2,46.0,,3,1,2,3,,
1426,tt0454879,Journey to the End of the Night,2006,"1,000+",2498,104,138,123,3,43.0,,2,1,1,2,,
1427,tt0269347,The Hunted,2003,"25,000+",41332,1559,1794,1093,3.2,46.0,,150,44,106,150,4.70,29.0
1428,tt1820400,Black & White & Sex,2012,100+,101,25,12,4,3.8,68.0,,4,4,0,4,,
1429,tt0082031,Arthur,1981,"25,000+",33609,2301,679,1018,3.9,77.0,,36,31,5,36,7.20,86.0
1430,tt0080131,Wild Horse Hank,1979,Fewer than 50,16,4,2,0,4.1,67.0,,0,0,0,0,,
1431,tt0166276,Monkeybone,2001,"25,000+",47307,565,1498,824,2.6,27.0,,114,23,91,114,3.90,20.0
1432,tt0082279,The Dorm That Dripped Blood,1982,250+,480,29,84,44,2.5,26.0,,5,0,5,5,2.80,0.0
1433,tt1370728,Dough Boys,2009,50+,91,2,7,4,2.9,22.0,,0,0,0,0,,
1434,tt0804539,Surviving Evil,2009,100+,145,10,42,18,2.3,20.0,,1,0,1,1,,
1435,tt0274584,The Jennie Project,2001,100+,123,11,6,6,3.7,65.0,,1,0,1,1,,
1436,tt0092099,Top Gun,1986,"250,000+",727002,52566,10889,26391,4.1,83.0,,77,44,33,77,6.00,57.0
1437,tt7169860,Kandhakottai,2009,0,0,0,0,0,,,,0,0,0,0,,
1438,tt0094072,Summer School,1987,"25,000+",27901,878,623,552,3.5,58.0,,35,20,15,35,5.40,57.0
1439,tt0058981,"Boeing, Boeing",1965,250+,440,69,28,38,3.8,71.0,,1,0,1,1,,
1440,tt0333766,Garden State,2004,"250,000+",330211,67680,9314,25949,4.2,88.0,,191,164,27,191,7.50,86.0
1441,tt0110612,My Father the Hero,1994,"10,000+",14313,577,491,406,3.3,54.0,,15,3,12,15,4.40,20.0
1442,tt0081184,Motel Hell,1980,"5,000+",7334,557,511,415,3.4,52.0,,27,18,9,27,5.80,67.0
1443,tt1267500,Phoonk,2008,100+,246,9,39,24,2.3,19.0,,1,0,1,1,,
1444,tt0094923,Crusoe,1988,250+,352,18,24,16,3,43.0,,13,8,5,13,6.20,62.0
1445,tt0119633,Mauvais genre,1997,0,0,0,0,0,,,,0,0,0,0,,
1446,tt0106856,Falling Down,1993,"50,000+",92862,9882,1878,4039,4,84.0,,56,42,14,56,6.80,75.0
1447,tt1052003,High on Crack Street: Lost Lives in Lowell,1995,100+,104,32,6,7,4,84.0,,1,1,0,1,,
1448,tt0795361,Cougar Club,2007,"1,000+",2024,67,314,148,2.2,17.0,,1,0,1,1,,
1449,tt0490166,London to Brighton,2006,"5,000+",6293,1288,445,863,3.7,74.0,,28,19,9,28,6.60,68.0
1450,tt0083885,Endangered Species,1982,100+,218,10,19,3,2.9,34.0,,3,2,1,3,,
1451,tt0205380,Sanam Teri Kasam,2009,50+,72,2,0,0,,,,1,0,1,1,,
1452,tt0435181,Manners of Dying,2004,Fewer than 50,8,3,1,1,,,,5,3,2,5,6.40,60.0
1453,tt1363127,Northern Lights,2009,0,0,0,0,0,,,,0,0,0,0,,
1454,tt0120601,Being John Malkovich,1999,"250,000+",262977,38797,5867,11373,4.1,87.0,,135,127,8,135,8.30,94.0
1455,tt0435528,Whisper,2007,"2,500+",4088,437,607,470,3,42.0,,1,0,1,1,,
1456,tt0327888,Hope Ranch,2002,100+,210,10,2,5,4.3,83.0,,0,0,0,0,,
1457,tt2241207,Hibakusha,2012,50+,73,72,0,0,5,100.0,,0,0,0,0,,
1458,tt0079580,Mountain Family Robinson,1979,500+,718,14,9,11,3.7,61.0,,0,0,0,0,,
1459,tt0419828,Hyderabad Blues 2,2004,50+,96,3,6,1,3.4,33.0,,1,0,1,1,,
1460,tt0076137,Herbie Goes to Monte Carlo,1977,"10,000+",13620,329,248,195,3.5,57.0,,10,6,4,10,5.10,60.0
1461,tt1249428,Amexica,2010,Fewer than 50,5,2,0,0,,,,0,0,0,0,,
1462,tt0098546,UHF,1989,"50,000+",50750,4128,1204,2600,3.9,77.0,,23,14,9,23,5.70,61.0
1463,tt0350663,Bugs,2003,100+,111,1,13,3,2,7.0,,0,0,0,0,,
1464,tt0099800,House Party,1990,"25,000+",38620,1954,449,789,4.1,81.0,,31,29,2,31,7.00,94.0
1465,tt0327084,Over the Hedge,2006,"250,000+",543992,34483,14074,22153,3.7,71.0,,173,130,43,173,6.80,75.0
1466,tt0494716,Read It and Weep,2006,"10,000+",21647,764,554,583,3.4,58.0,,4,2,2,4,,
1467,tt0278406,Danger Beneath the Sea,2001,50+,88,3,4,3,3,43.0,,0,0,0,0,,
1468,tt0801819,Analog Days,2006,Fewer than 50,22,2,0,0,,,,0,0,0,0,,
1469,tt1016268,Enron: The Smartest Guys in the Room,2005,"25,000+",32570,2839,441,982,4,87.0,,119,116,3,119,8.10,97.0
1470,tt1142433,Post Grad,2009,"100,000+",188330,1210,3311,1258,2.7,27.0,,100,8,92,100,3.70,8.0
1471,tt1515199,Fertile Ground,2011,250+,335,43,162,83,2.3,21.0,,1,0,1,1,,
1472,tt0108028,Sakay,1993,0,0,0,0,0,,,,0,0,0,0,,
1473,tt0332280,The Notebook,2004,"250,000+",31656590,180712,32282,1258974,3.6,85.0,,182,98,84,182,5.70,54.0
1474,tt0443706,Zodiac,2007,"250,000+",495138,48107,14072,27656,3.8,77.0,,265,238,27,265,7.70,90.0
1475,tt0443706,Zodiac,2007,"250,000+",495138,48107,14072,27656,3.8,77.0,,265,238,27,265,7.70,90.0
1476,tt0332280,The Notebook,2004,"250,000+",31656590,180712,32282,1258974,3.6,85.0,,182,98,84,182,5.70,54.0
1477,tt0281924,I Am Dina,2002,"2,500+",4305,496,163,138,3.8,75.0,,2,1,1,2,,
1478,tt0465670,Wilderness,2006,"5,000+",5039,327,381,346,3.1,46.0,,9,3,6,9,4.70,33.0
1479,tt0368571,Americano,2005,500+,999,92,57,56,3.5,62.0,,8,5,3,8,6.00,63.0
1480,tt0221799,An American Rhapsody,2001,"2,500+",3294,204,105,85,3.6,66.0,,61,34,27,61,5.60,56.0
1481,tt0106317,Attack of the 50 Ft. Woman,1993,100+,199,3,3,2,3.6,50.0,,10,3,7,10,3.60,30.0
1482,tt0115641,Beavis and Butt-Head Do America,1996,"250,000+",302019,6932,3038,5741,3.7,70.0,,55,39,16,55,6.40,71.0
1483,tt0189071,Scooby-Doo and the Ghoul School,1988,250+,323,116,54,26,3.7,68.0,,2,0,2,2,,
1484,tt0462295,Flakes,2007,"1,000+",2428,288,344,227,3.1,46.0,,18,4,14,18,4.40,22.0
1485,tt1170399,C Kkompany,2008,250+,258,14,30,22,2.9,32.0,,1,0,1,1,,
1486,tt1935896,The ABCs of Death,2012,"10,000+",10674,767,2527,578,2.3,23.0,,68,26,42,68,4.90,38.0
1487,tt1772240,Apollo 18,2011,"25,000+",42521,2727,9261,2833,2.4,23.0,,76,18,58,76,4.00,24.0
1488,tt0084359,Mother Lode,1982,100+,136,21,15,10,3.3,58.0,,0,0,0,0,,
1489,tt0107254,Jason Goes to Hell: The Final Friday,1993,"50,000+",59808,896,2923,1648,2.4,24.0,,20,3,17,20,4.20,15.0
1490,tt0107101,Hellbound,1994,"5,000+",6903,65,139,102,2.8,32.0,,1,1,0,1,,
1491,tt0096804,American Ninja 3: Blood Hunt,1989,"1,000+",1659,38,172,68,2.3,18.0,,1,0,1,1,,
1492,tt0271172,Jumping Ship,2001,500+,713,85,54,35,3.6,61.0,,2,1,1,2,,
1493,tt1043876,Woodstock Villa,2008,Fewer than 50,6,0,1,0,,,,0,0,0,0,,
1494,tt0184184,An Act of Conscience,1997,0,0,0,0,0,,,,0,0,0,0,,
1495,tt0433400,Just Friends,2005,"250,000+",420728,16767,6789,13232,3.8,71.0,,109,46,63,109,5.20,42.0
1496,tt1582271,The Good Doctor,2011,"2,500+",4046,299,649,120,2.8,31.0,,28,19,9,28,6.30,68.0
1497,tt0094021,The Squeeze,1987,250+,355,13,34,7,2.6,28.0,,7,1,6,7,3.60,14.0
1498,tt0759743,Underfunded,2006,50+,70,2,5,4,2.8,29.0,,0,0,0,0,,
1499,tt1609119,Happy Husbands,2010,0,0,0,0,0,,,,0,0,0,0,,
1500,tt0833960,Gardens of the Night,2008,"1,000+",1587,274,147,144,3.6,65.0,,14,8,6,14,5.80,57.0
1501,tt1345836,The Dark Knight Rises,2012,"250,000+",1215193,296190,33901,34015,4.4,90.0,,379,328,51,379,8.00,87.0
1502,tt0064379,The Good Guys and the Bad Guys,1969,250+,337,13,33,19,2.9,28.0,,6,1,5,6,5.10,17.0
1503,tt0377084,Ladies in Lavender,2004,"5,000+",8085,826,422,475,3.6,66.0,,92,59,33,92,6.10,64.0
1504,tt0280398,Adhikar,1986,0,0,0,0,0,,,,0,0,0,0,,
1505,tt0075145,The River Niger,1976,50+,89,7,9,6,3.1,44.0,,4,1,3,4,,
1506,tt1865368,Frenemies,2012,100+,145,38,51,12,3,43.0,,1,1,0,1,,
1507,tt1825812,Ik Kudi Punjab Di,2010,Fewer than 50,2,1,0,0,,,,1,1,0,1,,
1508,tt0104054,Dark Horse,1992,100+,132,12,6,3,3.8,67.0,,2,1,1,2,,
1509,tt0455415,Daas,2005,0,0,0,0,0,,,,0,0,0,0,,
1510,tt0056580,The Three Stooges in Orbit,1962,500+,950,45,23,32,3.7,66.0,,1,1,0,1,,
1511,tt0476805,Malamaal Weekly,2006,500+,719,58,42,18,3.5,58.0,,0,0,0,0,,
1512,tt0817228,The Tattooist,2007,"2,500+",2998,270,468,402,2.9,37.0,,2,2,0,2,,
1513,tt0054393,Tormented,1960,250+,432,26,98,64,2.4,21.0,,3,2,1,3,,
1514,tt0119592,Mad City,1997,"5,000+",9620,437,596,222,3.1,42.0,,29,10,19,29,5.10,34.0
1515,tt1729637,Bodyguard,2011,50+,59,5,8,1,2.9,38.0,,0,0,0,0,,
1516,tt0076009,Exorcist II: The Heretic,1977,"25,000+",36591,263,1786,878,1.9,13.0,,65,7,58,65,3.60,11.0
1517,tt0843612,Tulad ng dati,2006,0,0,0,0,0,,,,0,0,0,0,,
1518,tt1103984,Insanitarium,2008,"1,000+",2153,155,385,266,2.7,29.0,,0,0,0,0,,
1519,tt0120623,A Bug's Life,1998,"250,000+",983113,25720,9776,18190,3.7,72.0,,91,84,7,91,7.90,92.0
1520,tt0054671,Battle at Bloody Beach,1961,Fewer than 50,13,0,6,3,2.4,0.0,,1,1,0,1,,
1521,tt0077200,Badaltey Rishtey,1978,0,0,0,0,0,,,,0,0,0,0,,
1522,tt0193246,Jaan Se Pyaara,1992,0,0,0,0,0,,,,0,0,0,0,,
1523,tt0076271,Kingdom of the Spiders,1977,"2,500+",3293,120,212,196,2.9,36.0,,9,4,5,9,5.50,44.0
1524,tt0095382,Iron Eagle II,1988,"5,000+",7814,65,159,73,2.7,29.0,,1,0,1,1,,
1525,tt0245851,Dhairyavanthudu,1986,0,0,0,0,0,,,,0,0,0,0,,
1526,tt0059470,Morituri,1965,500+,925,97,39,46,3.7,71.0,,8,6,2,8,7.30,75.0
1527,tt0071155,The Apprenticeship of Duddy Kravitz,1974,500+,771,79,30,30,3.6,72.0,,14,13,1,14,7.60,93.0
1528,tt0301184,The Ghosts of Edendale,2003,"1,000+",1107,5,30,16,1.9,14.0,,5,4,1,5,6.80,80.0
1529,tt0309150,DreamKeeper,2003,"1,000+",1896,209,12,101,4.5,94.0,,0,0,0,0,,
1530,tt0312510,The Burial Society,2002,100+,109,3,10,8,2.9,23.0,,16,8,8,16,5.60,50.0
1531,tt0066102,Move,1970,0,0,0,0,0,,,,0,0,0,0,,
1532,tt0251160,John Q,2002,"100,000+",169664,9891,2834,4498,3.9,78.0,,133,33,100,133,4.50,25.0
1533,tt0206845,Joseph's Gift,1999,50+,61,3,1,1,,,,0,0,0,0,,
1534,tt0077745,Invasion of the Body Snatchers,1978,"25,000+",35602,3737,837,1364,3.9,82.0,,68,63,5,68,8.20,93.0
1535,tt0053557,Twelve Hours to Kill,1960,Fewer than 50,1,0,1,1,,,,0,0,0,0,,
1536,tt1225902,The Hungry Ghosts,2009,50+,50,6,4,3,3.4,60.0,,7,1,6,7,3.40,14.0
1537,tt1276117,Rock Prophecies,2009,500+,611,39,6,10,4.1,87.0,,0,0,0,0,,
1538,tt0463600,Mayookham,2005,0,0,0,0,0,,,,0,0,0,0,,
1539,tt0107553,Men Don't Tell,1993,100+,175,8,7,3,3.6,53.0,,1,1,0,1,,
1540,tt0053889,Hand in Hand,1961,100+,101,8,1,3,4.2,89.0,,1,1,0,1,,
1541,tt0246500,Who Is Cletis Tout?,2001,"1,000+",2385,117,110,83,3.2,51.0,,56,13,43,56,4.30,23.0
1542,tt0181473,Desserts,1999,"1,000+",1016,34,6,15,4,85.0,,0,0,0,0,,
1543,tt0110913,Pumpkinhead II: Blood Wings,1993,"5,000+",7380,77,310,156,2.5,20.0,,8,1,7,8,4.00,13.0
1544,tt0069312,Stigma,1972,0,0,0,0,0,,,,0,0,0,0,,
1545,tt0089679,The New Kids,1985,"1,000+",1525,76,83,70,3.2,48.0,,5,2,3,5,4.10,40.0
1546,tt0273253,Haiku Tunnel,2001,"1,000+",1199,100,33,61,3.7,75.0,,47,28,19,47,5.70,60.0
1547,tt0055277,The Parent Trap,1961,"100,000+",174715,3880,1325,3155,3.9,75.0,,20,18,2,20,6.90,90.0
1548,tt1589511,TuTuMuch,2010,Fewer than 50,21,2,2,0,,,,0,0,0,0,,
1549,tt0061931,Mad Monster Party?,1967,"2,500+",3351,230,112,154,3.7,67.0,,10,7,3,10,6.40,70.0
1550,tt0400679,Natturajavu,2004,0,0,0,0,0,,,,0,0,0,0,,
1551,tt0395495,Catch and Release,2006,"100,000+",206208,8824,7285,7718,3.3,55.0,,134,30,104,134,4.60,22.0
1552,tt0077668,Here Come the Tigers,1978,Fewer than 50,22,2,4,2,2.6,33.0,,1,0,1,1,,
1553,tt0808510,Tooth Fairy,2010,"100,000+",183839,4927,7060,3895,3,41.0,,115,20,95,115,4.10,17.0
1554,tt0100142,Metropolitan,1990,"5,000+",5346,969,178,340,4,84.0,,43,40,3,43,7.80,93.0
1555,tt0838283,Step Brothers,2008,"250,000+",366361,33263,14807,17852,3.7,69.0,,205,112,93,205,5.60,55.0
1556,tt0079386,Kaala Patthar,1979,100+,102,23,10,2,3.8,70.0,,0,0,0,0,,
1557,tt0359564,Kohtalon kirja,2003,0,0,0,0,0,,,,0,0,0,0,,
1558,tt0271018,Jane White Is Sick & Twisted,2002,500+,513,5,9,5,2.4,36.0,,8,6,2,8,5.90,75.0
1559,tt0264333,The Abduction Club,2002,"1,000+",1020,103,32,46,3.8,76.0,,5,2,3,5,4.90,40.0
1560,tt0073191,Jai Santoshi Maa,1975,0,0,0,0,0,,,,0,0,0,0,,
1561,tt0242888,The Sleeping Dictionary,2003,"5,000+",6814,627,314,351,3.6,67.0,,3,0,3,3,,
1562,tt0109732,"English, August",1994,0,0,0,0,0,,,,0,0,0,0,,
1563,tt0123221,Just the Ticket,1998,"1,000+",1511,32,52,23,3.1,38.0,,13,3,10,13,4.30,23.0
1564,tt0866435,Hotel California,2008,100+,156,19,15,13,3.5,56.0,,0,0,0,0,,
1565,tt0058238,Invitation to a Gunfighter,1964,"1,000+",1258,24,37,19,3,39.0,,3,2,1,3,,
1566,tt1535107,The First Men in the Moon,2010,50+,52,10,11,7,3.2,48.0,,0,0,0,0,,
1567,tt0068699,High Plains Drifter,1973,"25,000+",36065,3820,645,1180,4.1,86.0,,32,30,2,32,7.60,94.0
1568,tt0418647,Dreamer: Inspired by a True Story,2005,"50,000+",90745,2511,721,2107,4,78.0,,116,74,42,116,6.30,64.0
1569,tt0183076,Oi! Warning,1999,100+,152,16,6,5,4,73.0,,0,0,0,0,,
1570,tt0185908,The Base,1999,100+,115,6,16,9,2.4,27.0,,4,0,4,4,,
1571,tt0066592,The Yin and the Yang of Mr. Go,1970,Fewer than 50,18,0,3,1,,,,0,0,0,0,,
1572,tt0393941,Vellinakshatram,2004,0,0,0,0,0,,,,0,0,0,0,,
1573,tt1582248,Puncture,2011,"2,500+",4385,1170,994,403,3.4,54.0,,42,22,20,42,5.60,52.0
1574,tt0295303,Heartlands,2002,"1,000+",1069,131,34,57,3.9,79.0,,5,3,2,5,6.00,60.0
1575,tt1571222,A Dangerous Method,2011,"25,000+",27753,5179,5227,1795,3.2,50.0,,191,150,41,191,6.90,79.0
1576,tt0211933,Awake,2007,"100,000+",237992,10317,8547,8604,3.3,55.0,,62,14,48,62,4.20,23.0
1577,tt0085873,Lovesick,1983,500+,806,14,25,15,3,36.0,,5,2,3,5,5.20,40.0
1578,tt0246162,Pranam Kareedu,1978,0,0,0,0,0,,,,0,0,0,0,,
1579,tt0097493,Heathers,1988,"50,000+",75760,12541,2504,4494,4,83.0,,58,54,4,58,7.80,93.0
1580,tt0058305,The Luck of Ginger Coffey,1964,Fewer than 50,24,1,1,1,,,,3,3,0,3,,
1581,tt0178192,Aap Aye Bahaar Ayee,1971,0,0,0,0,0,,,,0,0,0,0,,
1582,tt1827536,The Ballad of Nessie,2011,250+,317,39,25,2,3.6,61.0,,0,0,0,0,,
1583,tt0107711,Nowhere to Run,1993,"10,000+",20765,387,807,320,2.9,32.0,,25,9,16,25,4.20,36.0
1584,tt0105130,Peter's Friends,1992,"5,000+",6369,702,206,256,3.9,77.0,,37,24,13,37,6.00,65.0
1585,tt0100708,Strike It Rich,1990,100+,165,10,6,1,3.8,62.0,,2,1,1,2,,
1586,tt0088380,Warrior of the Lost World,1983,"1,000+",1324,23,116,63,1.7,17.0,,0,0,0,0,,
1587,tt1564571,Meteor Apocalypse,2010,100+,248,11,45,14,2,20.0,,0,0,0,0,,
1588,tt0426955,Barbie as the Princess and the Pauper,2004,"10,000+",13044,481,158,373,4,75.0,,2,2,0,2,,
1589,tt1226229,Get Him to the Greek,2010,"100,000+",213913,19624,11990,7545,3.5,62.0,,203,147,56,203,6.30,72.0
1590,tt0081398,Raging Bull,1980,"100,000+",131881,26515,2044,7200,4.4,93.0,,150,138,12,150,9.00,92.0
1591,tt0245574,Y tu mamá también,2001,"50,000+",69920,16471,2202,4343,4.1,88.0,,192,174,18,192,8.10,91.0
1592,tt0251690,Ethirum Puthirum,2001,0,0,0,0,0,,,,0,0,0,0,,
1593,tt0060726,"Munster, Go Home!",1966,"1,000+",1702,113,51,43,3.8,69.0,,2,1,1,2,,
1594,tt0969345,Strange Frame: Love & Sax,2012,50+,66,28,3,13,4.2,90.0,,2,2,0,2,,
1595,tt0067204,The Hired Hand,1971,"1,000+",1589,89,30,59,3.8,75.0,,16,13,3,16,7.50,81.0
1596,tt0765487,The Wizard of Gore,2007,"1,000+",1195,93,238,192,2.6,28.0,,5,4,1,5,6.70,80.0
1597,tt2458524,Trivandrum Lodge,2012,Fewer than 50,26,8,0,2,4.2,100.0,,0,0,0,0,,
1598,tt0120800,Quest for Camelot,1998,"25,000+",26954,1057,718,699,3.5,60.0,,30,13,17,30,5.20,43.0
1599,tt0092545,Amazing Grace and Chuck,1987,"1,000+",1389,47,21,24,3.8,69.0,,7,3,4,7,4.80,43.0
1600,tt0119375,Insomnia,1997,Fewer than 50,2,2,0,0,,,,0,0,0,0,,
1601,tt0466679,Arindhum Ariyamalum,2005,Fewer than 50,2,2,0,1,,,,0,0,0,0,,
1602,tt0091680,One Crazy Summer,1986,"10,000+",15071,1030,599,474,3.6,63.0,,20,9,11,20,5.30,45.0
1603,tt0085276,Breathless,1983,"5,000+",7041,296,318,188,3.1,48.0,,16,10,6,16,5.60,63.0
1604,tt0257231,Torrente 2: Misión en Marbella,2001,"2,500+",2976,177,79,48,3.7,69.0,,0,0,0,0,,
1605,tt0053752,The Day They Robbed the Bank of England,1960,Fewer than 50,15,9,1,2,3.9,90.0,,0,0,0,0,,
1606,tt0096895,Batman,1989,"250,000+",912727,53307,10269,29013,4,84.0,,138,105,33,138,7.00,76.0
1607,tt0298514,Ravanaprabhu,2001,0,0,0,0,0,,,,0,0,0,0,,
1608,tt0328828,American Wedding,2003,"250,000+",495024,18319,10752,11181,3.6,63.0,,155,82,73,155,5.80,53.0
1609,tt0099546,Far Out Man,1990,"2,500+",2976,68,69,40,3.3,50.0,,1,0,1,1,,
1610,tt0106364,Batman: Mask of the Phantasm,1993,"5,000+",7804,6860,944,2579,4.2,88.0,,57,47,10,57,7.10,82.0
1611,tt0391198,The Grudge,2004,"250,000+",458865,11342,13167,18511,3.1,46.0,,163,66,97,163,5.10,40.0
1612,tt0456396,L'enfant,2005,"25,000+",32660,1520,583,660,3.7,72.0,,115,97,18,115,7.50,84.0
1613,tt0274546,Hellraiser: Hellseeker,2002,"10,000+",16514,372,772,412,2.7,33.0,,9,0,9,9,3.80,0.0
1614,tt0817544,Never Forever,2007,500+,869,173,72,92,3.6,71.0,,20,16,4,20,6.70,80.0
1615,tt0078446,Up in Smoke,1978,"50,000+",63045,4259,914,1983,4.1,82.0,,19,9,10,19,5.90,47.0
1616,tt0448124,Snow Cake,2006,"10,000+",13648,2135,342,1118,4.1,86.0,,63,41,22,63,6.10,65.0
1617,tt0219171,Ripley Under Ground,2005,500+,630,57,100,45,2.9,37.0,,0,0,0,0,,
1618,tt0058523,Ride the Wild Surf,1964,500+,756,15,16,17,3.2,48.0,,1,1,0,1,,
1619,tt0318828,When Boys Fly,2002,500+,681,6,12,10,2.9,33.0,,0,0,0,0,,
1620,tt0060268,Cul-de-sac,1966,"2,500+",4256,696,192,203,3.8,78.0,,25,21,4,25,7.40,84.0
1621,tt0242423,"Dude, Where's My Car?",2000,"250,000+",367578,9671,10969,12168,3.1,47.0,,60,10,50,60,3.70,17.0
1622,tt0085549,Flashdance,1983,"50,000+",79268,3067,1989,2023,3.6,61.0,,49,18,31,49,4.80,37.0
1623,tt0092112,Trick or Treat,1986,"5,000+",6790,383,227,308,3.6,63.0,,8,6,2,8,5.70,75.0
1624,tt0479199,Buried Alive,2007,100+,249,6,41,22,2.2,13.0,,0,0,0,0,,
1625,tt0435680,Kidulthood,2006,"10,000+",19701,2206,644,1267,3.9,77.0,,3,2,1,3,,
1626,tt0805485,Alaudin,2003,0,0,0,0,0,,,,0,0,0,0,,
1627,tt1054606,The Imaginarium of Doctor Parnassus,2009,"250,000+",295900,15927,10677,7740,3.4,60.0,,197,126,71,197,6.00,64.0
1628,tt0057523,Spencer's Mountain,1963,"1,000+",1452,83,42,35,3.7,66.0,,5,4,1,5,6.70,80.0
1629,tt0116259,Extreme Measures,1996,"10,000+",11031,413,598,225,3.1,41.0,,34,19,15,34,6.00,56.0
1630,tt0388125,In Her Shoes,2005,"250,000+",390921,8444,4350,9096,3.6,66.0,,162,120,42,162,6.80,74.0
1631,tt0216986,Propaganda,1999,250+,446,59,45,6,3.5,57.0,,0,0,0,0,,
1632,tt0106267,The Amy Fisher Story,1993,500+,949,40,56,24,3.2,42.0,,4,2,2,4,,
1633,tt1145446,Fatso,2008,250+,489,78,139,60,2.9,36.0,,0,0,0,0,,
1634,tt1545106,Vamps,2012,"5,000+",5657,453,920,165,2.8,33.0,,18,10,8,18,5.60,56.0
1635,tt2083383,Trouble with the Curve,2012,"25,000+",46237,11360,5825,2077,3.6,66.0,,206,105,101,206,5.60,51.0
1636,tt0423849,Balto III: Wings of Change,2004,"2,500+",4513,168,103,85,3.6,62.0,,2,1,1,2,,
1637,tt0379060,Zenon: Z3,2004,"2,500+",4668,160,185,70,3.2,46.0,,1,1,0,1,,
1638,tt0438575,West Bank Story,2005,500+,750,171,21,82,4.2,89.0,,0,0,0,0,,
1639,tt1331025,The September Issue,2009,"25,000+",49600,1738,705,842,3.6,71.0,,114,95,19,114,7.00,83.0
1640,tt0090738,Black Widow,1987,"2,500+",3821,145,210,101,3.2,41.0,,24,13,11,24,5.40,54.0
1641,tt1568798,15 Till Midnight,2010,Fewer than 50,4,0,1,0,,,,0,0,0,0,,
1642,tt1712057,Vaanam,2011,50+,64,29,9,11,3.7,76.0,,0,0,0,0,,
1643,tt0103628,Against Her Will: An Incident in Baltimore,1992,Fewer than 50,1,0,1,0,,,,0,0,0,0,,
1644,tt0089822,Police Academy 2: Their First Assignment,1985,"50,000+",60704,1187,1612,773,3.1,42.0,,18,5,13,18,4.00,28.0
1645,tt0087979,The Ratings Game,1984,100+,137,5,7,1,3.2,42.0,,3,2,1,3,,
1646,tt0314431,Hope Springs,2003,"5,000+",6961,173,465,221,2.7,27.0,,12,3,9,12,4.70,25.0
1647,tt0929613,Lakshmi Narasimha,2004,Fewer than 50,36,2,0,1,,,,0,0,0,0,,
1648,tt1078940,Couples Retreat,2009,"250,000+",293767,11882,18226,9680,3,39.0,,164,17,147,164,3.80,10.0
1649,tt0420550,Christmas at Maxwell's,2006,0,0,0,0,0,,,,0,0,0,0,,
1650,tt0119874,The Peacemaker,1997,"25,000+",45706,1243,1919,725,3,39.0,,37,17,20,37,6.00,46.0
1651,tt0465616,Stagknight,2007,100+,108,1,12,7,1.9,8.0,,0,0,0,0,,
1652,tt0173910,Running Free,1999,"1,000+",1421,53,21,37,3.7,72.0,,30,8,22,30,4.50,27.0
1653,tt0473658,Inuyasha the Movie: Vol. 4 - Fire on the Mystic Island,2004,0,0,0,0,0,,,,0,0,0,0,,
1654,tt0062472,The War Wagon,1967,"5,000+",7474,339,98,157,3.8,78.0,,11,9,2,11,5.90,82.0
1655,tt0085210,Bad Boys,1983,"50,000+",61615,1214,279,504,3.9,81.0,,20,18,2,20,7.00,90.0
1656,tt1982143,Pillaiyar Theru Kadaisi Veedu,2011,0,0,0,0,0,,,,0,0,0,0,,
1657,tt0071186,Bad Ronald,1974,500+,771,86,68,64,3.6,56.0,,5,3,2,5,6.30,60.0
1658,tt1942905,Kucch Luv Jaisaa,2011,Fewer than 50,6,0,4,1,,,,1,0,1,1,,
1659,tt1467088,Sweet Karma,2009,250+,343,44,88,45,2.8,33.0,,2,0,2,2,,
1660,tt0055253,On the Double,1961,100+,239,19,12,10,3.6,61.0,,0,0,0,0,,
1661,tt0073764,Summer School Teachers,1975,Fewer than 50,8,0,1,0,,,,0,0,0,0,,
1662,tt1183923,Welcome to the Rileys,2010,"10,000+",17530,1604,1172,554,3.4,58.0,,83,45,38,83,5.60,54.0
1663,tt0062262,The Shooting,1966,"1,000+",2018,164,92,85,3.5,64.0,,20,20,0,20,8.40,100.0
1664,tt0896866,Standard Operating Procedure,2008,"2,500+",2728,574,157,373,3.8,78.0,,108,85,23,108,7.10,79.0
1665,tt1773507,Kadha Thudarunnu,2010,0,0,0,0,0,,,,0,0,0,0,,
1666,tt1084746,Twin Rivers,2007,Fewer than 50,1,1,0,1,,,,0,0,0,0,,
1667,tt0072251,The Taking of Pelham One Two Three,1974,"5,000+",9551,2371,337,923,4,88.0,,45,44,1,45,8.30,98.0
1668,tt0099387,The Death of the Incredible Hulk,1990,"2,500+",3865,88,155,94,3,36.0,,5,1,4,5,3.70,20.0
1669,tt0092548,American Ninja 2: The Confrontation,1987,"2,500+",2955,149,224,132,2.9,40.0,,2,2,0,2,,
1670,tt0094963,The Dead Pool,1988,"10,000+",19792,1104,1402,670,3.2,44.0,,34,18,16,34,5.40,53.0
1671,tt0060705,Mister Ten Per Cent,1967,0,0,0,0,0,,,,0,0,0,0,,
1672,tt0463345,La mujer de mi hermano,2005,"10,000+",22421,419,287,276,3.5,59.0,,41,8,33,41,4.30,20.0
1673,tt0938666,Holiday in Handcuffs,2006,"2,500+",3658,511,284,261,3.6,64.0,,1,1,0,1,,
1674,tt0418625,Deadroom,2005,0,0,0,0,0,,,,1,1,0,1,,
1675,tt0443431,Another Gay Movie,2006,"25,000+",33365,1534,964,1125,3.5,62.0,,10,5,5,10,5.00,50.0
1676,tt0402305,Kadhal Kirukkan,2003,0,0,0,0,0,,,,0,0,0,0,,
1677,tt4034118,Seasons of Love,2014,0,0,0,0,0,,,,0,0,0,0,,
1678,tt0271601,Kottayam Kunjachan,1990,0,0,0,0,0,,,,0,0,0,0,,
1679,tt0089791,Pee-wee's Big Adventure,1985,"100,000+",113467,6775,1795,3805,4,79.0,,51,45,6,51,7.80,88.0
1680,tt1172957,How to Live Forever,2009,250+,290,28,26,18,3.4,52.0,,21,13,8,21,6.00,62.0
1681,tt0104448,The Hours and Times,1991,50+,67,21,16,12,3.3,57.0,,17,14,3,17,6.90,82.0
1682,tt0060558,Jesse James Meets Frankenstein's Daughter,1966,"1,000+",1016,8,70,47,1.9,10.0,,7,1,6,7,3.00,14.0
1683,tt0100514,The Rookie,1990,"10,000+",20638,431,768,310,2.9,36.0,,14,4,10,14,4.80,29.0
1684,tt1248236,Premante Inthe,2006,0,0,0,0,0,,,,0,0,0,0,,
1685,tt0286947,Scorched,2003,"5,000+",5059,237,284,160,3.1,45.0,,5,1,4,5,4.90,20.0
1686,tt0092608,Back to the Beach,1987,"5,000+",8049,192,112,160,3.6,63.0,,18,14,4,18,6.00,78.0
1687,tt0229002,Green Dragon,2001,"1,000+",1583,47,47,27,3.3,50.0,,28,17,11,28,6.10,61.0
1688,tt0157262,2001: A Space Travesty,2000,"10,000+",10808,77,379,188,1.9,17.0,,3,1,2,3,,
1689,tt0061177,"What's Up, Tiger Lily?",1966,"5,000+",8081,578,527,341,3.3,52.0,,26,21,5,26,6.90,81.0
1690,tt0343996,The Lost City,2005,"25,000+",25955,741,419,434,3.6,64.0,,82,21,61,82,4.70,26.0
1691,tt0382944,Reversible Errors,2004,500+,876,17,28,17,3.1,38.0,,1,0,1,1,,
1692,tt1731767,Scooby-Doo! Camp Scare,2010,500+,917,239,80,60,4,75.0,,2,2,0,2,,
1693,tt1511532,Special When Lit,2009,100+,138,64,35,15,3.6,65.0,,0,0,0,0,,
1694,tt0098308,She's Out of Control,1989,"5,000+",6521,156,143,131,3.3,52.0,,19,2,17,19,3.50,11.0
1695,tt0083907,The Evil Dead,1981,"100,000+",203510,21879,4306,9068,4.1,84.0,,83,71,12,83,7.70,86.0
1696,tt1287845,Kung Fu Panda: Secrets of the Furious Five,2008,"25,000+",34042,1063,606,552,3.6,64.0,,0,0,0,0,,
1697,tt0067490,The Night Stalker,1972,250+,432,116,35,55,3.8,77.0,,8,7,1,8,6.30,88.0
1698,tt0384642,Kicking & Screaming,2005,"50,000+",70340,3141,4101,2709,3.1,43.0,,142,58,84,142,5.10,41.0
1699,tt0816483,Donsol,2006,Fewer than 50,22,1,0,0,,,,0,0,0,0,,
1700,tt0352994,Walk on Water,2004,"5,000+",5728,808,117,278,4.1,87.0,,75,55,20,75,6.60,73.0
1701,tt0072608,The Adventure of Sherlock Holmes' Smarter Brother,1975,"2,500+",3939,266,197,173,3.5,57.0,,9,5,4,9,5.90,56.0
1702,tt0080461,"Bon Voyage, Charlie Brown (and Don't Come Back!!)",1980,"1,000+",1844,183,50,72,4,79.0,,3,1,2,3,,
1703,tt0113089,Fluke,1995,"5,000+",9028,544,250,365,3.8,68.0,,13,4,9,13,3.90,31.0
1704,tt0459924,Paragraf 78,2007,Fewer than 50,1,0,1,0,,,,0,0,0,0,,
1705,tt0074483,The Enforcer,1976,"10,000+",16101,1522,1053,651,3.4,59.0,,38,27,11,38,6.20,71.0
1706,tt1575671,Sakutumba Saparivara Sametamga,2000,0,0,0,0,0,,,,0,0,0,0,,
1707,tt0057883,The Best Man,1964,500+,689,129,14,61,4.1,90.0,,6,6,0,6,9.00,100.0
1708,tt0978800,La cucina,2007,100+,100,6,13,3,2.5,32.0,,0,0,0,0,,
1709,tt0241753,Naseem,1995,0,0,0,0,0,,,,0,0,0,0,,
1710,tt0271422,Charithram,1989,0,0,0,0,0,,,,0,0,0,0,,
1711,tt0281617,Atomic Twister,2002,500+,544,64,55,33,3.4,54.0,,3,1,2,3,,
1712,tt0281322,Undisputed,2002,"5,000+",9280,600,695,283,3.2,46.0,,107,52,55,107,5.50,49.0
1713,tt0139157,Dil Ek Mandir,1963,0,0,0,0,0,,,,0,0,0,0,,
1714,tt1087517,American High School,2009,500+,503,17,130,64,1.7,12.0,,0,0,0,0,,
1715,tt0250690,Refugee,2000,0,0,0,0,0,,,,1,1,0,1,,
1716,tt0082329,Endless Love,1981,"5,000+",7262,331,314,225,3.2,51.0,,19,5,14,19,4.50,26.0
1717,tt0086996,The Boy Who Loved Trolls,1984,0,0,0,0,0,,,,0,0,0,0,,
1718,tt0379577,Vodka Lemon,2003,"1,000+",1223,179,65,68,3.7,73.0,,30,28,2,30,7.20,93.0
1719,tt0379725,Capote,2005,"100,000+",116073,11960,2705,5270,3.9,82.0,,196,175,21,196,8.20,89.0
1720,tt0086075,Pallavi Anu Pallavi,1983,0,0,0,0,0,,,,0,0,0,0,,
1721,tt2011971,Monsieur Lazhar,2011,"25,000+",26284,2638,426,482,4,86.0,,118,116,2,118,8.20,98.0
1722,tt0760160,Color of the Cross,2006,"1,000+",2224,19,21,23,3.1,48.0,,10,4,6,10,5.80,40.0
1723,tt1674131,An African Election,2011,100+,131,9,2,2,4,82.0,,11,11,0,11,6.50,100.0
1724,tt0114024,Object of Obsession,1994,Fewer than 50,22,1,6,4,2.4,14.0,,0,0,0,0,,
1725,tt0081635,Times Square,1980,"1,000+",1606,130,46,79,3.9,74.0,,16,8,8,16,6.10,50.0
1726,tt0080474,Brubaker,1980,"5,000+",6690,675,244,195,3.7,73.0,,24,18,6,24,6.70,75.0
1727,tt0105810,Where the Day Takes You,1992,"2,500+",3153,223,80,113,3.8,74.0,,5,4,1,5,5.80,80.0
1728,tt0373690,Arsène Lupin,2004,Fewer than 50,10,1,7,2,2.2,12.0,,0,0,0,0,,
1729,tt0102655,The Perfect Weapon,1991,"2,500+",2612,176,105,115,3.6,63.0,,11,4,7,11,3.80,36.0
1730,tt0479537,Seraphim Falls,2006,"10,000+",10998,1570,1367,1400,3.3,53.0,,85,48,37,85,5.70,56.0
1731,tt0411765,Pop Rocks,2004,100+,106,11,12,6,3.3,48.0,,0,0,0,0,,
1732,tt1012804,Redbelt,2008,"10,000+",22019,2214,1192,1868,3.5,65.0,,145,98,47,145,6.30,68.0
1733,tt0418880,Mere Jeevan Saathi,2006,0,0,0,0,0,,,,0,0,0,0,,
1734,tt0319531,I'll Sleep When I'm Dead,2003,"5,000+",8055,354,654,455,2.8,35.0,,89,40,49,89,5.50,45.0
1735,tt1006867,Doubletime,2007,50+,72,2,0,1,,,,1,1,0,1,,
1736,tt0059637,Rat Pfink a Boo Boo,1966,500+,580,31,32,37,3.1,49.0,,1,0,1,1,,
1737,tt0924151,Strange Culture,2007,500+,559,53,37,45,3.4,59.0,,22,20,2,22,7.50,91.0
1738,tt0114268,Rent-a-Kid,1995,"5,000+",5577,77,105,55,3.2,42.0,,0,0,0,0,,
1739,tt0090993,Eat the Peach,1986,50+,69,3,6,2,2.6,33.0,,1,1,0,1,,
1740,tt0084445,One from the Heart,1981,"2,500+",2874,236,151,137,3.5,61.0,,37,18,19,37,6.10,49.0
1741,tt0443567,Left Behind III: World at War,2005,"5,000+",8535,452,225,306,3.6,67.0,,3,0,3,3,,
1742,tt0080684,Star Wars: Episode V - The Empire Strikes Back,1980,"250,000+",1060551,121814,4037,42435,4.6,97.0,,111,105,6,111,9.00,95.0
1743,tt0373856,Gangaajal,2003,100+,159,29,9,5,3.8,76.0,,2,2,0,2,,
1744,tt0109738,Ermo,1994,250+,306,30,6,13,4,83.0,,2,2,0,2,,
1745,tt0071398,Deadly Strangers,1975,50+,64,8,6,6,3.3,57.0,,0,0,0,0,,
1746,tt0389911,Deck Dogz,2005,"1,000+",1048,34,15,35,3.8,69.0,,0,0,0,0,,
1747,tt0086981,Bloodbath at the House of Death,1984,"1,000+",1593,38,55,50,3,41.0,,4,0,4,4,,
1748,tt0795493,Cassandra's Dream,2007,"100,000+",121987,3782,3919,2849,3.2,49.0,,118,54,64,118,5.60,46.0
1749,tt1410020,Freeway Killer,2010,250+,281,19,66,32,2.4,22.0,,0,0,0,0,,
1750,tt0058050,The Earth Dies Screaming,1964,100+,140,13,34,16,3,28.0,,2,1,1,2,,
1751,tt1915581,Magic Mike,2012,"100,000+",145052,24979,16458,5761,3.5,60.0,,217,170,47,217,6.80,78.0
1752,tt0115927,Commandments,1997,"1,000+",1741,30,51,36,3.1,37.0,,17,4,13,17,4.90,24.0
1753,tt0097478,Happy Together,1989,500+,643,32,37,12,3.3,46.0,,0,0,0,0,,
1754,tt0118178,Wish Upon a Star,1996,"5,000+",8830,789,278,375,3.9,74.0,,5,2,3,5,5.00,40.0
1755,tt0201290,The Underground Comedy Movie,1999,"1,000+",1238,16,62,32,1.8,21.0,,6,2,4,6,4.40,33.0
1756,tt0219822,Human Nature,2001,"10,000+",12478,1308,832,597,3.5,61.0,,95,46,49,95,5.70,48.0
1757,tt0102113,In the Nick of Time,1991,500+,656,0,3,3,,,,0,0,0,0,,
1758,tt0087722,Mike's Murder,1984,50+,63,9,12,3,2.8,43.0,,5,4,1,5,6.50,80.0
1759,tt0087742,Les morfalous,1984,"1,000+",1006,106,53,24,3.7,67.0,,2,2,0,2,,
1760,tt0079005,The Cracker Factory,1979,0,0,0,0,0,,,,0,0,0,0,,
1761,tt0374600,A Date with Darkness: The Trial and Capture of Andrew Luster,2003,500+,635,18,6,12,3.9,75.0,,0,0,0,0,,
1762,tt1815837,Moner Manush,2010,Fewer than 50,16,8,2,5,3.8,80.0,,0,0,0,0,,
1763,tt0117437,Raja Hindustani,1996,"1,000+",1920,99,94,29,3.3,51.0,,0,0,0,0,,
1764,tt0997143,Bled,2009,100+,205,7,47,32,1.8,13.0,,0,0,0,0,,
1765,tt0089886,Real Genius,1985,"25,000+",34833,3363,714,1485,4.1,82.0,,35,27,8,35,6.70,77.0
1766,tt0073042,The Ghoul,1975,100+,150,7,15,6,2.9,32.0,,2,1,1,2,,
1767,tt0151738,Never Been Kissed,1999,"250,000+",441227,18449,8450,11255,3.7,69.0,,91,50,41,91,5.70,55.0
1768,tt0182236,La hora de los valientes,1998,Fewer than 50,12,1,1,0,,,,0,0,0,0,,
1769,tt0080274,Shogun,1980,500+,693,219,23,54,4.2,90.0,,8,6,2,8,7.80,75.0
1770,tt0224772,Code Name Phoenix,2000,500+,778,9,2,3,4.4,82.0,,0,0,0,0,,
1771,tt0107875,The Princess and the Goblin,1991,"2,500+",3127,282,85,156,3.9,77.0,,2,0,2,2,,
1772,tt0180073,Quills,2000,"25,000+",45607,4925,1037,2067,4,83.0,,126,95,31,126,6.60,75.0
1773,tt1517561,Thulladha Manamum Thullum,1999,Fewer than 50,15,6,1,0,4.2,86.0,,0,0,0,0,,
1774,tt0285665,Kuruthipunal,1995,Fewer than 50,5,5,0,0,4.9,100.0,,0,0,0,0,,
1775,tt0083869,Eating Raoul,1982,"5,000+",5449,458,185,230,3.7,71.0,,21,18,3,21,6.80,86.0
1776,tt0097662,Kill Me Again,1989,"1,000+",2309,89,101,40,3.1,47.0,,4,4,0,4,,
1777,tt0067183,Haré Rama Haré Krishna,1971,250+,441,29,9,10,3.9,76.0,,0,0,0,0,,
1778,tt0222812,Beyond Re-Animator,2003,"5,000+",9629,328,498,354,3,40.0,,11,6,5,11,5.30,55.0
1779,tt0325618,India: Kingdom of the Tiger,2002,500+,698,9,5,3,3.2,64.0,,6,5,1,6,7.10,83.0
1780,tt1221208,Frankie & Alice,2010,"10,000+",11673,840,591,220,3.6,59.0,,33,7,26,33,4.60,21.0
1781,tt0068311,The Boy Who Turned Yellow,1972,250+,350,2,7,4,3.1,22.0,,0,0,0,0,,
1782,tt0090095,Subway,1985,"5,000+",6416,921,310,297,3.8,75.0,,9,6,3,9,5.60,67.0
1783,tt0821557,Rag Tag,2006,50+,88,12,8,3,3.4,60.0,,0,0,0,0,,
1784,tt0369447,Gauravam,1973,0,0,0,0,0,,,,0,0,0,0,,
1785,tt1007018,The Open Road,2009,"25,000+",38476,165,499,212,2.7,25.0,,7,2,5,7,4.70,29.0
1786,tt0798817,13,2010,"5,000+",5660,740,1412,479,2.8,34.0,,14,1,13,14,3.80,7.0
1787,tt0167049,Billboard Dad,1998,"50,000+",61957,356,391,581,3.2,48.0,,2,0,2,2,,
1788,tt0110737,Only You,1994,"10,000+",21782,1811,832,879,3.7,68.0,,36,19,17,36,5.50,53.0
1789,tt0246144,Pasivadi Pranam,1987,50+,52,5,0,0,4.3,100.0,,0,0,0,0,,
1790,tt0193524,The Star Wars Holiday Special,1978,"10,000+",16645,397,1651,1120,1.8,19.0,,16,4,12,16,3.00,25.0
1791,tt0437503,Tarzan II,2005,"5,000+",9598,203,341,174,2.9,37.0,,6,2,4,6,5.50,33.0
1792,tt1985064,Don't Pass Me By,2013,Fewer than 50,42,13,7,9,3.7,65.0,,0,0,0,0,,
1793,tt0087222,The Evil That Men Do,1984,"2,500+",3596,61,104,57,2.9,37.0,,5,2,3,5,4.50,40.0
1794,tt0119970,Quality Time,2008,Fewer than 50,45,0,2,1,,,,0,0,0,0,,
1795,tt0402247,Hating Alison Ashley,2005,"5,000+",6926,107,104,199,3.2,51.0,,1,0,1,1,,
1796,tt1418673,Hello Kolkata,2008,0,0,0,0,0,,,,0,0,0,0,,
1797,tt0349903,Ocean's Twelve,2004,"250,000+",673317,35313,23527,21397,3.5,60.0,,188,103,85,188,5.90,55.0
1798,tt0087127,Deathstalker,1983,"1,000+",2065,56,161,86,2.5,26.0,,1,1,0,1,,
1799,tt0105414,Single White Female,1992,"25,000+",39156,988,1251,803,3.2,44.0,,49,26,23,49,5.30,53.0
1800,tt0497365,True North,2006,500+,528,57,18,24,3.6,76.0,,11,9,2,11,6.70,82.0
1801,tt0131502,No Code of Conduct,1998,100+,213,16,20,10,3.1,44.0,,3,0,3,3,,
1802,tt1577061,Recep Ivedik 3,2010,100+,134,13,29,7,2.8,31.0,,0,0,0,0,,
1803,tt0426075,Lakeer: Forbidden Lines,2004,500+,783,25,33,17,2.9,43.0,,0,0,0,0,,
1804,tt0074256,Bugsy Malone,1976,"10,000+",21682,1587,393,928,4,80.0,,28,22,6,28,6.50,79.0
1805,tt0356910,Mr. & Mrs. Smith,2005,"250,000+",33461707,82118,59596,1349416,3.4,58.0,,212,127,85,212,6.10,60.0
1806,tt0151466,Main Tulsi Tere Aangan Ki,1978,Fewer than 50,19,2,0,0,,,,0,0,0,0,,
1807,tt0061456,Catalina Caper,1967,100+,141,1,52,18,1.2,2.0,,1,0,1,1,,
1808,tt0065788,Goin' Down the Road,1970,250+,377,71,15,43,3.8,83.0,,4,4,0,4,,
1809,tt0096256,They Live,1988,"25,000+",39626,7104,1808,3233,3.9,80.0,,73,63,10,73,7.30,86.0
1810,tt2279071,"L'affaire Chebeya, un crime d'Etat?",2012,0,0,0,0,0,,,,0,0,0,0,,
1811,tt2222550,1920: Evil Returns,2012,Fewer than 50,2,1,1,0,,,,0,0,0,0,,
1812,tt1810633,Happiness Is a Warm Blanket Charlie Brown,2011,100+,166,69,26,31,3.9,73.0,,3,2,1,3,,
1813,tt0094921,Crossing Delancey,1988,"1,000+",2233,221,66,118,3.9,77.0,,82,66,16,82,7.40,80.0
1814,tt0116405,Getting Away with Murder,1996,"1,000+",2039,11,44,20,2.5,20.0,,8,0,8,8,3.40,0.0
1815,tt0811106,The Ten,2007,"50,000+",77957,1908,2887,2572,2.8,40.0,,83,29,54,83,5.10,35.0
1816,tt0306097,Stratosphere Girl,2004,500+,504,57,31,35,3.7,64.0,,1,1,0,1,,
1817,tt0102116,The Indian Runner,1991,"5,000+",5725,606,148,240,3.9,80.0,,19,14,5,19,5.90,74.0
1818,tt0120746,The Mask of Zorro,1998,"250,000+",375575,11128,4174,7193,3.7,73.0,,79,66,13,79,7.20,84.0
1819,tt1582584,Rama Rama Krishna Krishna,2010,Fewer than 50,41,3,8,0,2.8,27.0,,0,0,0,0,,
1820,tt0419491,Believe in Me,2006,"1,000+",1988,126,46,81,3.9,74.0,,10,6,4,10,5.80,60.0
1821,tt1032815,"I Love You, Beth Cooper",2009,"250,000+",264340,2699,5682,2649,2.7,32.0,,120,16,104,120,3.60,13.0
1822,tt0379708,Bailey's Billion$,2005,"1,000+",1713,32,38,20,3,46.0,,5,1,4,5,4.30,20.0
1823,tt0292181,Peruvannapurathe Visheshangal,1989,0,0,0,0,0,,,,0,0,0,0,,
1824,tt0058756,The World of Henry Orient,1964,"1,000+",1356,120,88,83,3.5,58.0,,11,10,1,11,7.30,91.0
1825,tt0105585,Thunderheart,1992,"10,000+",12178,986,330,406,3.9,75.0,,19,17,2,19,6.50,89.0
1826,tt0331642,Rasigan,1994,0,0,0,0,0,,,,0,0,0,0,,
1827,tt0926762,Loft,2008,Fewer than 50,1,0,1,0,,,,0,0,0,0,,
1828,tt0318520,Oru Oorla Oru Rajakumari,1995,0,0,0,0,0,,,,0,0,0,0,,
1829,tt0101356,Another You,1991,"2,500+",3164,74,145,72,2.8,34.0,,21,1,20,21,2.90,5.0
1830,tt1390533,Bedrooms,2010,50+,84,4,19,6,2.4,17.0,,0,0,0,0,,
1831,tt0100291,Omega Cop,1990,50+,76,5,3,5,3,62.0,,0,0,0,0,,
1832,tt0088206,Supergirl,1984,"25,000+",49354,531,1494,1022,2.5,26.0,,36,3,33,36,3.40,8.0
1833,tt0902952,Acolytes,2008,500+,744,101,138,99,3,42.0,,8,6,2,8,6.30,75.0
1834,tt0067959,Walkabout,1971,"5,000+",8053,1533,244,536,4.1,86.0,,42,36,6,42,8.20,86.0
1835,tt0101660,The Dark Backward,1991,500+,563,93,62,65,3.5,60.0,,11,5,6,11,5.60,45.0
1836,tt0088751,The Naked Monster,2005,100+,143,2,7,7,2.4,22.0,,0,0,0,0,,
1837,tt1042877,Cadillac Records,2008,"50,000+",63269,2367,1250,1523,3.6,65.0,,123,81,42,123,6.10,66.0
1838,tt0970468,Miss Pettigrew Lives for a Day,2008,"50,000+",81569,5805,2365,3676,3.7,71.0,,152,118,34,152,6.70,78.0
1839,tt0903131,All Hat,2007,250+,414,12,40,28,2.7,23.0,,5,1,4,5,4.30,20.0
1840,tt1637691,Khelein Hum Jee Jaan Sey,2010,100+,150,32,32,25,3.1,49.0,,2,1,1,2,,
1841,tt0085551,Get Crazy,1983,500+,724,61,32,41,3.8,66.0,,2,2,0,2,,
1842,tt0110074,The Hudsucker Proxy,1994,"25,000+",43283,5841,1565,2143,3.9,79.0,,47,28,19,47,6.40,60.0
1843,tt0420346,Zzyzx,2006,250+,316,17,26,17,2.8,40.0,,3,2,1,3,,
1844,tt0114537,Steel Frontier,1995,250+,402,12,14,14,3.3,46.0,,0,0,0,0,,
1845,tt0466665,The Architect,2006,Fewer than 50,17,4,4,0,3.1,43.0,,0,0,0,0,,
1846,tt0383353,Evil Aliens,2005,"2,500+",4741,283,257,307,3.1,53.0,,11,5,6,11,4.90,45.0
1847,tt1113829,George Harrison: Living in the Material World,2011,"1,000+",1733,875,65,190,4.2,93.0,,38,33,5,38,7.50,87.0
1848,tt0321058,90 Miles,2001,Fewer than 50,1,1,0,1,,,,0,0,0,0,,
1849,tt0363666,Hatya,1988,0,0,0,0,0,,,,0,0,0,0,,
1850,tt0127637,Land of the Free,1998,50+,69,0,6,2,1.6,0.0,,2,0,2,2,,
1851,tt0069097,"Play It Again, Sam",1972,"10,000+",11242,2199,268,499,4.1,89.0,,35,34,1,35,7.40,97.0
1852,tt0418362,Mujhse Shaadi Karogi,2004,"1,000+",2172,187,100,65,3.7,65.0,,1,0,1,1,,
1853,tt0800022,Electroma,2006,"2,500+",3833,587,223,344,3.7,73.0,,5,3,2,5,5.50,60.0
1854,tt0465936,Charlie's Death Wish,2005,Fewer than 50,19,0,7,2,1.4,0.0,,0,0,0,0,,
1855,tt0075653,Alaap,1977,50+,60,2,3,1,2.6,40.0,,0,0,0,0,,
1856,tt0098385,Stepfather II,1989,"2,500+",2856,95,180,109,3,35.0,,7,1,6,7,4.40,14.0
1857,tt0804516,P2,2007,"50,000+",67921,2183,3856,2721,2.9,36.0,,71,24,47,71,4.40,34.0
1858,tt1360061,The Final Inch,2009,Fewer than 50,22,2,1,1,,,,0,0,0,0,,
1859,tt0070753,Super Fly T.N.T.,1973,Fewer than 50,49,2,9,4,2.8,18.0,,0,0,0,0,,
1860,tt0210382,The Weight of Water,2000,500+,624,238,383,188,3,38.0,,64,22,42,64,5.10,34.0
1861,tt0420181,A Short Film About John Bolton,2003,100+,148,8,13,6,3,40.0,,0,0,0,0,,
1862,tt0457647,Azhagesan,2004,0,0,0,0,0,,,,0,0,0,0,,
1863,tt0120686,Stepmom,1998,"250,000+",272000,7517,2527,5872,3.9,75.0,,93,41,52,93,5.30,44.0
1864,tt0424474,Swapner Din,2004,0,0,0,0,0,,,,0,0,0,0,,
1865,tt1172998,Hurricane Season,2009,500+,664,165,71,38,3.8,70.0,,0,0,0,0,,
1866,tt0384177,Holy Lola,2004,Fewer than 50,34,4,6,3,2.9,40.0,,1,0,1,1,,
1867,tt0425196,Like Minds,2006,"2,500+",2978,368,215,237,3.6,63.0,,8,3,5,8,4.50,38.0
1868,tt0105179,Prom Night IV: Deliver Us from Evil,1991,500+,687,16,108,47,2,13.0,,5,0,5,5,3.10,0.0
1869,tt0808892,Kanda Naal Mudhal,2005,0,0,0,0,0,,,,0,0,0,0,,
1870,tt0054368,Tarzan the Magnificent,1960,Fewer than 50,10,9,0,2,4.1,100.0,,0,0,0,0,,
1871,tt0170704,Train to Pakistan,1998,Fewer than 50,36,5,4,3,3.8,56.0,,0,0,0,0,,
1872,tt1612064,Takkari,2007,0,0,0,0,0,,,,0,0,0,0,,
1873,tt0220029,Second Glance,1992,250+,261,23,25,18,3.2,48.0,,0,0,0,0,,
1874,tt0870089,Ciao,2008,500+,831,70,86,51,3.1,45.0,,12,3,9,12,4.90,25.0
1875,tt0843328,Chatrapathi,2005,0,0,0,0,0,,,,0,0,0,0,,
1876,tt0111067,Sangdil Sanam,1994,50+,65,0,5,0,1.1,0.0,,0,0,0,0,,
1877,tt0060287,Dead Heat on a Merry-Go-Round,1966,"1,000+",1046,13,29,22,2.8,31.0,,6,2,4,6,4.50,33.0
1878,tt0062153,The President's Analyst,1967,"1,000+",1140,151,42,84,3.9,78.0,,22,17,5,22,7.00,77.0
1879,tt0471041,The Tournament,2009,"5,000+",5499,784,1190,716,3,40.0,,2,0,2,2,,
1880,tt0069890,Cleopatra Jones,1973,"2,500+",2686,117,147,121,3.3,44.0,,15,12,3,15,6.10,80.0
1881,tt0758771,Outlaw,2007,"5,000+",8233,1223,1132,1257,3.2,52.0,,19,4,15,19,4.30,21.0
1882,tt0299556,Bloody Mallory,2002,500+,964,47,50,59,2.9,48.0,,1,1,0,1,,
1883,tt0065669,The Dunwich Horror,1970,"2,500+",2637,73,180,102,2.7,29.0,,7,2,5,7,4.50,29.0
1884,tt0067711,Say Hello to Yesterday,1971,Fewer than 50,19,3,1,2,,,,2,1,1,2,,
1885,tt1067584,Xenoa,2007,0,0,0,0,0,,,,0,0,0,0,,
1886,tt0084438,Oliver Twist,1982,0,0,0,0,0,,,,0,0,0,0,,
1887,tt0167260,The Lord of the Rings: The Return of the King,2003,"250,000+",34679773,193983,30876,2050091,3.6,86.0,,278,261,17,278,8.70,94.0
1888,tt15010664,Sonnal Thaan Kaadhala,2001,0,0,0,0,0,,,,0,0,0,0,,
1889,tt0167260,The Lord of the Rings: The Return of the King,2003,"250,000+",34679773,193983,30876,2050091,3.6,86.0,,278,261,17,278,8.70,94.0
1890,tt0071369,Crazy Joe,1974,50+,56,4,7,5,3.2,36.0,,0,0,0,0,,
1891,tt0246794,Murder Seen,2000,0,0,0,0,0,,,,0,0,0,0,,
1892,tt0986225,Duska,2007,0,0,0,0,0,,,,0,0,0,0,,
1893,tt0096046,Scarecrows,1988,"1,000+",1210,121,203,148,2.8,37.0,,12,5,7,12,5.00,42.0
1894,tt0372238,Dinotopia: Quest for the Ruby Sunstone,2005,500+,574,16,28,10,3,36.0,,0,0,0,0,,
1895,tt0120646,The Deep End of the Ocean,1999,"10,000+",19942,844,610,416,3.5,58.0,,36,15,21,36,5.80,42.0
1896,tt0801010,Salakhain,2004,0,0,0,0,0,,,,0,0,0,0,,
1897,tt0120646,The Deep End of the Ocean,1999,"10,000+",19942,844,610,416,3.5,58.0,,36,15,21,36,5.80,42.0
1898,tt0432906,Jargo,2004,50+,61,2,1,1,,,,1,0,1,1,,
1899,tt1176960,One Two Three,2008,"1,000+",2292,79,185,152,2.6,30.0,,2,0,2,2,,
1900,tt1378378,The Widow's Might,2009,50+,69,11,7,5,3.4,61.0,,0,0,0,0,,
1901,tt1477109,Space Battleship Yamato,2010,"2,500+",2896,330,275,183,3.3,55.0,,2,0,2,2,,
1902,tt0109781,Faust,1994,"2,500+",4893,459,49,146,4.2,90.0,,11,8,3,11,6.80,73.0
1903,tt0353880,Pidakkozhi Koovunna Noottandu,1994,0,0,0,0,0,,,,0,0,0,0,,
1904,tt0878674,Garage,2007,"1,000+",2094,328,120,235,3.7,73.0,,4,2,2,4,,
1905,tt0065112,Topaz,1969,"5,000+",6334,344,603,263,3,36.0,,32,22,10,32,6.20,69.0
1906,tt1488601,The Show Must Go On,2010,Fewer than 50,8,2,3,1,3.4,40.0,,0,0,0,0,,
1907,tt0116322,Flipper,1996,"50,000+",57439,563,1072,824,2.9,34.0,,20,6,14,20,4.90,30.0
1908,tt0105695,Unforgiven,1992,"100,000+",123281,22112,1567,6491,4.4,93.0,,110,106,4,110,8.80,96.0
1909,tt0349710,Ladder 49,2004,"250,000+",343237,14289,3306,9108,4.1,81.0,,163,67,96,163,5.40,41.0
1910,tt0098319,Shirley Valentine,1989,"5,000+",5854,783,124,350,4.2,86.0,,18,13,5,18,6.10,72.0
1911,tt0163988,Bringing Out the Dead,1999,"25,000+",38914,3476,1479,1456,3.6,70.0,,113,82,31,113,6.70,73.0
1912,tt0364049,Adventures of Tarzan,1985,Fewer than 50,44,0,1,0,,,,0,0,0,0,,
1913,tt0147800,10 Things I Hate About You,1999,"250,000+",32104911,83914,37644,987442,3.2,69.0,,93,66,27,93,6.30,71.0
1914,tt0255048,Cheppu,1987,0,0,0,0,0,,,,0,0,0,0,,
1915,tt0266915,Rush Hour 2,2001,"250,000+",894402,26601,9438,17756,3.8,74.0,,128,65,63,128,5.40,51.0
1916,tt0120901,Wrongfully Accused,1998,"10,000+",20091,917,705,554,3.4,57.0,,33,6,27,33,4.10,18.0
1917,tt0438052,The Gene Generation,2007,500+,876,50,164,114,2.4,23.0,,1,0,1,1,,
1918,tt0352732,Ponmuttayidunna Tharavu,1988,0,0,0,0,0,,,,0,0,0,0,,
1919,tt0081110,The Man with Bogart's Face,1980,50+,91,9,5,6,3.6,64.0,,1,0,1,1,,
1920,tt0075208,Sherlock Holmes in New York,1976,Fewer than 50,20,7,6,1,3.5,54.0,,1,0,1,1,,
1921,tt0059549,Operation Crossbow,1965,"1,000+",1270,81,68,52,3.4,54.0,,8,6,2,8,6.00,75.0
1922,tt0098180,Red Scorpion,1988,"5,000+",7570,157,286,157,2.9,36.0,,12,2,10,12,3.90,17.0
1923,tt0419468,Baabul,2006,"5,000+",6640,259,107,170,3.8,71.0,,1,0,1,1,,
1924,tt0829442,The Wild Man of the Navidad,2008,100+,152,11,29,19,2.4,28.0,,2,1,1,2,,
1925,tt0265799,Sri Krishnarjuna Yudham,1963,0,0,0,0,0,,,,0,0,0,0,,
1926,tt0110391,Love Affair,1994,"5,000+",5947,287,138,182,3.8,68.0,,29,8,21,29,4.90,28.0
1927,tt0065466,Beyond the Valley of the Dolls,1970,"5,000+",8141,1130,438,687,3.8,72.0,,29,22,7,29,6.70,76.0
1928,tt1023347,Universal Soldiers,2007,250+,486,13,42,18,1.9,24.0,,1,0,1,1,,
1929,tt0067433,Minnie and Moskowitz,1971,"1,000+",1613,296,51,83,4,85.0,,16,13,3,16,7.40,81.0
1930,tt0999986,My Big Break,2009,Fewer than 50,14,3,0,1,,,,1,0,1,1,,
1931,tt0065038,Stiletto,1969,Fewer than 50,13,0,3,3,,,,0,0,0,0,,
1932,tt1237962,Will You Merry Me?,2008,100+,101,13,25,9,3,34.0,,0,0,0,0,,
1933,tt0086879,Amadeus,1984,"100,000+",180470,24046,1328,7757,4.5,95.0,,153,136,17,153,8.90,89.0
1934,tt0134983,Supernova,2000,"10,000+",11072,191,914,335,2.2,17.0,,63,7,56,63,3.50,11.0
1935,tt0344118,A Ninja Pays Half My Rent,2003,0,0,0,0,0,,,,0,0,0,0,,
1936,tt0325805,Matchstick Men,2003,"100,000+",229764,21274,7530,4823,3.8,74.0,,184,152,32,184,7.10,83.0
1937,tt0071807,The Man with the Golden Gun,1974,"50,000+",62657,3715,3007,2131,3.4,55.0,,53,22,31,53,5.30,42.0
1938,tt0173102,Raju Ban Gaya Gentleman,1992,500+,774,37,37,9,3.2,50.0,,0,0,0,0,,
1939,tt0123166,Maria Mariana,1996,0,0,0,0,0,,,,0,0,0,0,,
1940,tt0306597,Brother to Brother,2004,"1,000+",1072,94,35,58,3.7,73.0,,45,34,11,45,6.70,76.0
1941,tt0105690,Under Siege,1992,"50,000+",64121,3115,1936,2060,3.5,62.0,,29,23,6,29,6.20,79.0
1942,tt0279778,Divine Secrets of the Ya-Ya Sisterhood,2002,"50,000+",66486,3091,1676,1708,3.6,65.0,,146,64,82,146,5.30,44.0
1943,tt1438298,Guzaarish,2010,"1,000+",1824,498,194,227,3.8,72.0,,10,6,4,10,6.00,60.0
1944,tt0170016,How the Grinch Stole Christmas,2000,"250,000+",950959,13410,9737,22026,3.5,58.0,,144,71,73,144,5.50,49.0
1945,tt0116817,The Land Before Time IV: Journey Through the Mists,1996,"10,000+",21178,181,223,174,3.2,45.0,,2,1,1,2,,
1946,tt0114852,Village of the Damned,1995,"25,000+",35818,574,1532,814,2.7,27.0,,37,11,26,37,4.00,30.0
1947,tt0120632,City of Angels,1998,"250,000+",345708,26904,5841,11969,4.1,82.0,,60,35,25,60,6.20,58.0
1948,tt0772165,Dark Streets,2008,250+,369,8,48,35,2.1,14.0,,36,7,29,36,4.00,19.0
1949,tt0056983,Dementia 13,1963,"2,500+",4181,205,381,229,3,35.0,,29,20,9,29,5.70,69.0
1950,tt0475645,Vaah! Life Ho Toh Aisi!,2005,250+,436,21,25,17,3.1,46.0,,0,0,0,0,,
1951,tt0117165,Never Ever,1996,Fewer than 50,41,3,3,0,3.7,50.0,,0,0,0,0,,
1952,tt1783411,Veera,2011,Fewer than 50,20,0,6,1,1.5,0.0,,0,0,0,0,,
1953,tt0412798,Half Light,2006,"5,000+",8651,486,558,404,3.1,46.0,,7,2,5,7,4.10,29.0
1954,tt0279781,Sorority Boys,2002,"25,000+",47296,1188,999,1101,3.3,54.0,,68,8,60,68,3.60,12.0
1955,tt0371602,Chelisuva Modagalu,1982,0,0,0,0,0,,,,0,0,0,0,,
1956,tt0375705,Dhill,2001,0,0,0,0,0,,,,0,0,0,0,,
1957,tt0379306,A Good Woman,2004,"100,000+",107296,760,781,607,3.3,49.0,,82,31,51,82,5.30,38.0
1958,tt1754915,Wubbzy's Big Movie!,2008,100+,138,4,3,1,3.3,57.0,,0,0,0,0,,
1959,tt0203230,You Can Count on Me,2000,"10,000+",10709,2260,311,687,4.1,88.0,,105,100,5,105,8.10,95.0
1960,tt0363473,Beyond the Sea,2004,"10,000+",17963,1279,725,903,3.5,64.0,,156,66,90,156,5.20,42.0
1961,tt1612000,Sakhiya,2004,0,0,0,0,0,,,,0,0,0,0,,
1962,tt0114898,Waterworld,1995,"100,000+",230848,5023,6563,7276,3,43.0,,65,30,35,65,5.50,46.0
1963,tt0468565,Tsotsi,2005,"25,000+",39222,4045,640,1683,4,86.0,,131,108,23,131,7.40,82.0
1964,tt0099242,Chattahoochee,1989,"1,000+",1535,60,57,47,3.4,51.0,,9,1,8,9,4.60,11.0
1965,tt0118789,Buffalo '66,1998,"25,000+",34215,5462,751,1718,4.2,88.0,,60,46,14,60,7.10,77.0
1966,tt0092669,Blood Diner,1987,500+,918,161,160,147,3.2,50.0,,7,4,3,7,5.60,57.0
1967,tt0120832,Snake Eyes,1998,"50,000+",62333,1555,2863,1142,2.9,35.0,,68,29,39,68,5.30,43.0
1968,tt0104787,Mad at the Moon,1992,50+,54,1,6,2,2.2,14.0,,1,0,1,1,,
1969,tt0463029,Haunting Sarah,2005,100+,196,23,8,7,3.9,74.0,,0,0,0,0,,
1970,tt0164334,Along Came a Spider,2001,"100,000+",174311,2957,2646,2323,3.3,53.0,,125,40,85,125,4.60,32.0
1971,tt0452644,Lucky Miles,2007,500+,827,176,44,134,3.8,80.0,,2,2,0,2,,
1972,tt0113762,The Mangler,1995,"5,000+",6590,85,374,181,2.3,19.0,,11,3,8,11,5.00,27.0
1973,tt0432402,Factory Girl,2006,"50,000+",77201,4743,3229,3361,3.5,60.0,,113,23,90,113,4.70,20.0
1974,tt0080940,J-Men Forever,1979,500+,965,20,7,17,3.9,73.0,,1,1,0,1,,
1975,tt0758763,The Legend of Simon Conjurer,2006,Fewer than 50,6,2,2,1,,,,0,0,0,0,,
1976,tt1105269,Christmas in Paradise,2007,100+,188,19,12,6,3.7,61.0,,0,0,0,0,,
1977,tt1078912,Night at the Museum: Battle of the Smithsonian,2009,"250,000+",509185,16341,18433,18991,3.2,47.0,,168,74,94,168,5.10,44.0
1978,tt0430912,Basic Instinct 2,2006,"50,000+",89200,895,2500,1541,2.4,26.0,,154,9,145,154,3.30,6.0
1979,tt0323332,My House in Umbria,2003,"1,000+",2113,214,109,124,3.6,66.0,,6,3,3,6,4.50,50.0
1980,tt0067553,Paraya Dhan,1971,0,0,0,0,0,,,,0,0,0,0,,
1981,tt0061937,Magical Mystery Tour,1967,"5,000+",7837,637,474,432,3.5,57.0,,14,9,5,14,5.30,64.0
1982,tt0092666,Blind Date,1987,"10,000+",18571,524,714,304,3.1,42.0,,25,6,19,25,4.60,24.0
1983,tt0068240,Avanti!,1972,"2,500+",3319,320,100,108,3.8,76.0,,24,19,5,24,6.90,79.0
1984,tt0119314,The Horse Whisperer,1998,"50,000+",51567,3048,1192,1437,3.8,72.0,,63,46,17,63,7.00,73.0
1985,tt0075753,Bilitis,1977,250+,404,11,16,6,3.1,41.0,,5,0,5,5,5.00,0.0
1986,tt0102035,Highway 61,1991,"1,000+",1017,196,36,97,4,84.0,,7,7,0,7,6.80,100.0
1987,tt0384639,Uno,2004,"2,500+",3555,327,109,66,3.7,75.0,,0,0,0,0,,
1988,tt0884855,Devadasu,2006,0,0,0,0,0,,,,0,0,0,0,,
1989,tt0384833,Frankenfish,2004,"5,000+",7547,177,354,295,2.7,33.0,,2,2,0,2,,
1990,tt0962733,A Man Among Giants,2008,0,0,0,0,0,,,,1,0,1,1,,
1991,tt0053965,Jis Desh Men Ganga Behti Hai,1960,500+,763,5,2,11,3.8,71.0,,0,0,0,0,,
1992,tt0376108,Rebound,2005,"50,000+",52400,603,995,585,2.9,38.0,,90,13,77,90,3.70,14.0
1993,tt0374018,Man About Dog,2004,500+,981,114,30,58,4,79.0,,0,0,0,0,,
1994,tt0054135,Ocean's Eleven,1960,"100,000+",147258,9678,2294,3095,4,81.0,,31,15,16,31,5.30,48.0
1995,tt0184799,Ordinary Miracles,2005,100+,239,18,17,7,3.6,51.0,,0,0,0,0,,
1996,tt0120389,Turbo: A Power Rangers Movie,1997,"5,000+",9999,469,690,398,2.9,40.0,,19,3,16,19,3.80,16.0
1997,tt0059646,Repulsion,1965,"10,000+",19188,4409,709,1171,4.1,86.0,,67,64,3,67,8.90,96.0
1998,tt0109707,Ed Wood,1994,"100,000+",107435,16085,2212,5905,4.1,88.0,,68,63,5,68,8.00,93.0
1999,tt0150176,Coming Soon,1999,"1,000+",1338,38,111,48,2.5,26.0,,8,3,5,8,4.50,38.0
2000,tt0472181,The Smurfs,2011,"50,000+",71020,8192,10663,3153,3.1,43.0,,119,25,94,119,4.00,21.0
2001,tt0146402,Addams Family Reunion,1998,"10,000+",18160,296,610,270,2.7,33.0,,2,0,2,2,,
2002,tt0090219,Turtle Diary,1985,100+,171,21,7,4,3.9,75.0,,11,9,2,11,7.70,82.0
2003,tt0419677,Dead Man's Shoes,2004,"50,000+",60825,6601,665,3196,4.3,91.0,,48,29,19,48,6.20,60.0
2004,tt2118726,Six Million and One,2011,100+,126,8,2,2,4.2,80.0,,10,9,1,10,7.10,90.0
2005,tt0469810,"Live Once, Die Twice",2006,100+,174,11,14,3,3.1,44.0,,0,0,0,0,,
2006,tt1518812,Meek's Cutoff,2010,"5,000+",9361,1022,896,504,3.1,53.0,,133,114,19,133,7.60,86.0
2007,tt1620581,Rahasya Police,2009,0,0,0,0,0,,,,0,0,0,0,,
2008,tt0461743,Les artistes du Théâtre Brûlé,2005,50+,51,1,0,0,,,,0,0,0,0,,
2009,tt0059711,Shenandoah,1965,"5,000+",6146,401,104,188,4,79.0,,6,6,0,6,7.50,100.0
2010,tt0063540,Sunghursh,1968,0,0,0,0,0,,,,0,0,0,0,,
2011,tt1024724,Dr. Dolittle: Tail to the Chief,2008,"1,000+",1379,104,128,80,3.2,45.0,,1,0,1,1,,
2012,tt0371954,Snakehead Terror,2004,500+,648,26,81,55,2.4,24.0,,0,0,0,0,,
2013,tt2365873,Kevi Rite Jaish,2012,Fewer than 50,14,3,2,0,3.6,60.0,,0,0,0,0,,
2014,tt0111341,Sátántangó,1994,"2,500+",2968,589,47,179,4.5,93.0,,22,22,0,22,8.20,100.0
2015,tt0364556,Neo Ned,2005,500+,873,245,86,81,3.8,74.0,,6,4,2,6,6.40,67.0
2016,tt0071519,Frankenstein and the Monster from Hell,1974,"1,000+",2184,86,93,67,3.3,48.0,,8,5,3,8,4.90,63.0
2017,tt0116192,The Empty Mirror,1996,250+,263,8,2,5,3.6,80.0,,7,5,2,7,6.20,71.0
2018,tt0091295,"Jo Jo Dancer, Your Life Is Calling",1986,"2,500+",3302,112,29,38,4,79.0,,16,8,8,16,5.40,50.0
2019,tt0138414,Edge of Seventeen,1998,"2,500+",3854,367,137,166,3.8,73.0,,25,20,5,25,6.60,80.0
2020,tt0079636,Nocturna Artificialia,1979,50+,71,7,2,2,4,78.0,,0,0,0,0,,
2021,tt0070888,Voices,1973,0,0,0,0,0,,,,0,0,0,0,,
2022,tt0406754,Evilenko,2003,250+,393,56,61,30,3.1,48.0,,3,1,2,3,,
2023,tt0271663,Nair Saab,1989,0,0,0,0,0,,,,0,0,0,0,,
2024,tt0448172,8MM 2,2005,"2,500+",4444,44,215,85,2.2,17.0,,0,0,0,0,,
2025,tt0069124,Private Parts,1972,"1,000+",1570,50,38,45,3.3,57.0,,1,0,1,1,,
2026,tt0230055,Bulandi,2000,Fewer than 50,31,1,8,2,2.4,11.0,,0,0,0,0,,
2027,tt0425186,The Fine Art of Love: Mine Ha-Ha,2005,250+,396,39,27,25,3.4,59.0,,0,0,0,0,,
2028,tt0082979,Reds,1981,"5,000+",9043,1645,352,618,4,82.0,,49,44,5,49,7.90,90.0
2029,tt0339727,Stateside,2004,"1,000+",1912,110,74,62,3.5,60.0,,45,11,34,45,4.30,24.0
2030,tt0214073,Sangamam,1999,0,0,0,0,0,,,,0,0,0,0,,
2031,tt0085995,National Lampoon's Vacation,1983,"100,000+",113670,8161,1486,2829,4.1,85.0,,51,48,3,51,7.40,94.0
2032,tt0147995,The Chosen One: Legend of the Raven,1998,"1,000+",1299,12,18,16,2.6,40.0,,1,0,1,1,,
2033,tt1735862,Dragon Eyes,2012,500+,602,64,288,78,2.3,18.0,,3,2,1,3,,
2034,tt0095188,Funny Farm,1988,"25,000+",25864,852,823,539,3.3,51.0,,22,14,8,22,5.10,64.0
2035,tt0395743,Salaakhen,1975,0,0,0,0,0,,,,0,0,0,0,,
2036,tt0059243,The Great Race,1965,"5,000+",8829,1116,230,576,4.1,83.0,,26,18,8,26,6.00,69.0
2037,tt1037218,Flashbacks of a Fool,2008,"2,500+",3588,660,630,536,3.3,51.0,,22,9,13,22,4.50,41.0
2038,tt0100917,Wheels of Terror,1990,50+,57,10,19,10,2.9,34.0,,0,0,0,0,,
2039,tt0458184,Ullam Ketkumae,2005,0,0,0,0,0,,,,0,0,0,0,,
2040,tt0083909,The Executioner's Song,1982,500+,571,81,28,35,3.7,74.0,,1,0,1,1,,
2041,tt1135933,Never Cry Werewolf,2008,500+,711,94,119,90,3.1,44.0,,2,0,2,2,,
2042,tt0058506,"Quick, Before It Melts",1964,0,0,0,0,0,,,,0,0,0,0,,
2043,tt0101256,976-Evil II,1991,250+,296,15,76,38,2.4,16.0,,1,0,1,1,,
2044,tt0057811,633 Squadron,1964,"5,000+",5474,120,92,100,3.5,57.0,,4,2,2,4,,
2045,tt0161010,The Trench,1999,"1,000+",1215,70,104,65,3,40.0,,4,2,2,4,,
2046,tt0111361,Tammy and the T-Rex,1994,500+,529,40,60,39,2.6,40.0,,7,3,4,7,3.80,43.0
2047,tt0120722,Living Out Loud,1998,"2,500+",3568,197,118,102,3.7,62.0,,35,21,14,35,6.40,60.0
2048,tt0103786,Beethoven,1992,"250,000+",432477,1924,3487,6167,2.9,36.0,,29,9,20,29,4.70,31.0
2049,tt0085513,Exposed,1983,100+,136,10,8,10,3.2,56.0,,4,3,1,4,,
2050,tt0074962,The Next Man,1976,100+,244,2,11,3,2.5,15.0,,8,1,7,8,5.10,13.0
2051,tt0071281,Carry on Dick,1974,500+,620,62,45,30,3.4,58.0,,0,0,0,0,,
2052,tt0077714,I Wanna Hold Your Hand,1978,"2,500+",2926,269,88,113,3.7,75.0,,29,26,3,29,6.80,90.0
2053,tt0058930,Baby the Rain Must Fall,1965,250+,499,26,40,26,3.1,39.0,,5,3,2,5,6.50,60.0
2054,tt1269560,Love Takes Wing,2009,250+,477,85,46,29,3.8,65.0,,0,0,0,0,,
2055,tt1764366,Hollywood Sex Wars,2011,50+,73,3,21,4,2,12.0,,0,0,0,0,,
2056,tt0111418,Threesome,1994,"5,000+",8760,549,438,274,3.4,56.0,,25,7,18,25,4.60,28.0
2057,tt0317648,Hidalgo,2004,"100,000+",130494,4371,2428,3008,3.6,64.0,,165,76,89,165,5.50,46.0
2058,tt0469623,Things We Lost in the Fire,2007,"25,000+",30888,4887,1809,2904,3.7,73.0,,127,82,45,127,6.50,65.0
2059,tt0851430,My Boy Jack,2007,"2,500+",2516,404,161,223,3.7,72.0,,14,10,4,14,6.70,71.0
2060,tt0096928,Bill & Ted's Excellent Adventure,1989,"250,000+",376666,14744,4894,10479,3.8,75.0,,57,47,10,57,6.90,82.0
2061,tt0102201,Khoon Ka Karz,1991,0,0,0,0,0,,,,0,0,0,0,,
2062,tt1217426,Easier with Practice,2009,500+,842,171,72,70,3.6,70.0,,34,30,4,34,7.10,88.0
2063,tt0436339,G-Force,2009,"250,000+",964760,5427,8292,6778,3,40.0,,128,28,100,128,4.40,22.0
2064,tt1037011,Ben 10: Race Against Time,2007,500+,949,151,173,95,3.2,47.0,,2,2,0,2,,
2065,tt0099313,Crash and Burn,1990,100+,123,5,18,11,2.7,22.0,,0,0,0,0,,
2066,tt0189092,Simon mágus,1999,50+,70,7,2,1,3.9,78.0,,0,0,0,0,,
2067,tt0089927,Rocky IV,1985,"250,000+",326242,475,128,114,4,79.0,,51,20,31,51,5.10,39.0
2068,tt0128995,The Christmas Raccoons,1980,0,0,0,0,0,,,,0,0,0,0,,
2069,tt0067749,Shinbone Alley,1970,500+,884,13,6,11,3.6,68.0,,4,3,1,4,,
2070,tt1042910,"Shake, Rattle & Roll 9",2007,0,0,0,0,0,,,,0,0,0,0,,
2071,tt0115857,Chain Reaction,1996,"50,000+",52573,806,2158,746,2.7,27.0,,34,6,28,34,4.20,18.0
2072,tt0238414,Mickey's Once Upon a Christmas,1999,"10,000+",17795,350,177,226,3.7,66.0,,5,2,3,5,5.60,40.0
2073,tt0472033,9,2009,"250,000+",282394,15785,12535,10371,3.4,56.0,,185,106,79,185,5.90,57.0
2074,tt0081059,Lion of the Desert,1980,"2,500+",3733,448,35,120,4.5,93.0,,8,6,2,8,7.30,75.0
2075,tt0144546,Outside Ozona,1998,100+,123,6,8,7,3.6,43.0,,8,2,6,8,5.30,25.0
2076,tt0097228,Dr. Caligari,1989,250+,270,44,21,23,3.7,67.0,,1,0,1,1,,
2077,tt0107977,Robin Hood: Men in Tights,1993,"250,000+",323046,25870,6128,14816,4,81.0,,45,19,26,45,5.10,42.0
2078,tt0059312,The Informers,1963,0,0,0,0,0,,,,0,0,0,0,,
2079,tt0098513,Triumph of the Spirit,1989,"1,000+",1251,76,68,33,3.4,53.0,,8,5,3,8,5.50,63.0
2080,tt0459327,Gie,2005,500+,685,85,14,52,4.1,86.0,,0,0,0,0,,
2081,tt0889146,My Name Is Jerry,2009,50+,98,7,6,7,3.2,54.0,,0,0,0,0,,
2082,tt0839762,City of Rott,2006,"2,500+",4296,37,54,62,2.8,41.0,,2,2,0,2,,
2083,tt0470732,Bernard and Doris,2006,"1,000+",1936,243,197,181,3.3,55.0,,3,2,1,3,,
2084,tt0147857,Atomic Dog,1998,Fewer than 50,16,2,3,2,2.7,40.0,,2,0,2,2,,
2085,tt0098470,Those She Left Behind,1989,Fewer than 50,32,0,1,1,,,,0,0,0,0,,
2086,tt0099291,Come See the Paradise,1990,250+,481,81,30,37,3.7,73.0,,11,7,4,11,5.50,64.0
2087,tt0164550,Duplicate,1998,"1,000+",2162,111,109,45,3.1,50.0,,0,0,0,0,,
2088,tt0187412,Pokkiri Raja,1982,0,0,0,0,0,,,,0,0,0,0,,
2089,tt0093093,The Glass Menagerie,1987,500+,519,68,42,25,3.5,62.0,,12,9,3,12,6.00,75.0
2090,tt0839938,Out of the Blue,2006,Fewer than 50,1,0,1,0,,,,0,0,0,0,,
2091,tt0090653,Apology,1986,50+,70,4,8,2,3,33.0,,0,0,0,0,,
2092,tt0114682,"To Wong Foo Thanks for Everything, Julie Newmar",1995,"50,000+",50772,2901,1156,2015,3.8,72.0,,44,20,24,44,5.40,45.0
2093,tt0840272,The 9/11 Commission Report,2006,Fewer than 50,1,0,1,0,,,,0,0,0,0,,
2094,tt0088001,Rhinestone,1984,"5,000+",7577,178,322,232,2.7,36.0,,15,3,12,15,3.30,20.0
2095,tt0075147,Robin and Marian,1976,"5,000+",8441,369,328,201,3.3,53.0,,37,27,10,37,6.70,73.0
2096,tt0819354,10 Questions for the Dalai Lama,2006,100+,244,62,23,14,3.7,73.0,,14,11,3,14,6.80,79.0
2097,tt0822847,Priest,2011,"50,000+",86712,21851,25471,3837,3.2,46.0,,100,15,85,100,4.00,15.0
2098,tt0107333,Knights,1993,500+,521,16,27,18,2.6,37.0,,3,0,3,3,,
2099,tt0138050,Raiders of the Living Dead,1986,100+,130,0,14,8,1.4,0.0,,0,0,0,0,,
2100,tt0058390,The Naked Kiss,1964,"2,500+",3167,427,110,190,3.9,80.0,,15,14,1,15,7.80,93.0
2101,tt0307682,Yeh Dil Aashiqanaa,2002,50+,80,2,1,2,,,,0,0,0,0,,
2102,tt0438488,Terminator Salvation,2009,"250,000+",885481,32246,28071,31135,3.3,53.0,,281,93,188,281,5.10,33.0
2103,tt0072064,Rajnigandha,1974,0,0,0,0,0,,,,1,1,0,1,,
2104,tt0197094,What Becomes of the Broken Hearted?,1999,"2,500+",4315,200,97,129,3.7,67.0,,1,0,1,1,,
2105,tt0101366,Arena,1989,500+,751,61,115,71,2.7,35.0,,2,2,0,2,,
2106,tt0154838,Manmatha Leelai,1976,0,0,0,0,0,,,,0,0,0,0,,
2107,tt0978698,Samanyudu,2006,0,0,0,0,0,,,,0,0,0,0,,
2108,tt0109770,The Fantastic Four,1994,"5,000+",7625,233,506,291,2.5,32.0,,11,3,8,11,4.00,27.0
2109,tt0122933,Analyze This,1999,"100,000+",224704,5021,3069,2408,3.5,62.0,,106,73,33,106,6.50,69.0
2110,tt0432047,Sarkar,2005,500+,555,153,34,22,3.8,82.0,,0,0,0,0,,
2111,tt0063227,The Lion in Winter,1968,"10,000+",13156,2100,233,896,4.4,90.0,,43,39,4,43,8.20,91.0
2112,tt0259822,.45,2006,"5,000+",5205,363,603,438,2.9,38.0,,1,0,1,1,,
2113,tt0366943,Reconstruction,2003,"5,000+",5076,792,124,198,4.2,87.0,,38,27,11,38,6.30,71.0
2114,tt0405676,All the King's Men,2006,"50,000+",92042,1295,1944,1408,2.9,40.0,,158,19,139,158,4.30,12.0
2115,tt0157339,Baton Baton Mein,1979,0,0,0,0,0,,,,0,0,0,0,,
2116,tt0068615,Frogs,1972,"5,000+",6082,143,442,322,2.4,24.0,,17,5,12,17,4.40,29.0
2117,tt0249516,Foodfight!,2012,"1,000+",2260,106,895,407,1.1,11.0,,3,0,3,3,,
2118,tt1474271,Love Khichdi,2009,0,0,0,0,0,,,,1,0,1,1,,
2119,tt0419992,My Brother... Nikhil,2005,250+,343,46,13,21,3.9,78.0,,2,2,0,2,,
2120,tt0120684,Gods and Monsters,1998,"10,000+",13168,1768,376,607,3.9,83.0,,71,68,3,71,8.50,96.0
2121,tt0059726,Ski Party,1965,500+,749,17,27,20,3,39.0,,2,1,1,2,,
2122,tt0087928,Police Academy,1984,"100,000+",194745,3831,2162,3116,3.6,64.0,,32,18,14,32,5.30,56.0
2123,tt0116311,First Kid,1996,"25,000+",35790,302,647,492,2.8,32.0,,15,3,12,15,4.20,20.0
2124,tt0091353,Kojak: The Price of Justice,1987,0,0,0,0,0,,,,0,0,0,0,,
2125,tt0092897,Disorderlies,1987,"2,500+",3612,111,99,105,3.4,53.0,,2,0,2,2,,
2126,tt0066549,Waterloo,1970,"1,000+",2062,418,87,200,4.1,83.0,,11,3,8,11,5.70,27.0
2127,tt0251110,Gypsy 83,2001,"2,500+",3045,305,85,166,4,78.0,,26,14,12,26,5.50,54.0
2128,tt0064061,The Ballad of Andy Crocker,1969,50+,60,2,2,4,,,,0,0,0,0,,
2129,tt0090109,Swathi Muthyam,1986,0,0,0,0,0,,,,1,1,0,1,,
2130,tt0103957,Children of the Night,1991,500+,824,20,39,28,2.6,34.0,,1,0,1,1,,
2131,tt0055318,Posse from Hell,1961,100+,132,5,12,7,3,29.0,,1,1,0,1,,
2132,tt0320422,Saved by the Belles,2003,Fewer than 50,11,1,0,0,,,,4,2,2,4,,
2133,tt1431191,Wrong Side of Town,2010,"1,000+",1050,84,439,141,1.8,16.0,,1,0,1,1,,
2134,tt0133093,The Matrix,1999,"250,000+",33324202,142778,24632,1307885,3.6,85.0,,207,171,36,207,7.70,83.0
2135,tt0945405,The Trial of Tony Blair,2007,50+,90,6,4,3,3.6,60.0,,0,0,0,0,,
2136,tt1754264,Never Back Down 2: The Beatdown,2011,"1,000+",1856,403,397,128,3.3,50.0,,1,0,1,1,,
2137,tt0343172,What Alice Found,2003,500+,716,55,56,30,3.2,50.0,,38,26,12,38,6.30,68.0
2138,tt0117350,Plump Fiction,1997,"5,000+",6082,80,122,82,2.7,40.0,,5,0,5,5,3.50,0.0
2139,tt0081069,The Long Days of Summer,1980,0,0,0,0,1,,,,0,0,0,0,,
2140,tt1477837,Cedar Rapids,2011,"25,000+",26176,5775,3964,2069,3.4,59.0,,169,145,24,169,6.70,86.0
2141,tt0436689,The Puffy Chair,2005,"5,000+",5106,695,424,405,3.4,62.0,,52,40,12,52,6.80,77.0
2142,tt0099312,Cover-Up,1991,250+,370,7,34,18,2.1,17.0,,0,0,0,0,,
2143,tt0791274,Everest,2007,Fewer than 50,41,3,8,1,2.9,27.0,,0,0,0,0,,
2144,tt0470869,Neal 'N' Nikki,2005,0,0,0,0,0,,,,0,0,0,0,,
2145,tt0234829,Summer Catch,2001,"50,000+",50067,844,1239,732,3,41.0,,91,7,84,91,3.40,8.0
2146,tt0066114,My Sweet Charlie,1970,Fewer than 50,34,3,0,3,,,,1,1,0,1,,
2147,tt0065962,Land Raiders,1969,Fewer than 50,49,1,8,6,2.4,11.0,,1,0,1,1,,
2148,tt0096160,Splendor,1989,Fewer than 50,26,7,2,2,3.7,78.0,,0,0,0,0,,
2149,tt0102371,The Magic Riddle,1991,0,0,0,0,0,,,,0,0,0,0,,
2150,tt0762114,License to Wed,2007,"250,000+",512687,23839,21514,21684,3.3,53.0,,124,9,115,124,3.30,7.0
2151,tt0133412,Best Laid Plans,1999,"5,000+",6660,178,283,138,3.1,39.0,,21,9,12,21,5.80,43.0
2152,tt0309005,Tum Haseen Main Jawan,1970,0,0,0,0,0,,,,0,0,0,0,,
2153,tt0250415,Har Dil Jo Pyar Karega...,2000,"1,000+",2171,73,78,36,3.3,48.0,,0,0,0,0,,
2154,tt0076067,The Gathering,1977,Fewer than 50,36,11,3,5,4,79.0,,0,0,0,0,,
2155,tt0070355,Magnum Force,1973,"25,000+",29081,2906,844,983,3.8,77.0,,28,19,9,28,6.70,68.0
2156,tt0076890,Viva Knievel!,1977,100+,148,5,35,18,1.9,12.0,,7,1,6,7,2.70,14.0
2157,tt0944233,Shankardada Zindabad,2007,100+,147,7,2,3,3.7,78.0,,0,0,0,0,,
2158,tt0079889,Sankarabharanam,1980,0,0,0,0,0,,,,0,0,0,0,,
2159,tt0064639,Marooned,1969,"1,000+",1497,105,127,77,3.2,45.0,,7,6,1,7,6.70,86.0
2160,tt1506999,Haywire,2011,"25,000+",43490,8684,12627,4738,2.9,41.0,,200,160,40,200,6.90,80.0
2161,tt0306645,Chinna Thambi,1991,0,0,0,0,0,,,,0,0,0,0,,
2162,tt1723124,Inbred,2011,250+,373,68,163,68,2.7,29.0,,12,3,9,12,3.00,25.0
2163,tt0101410,Barton Fink,1991,"25,000+",45504,9859,1248,2646,4.1,89.0,,65,58,7,65,7.90,89.0
2164,tt0282554,Hello Brother,1994,0,0,0,0,0,,,,0,0,0,0,,
2165,tt0061747,Hang 'Em High,1968,"25,000+",33006,2192,799,745,3.7,73.0,,13,12,1,13,6.50,92.0
2166,tt1266116,Vault of Darkness,2009,0,0,0,0,0,,,,0,0,0,0,,
2167,tt0062711,Barbarella,1968,"25,000+",33622,1913,1521,1451,3.4,56.0,,48,36,12,48,6.20,75.0
2168,tt0098331,"Silent Night, Deadly Night 3: Better Watch Out!",1989,500+,728,20,158,88,2,11.0,,3,0,3,3,,
2169,tt0082020,The Animals Film,1981,50+,95,5,1,1,4.5,83.0,,0,0,0,0,,
2170,tt0117260,Original Gangstas,1996,"1,000+",2306,72,79,61,3.3,48.0,,15,8,7,15,5.60,53.0
2171,tt0337711,Rugrats Go Wild,2003,"10,000+",17897,533,835,317,3,39.0,,88,35,53,88,5.00,40.0
2172,tt0058626,Surf Party,1964,50+,69,1,8,8,2.2,11.0,,0,0,0,0,,
2173,tt0172300,Daulat Ki Jung,1992,0,0,0,0,0,,,,0,0,0,0,,
2174,tt0160236,Dudley Do-Right,1999,"25,000+",40207,272,871,533,2.4,24.0,,45,7,38,45,4.00,16.0
2175,tt0059127,"Dracula, Prince of Darkness",1966,"5,000+",8464,394,208,245,3.6,66.0,,21,17,4,21,6.30,81.0
2176,tt0220095,Thicker Than Water,1999,"1,000+",1558,81,32,25,3.9,72.0,,2,1,1,2,,
2177,tt0055805,Boccaccio '70,1962,"2,500+",2517,186,52,51,3.9,78.0,,12,6,6,12,6.60,50.0
2178,tt0384573,Swimmers,2005,100+,222,25,9,11,3.8,74.0,,6,5,1,6,5.90,83.0
2179,tt1279966,Rivers Wash Over Me,2009,Fewer than 50,48,6,6,2,3.1,50.0,,2,2,0,2,,
2180,tt1503639,Excited,2009,Fewer than 50,38,6,4,4,3.7,60.0,,1,0,1,1,,
2181,tt2254124,Thatsamayam Oru Penkutty,2012,0,0,0,0,0,,,,0,0,0,0,,
2182,tt0196229,Zoolander,2001,"250,000+",945237,64076,15970,37120,4,80.0,,141,91,50,141,6.00,65.0
2183,tt0080380,The Apple,1980,"1,000+",1232,138,147,191,3,48.0,,11,3,8,11,4.00,27.0
2184,tt0101428,La Belle Noiseuse,1991,500+,566,465,100,159,4,82.0,,28,28,0,28,8.20,100.0
2185,tt0109415,Children of the Corn III: Urban Harvest,1995,"10,000+",11852,117,339,193,2.6,26.0,,2,2,0,2,,
2186,tt0356561,Duck! The Carbine High Massacre,1999,"1,000+",1495,16,20,24,2.6,44.0,,1,1,0,1,,
2187,tt0233264,Avtaar,1983,0,0,0,0,0,,,,0,0,0,0,,
2188,tt1199550,Hit and Run,2009,"10,000+",10283,55,296,166,2.1,16.0,,1,0,1,1,,
2189,tt0438875,Insan,2005,100+,222,6,9,1,2.6,40.0,,0,0,0,0,,
2190,tt0337741,Something's Gotta Give,2003,"100,000+",208184,10726,4754,5427,3.7,69.0,,172,124,48,172,6.60,72.0
2191,tt0307873,Raaz,2002,"1,000+",2003,63,57,50,3.3,52.0,,0,0,0,0,,
2192,tt0229950,Aya Sawan Jhoom Ke,1969,0,0,0,0,0,,,,0,0,0,0,,
2193,tt0346750,Christmas Child,2004,"1,000+",1281,38,24,30,3.7,62.0,,0,0,0,0,,
2194,tt1525838,Gun Hill Road,2011,500+,742,105,50,30,3.7,68.0,,31,20,11,31,6.10,65.0
2195,tt0247944,Badal,2000,100+,107,3,7,2,2.6,30.0,,0,0,0,0,,
2196,tt0250934,61*,2001,"10,000+",15802,1996,214,743,4.2,90.0,,28,24,4,28,6.80,86.0
2197,tt0118531,One Eight Seven,1997,"10,000+",20799,1288,621,565,3.7,68.0,,27,8,19,27,5.20,30.0
2198,tt0073820,Trilogy of Terror,1975,"5,000+",5211,270,207,230,3.6,57.0,,13,12,1,13,7.80,92.0
2199,tt0156745,Loafer,1973,0,0,0,0,0,,,,0,0,0,0,,
2200,tt0120680,Frogs for Snakes,1998,250+,317,2,9,2,2.5,18.0,,11,3,8,11,4.50,27.0
2201,tt1183696,Second Skin,2008,250+,408,68,93,60,3.2,42.0,,5,3,2,5,6.20,60.0
2202,tt0060283,The Daydreamer,1966,50+,88,6,9,6,3,40.0,,3,2,1,3,,
2203,tt0862846,Sunshine Cleaning,2008,"100,000+",180745,7675,4591,4182,3.5,63.0,,182,135,47,182,6.40,74.0
2204,tt0371558,Bairaag,1976,0,0,0,0,0,,,,0,0,0,0,,
2205,tt0056914,Cattle King,1963,Fewer than 50,8,2,2,2,,,,0,0,0,0,,
2206,tt0107501,The Man Without a Face,1993,"25,000+",44854,1486,836,698,3.6,64.0,,24,16,8,24,5.70,67.0
2207,tt0465925,Brother Bear 2,2006,"10,000+",24426,789,649,529,3.4,55.0,,8,4,4,8,5.60,50.0
2208,tt0493421,Greetings from the Shore,2007,100+,123,19,15,9,3.4,56.0,,10,7,3,10,6.30,70.0
2209,tt0119012,Double Tap,1997,250+,388,55,18,11,3.7,75.0,,2,1,1,2,,
2210,tt0419256,Wah-Wah,2005,"10,000+",19337,344,206,263,3.5,63.0,,69,37,32,69,5.90,54.0
2211,tt0089272,Here Come the Littles,1985,"1,000+",1695,13,9,11,3.6,59.0,,0,0,0,0,,
2212,tt0067555,Parwana,1971,0,0,0,0,0,,,,0,0,0,0,,
2213,tt0424136,Hard Candy,2005,"100,000+",106066,18243,5310,10800,3.8,77.0,,149,100,49,149,6.50,67.0
2214,tt1102250,Kichamani M.B.A.,2007,0,0,0,0,0,,,,0,0,0,0,,
2215,tt0242527,The Hole,2001,"25,000+",34535,1723,1548,1283,3.3,53.0,,17,9,8,17,5.80,53.0
2216,tt0109836,Frankenstein,1994,100+,104,7,8,2,2.9,47.0,,6,1,5,6,3.30,17.0
2217,tt0435692,A Lousy 10 Grand,2004,Fewer than 50,44,1,0,0,,,,0,0,0,0,,
2218,tt0242527,The Hole,2001,"25,000+",34535,1723,1548,1283,3.3,53.0,,17,9,8,17,5.80,53.0
2219,tt1137434,Aabra Ka Daabra,2004,Fewer than 50,10,2,1,0,,,,0,0,0,0,,
2220,tt0110936,Radio Inside,1994,50+,96,5,8,5,3.2,38.0,,0,0,0,0,,
2221,tt2034011,Hum Tum Shabana,2011,Fewer than 50,1,0,1,0,,,,1,0,1,1,,
2222,tt0098491,Toofan,1989,100+,109,5,7,1,3.2,42.0,,0,0,0,0,,
2223,tt0116409,The Ghost and the Darkness,1996,"50,000+",53708,4223,1427,1681,3.9,75.0,,52,26,26,52,5.40,50.0
2224,tt0168987,Better Than Chocolate,1999,"10,000+",11716,1366,396,567,4,78.0,,26,12,14,26,6.00,46.0
2225,tt0061787,Hour of the Gun,1967,"1,000+",1635,62,61,42,3.4,50.0,,8,7,1,8,6.90,88.0
2226,tt0104549,Jennifer Eight,1992,"5,000+",7009,237,419,133,3,36.0,,21,8,13,21,5.30,38.0
2227,tt0058500,The Pumpkin Eater,1964,250+,489,75,29,41,3.7,72.0,,15,10,5,15,8.00,67.0
2228,tt0111151,Mad Dogs and Englishmen,1995,500+,777,6,11,4,2.7,35.0,,3,1,2,3,,
2229,tt0142634,Nobody Knows Anything!,2003,500+,572,4,17,6,2.2,19.0,,0,0,0,0,,
2230,tt0096149,Space Mutiny,1988,100+,215,15,105,35,1.6,12.0,,4,0,4,4,,
2231,tt0245755,Bavagaru Bagunnara?,1998,0,0,0,0,0,,,,0,0,0,0,,
2232,tt0119717,Mr. Jealousy,1997,"1,000+",1489,131,89,74,3.4,60.0,,14,10,4,14,6.60,71.0
2233,tt0461323,Pyare Mohan,2006,500+,691,21,35,17,2.9,38.0,,0,0,0,0,,
2234,tt0080377,Any Which Way You Can,1980,"10,000+",21153,533,652,358,3.2,45.0,,10,2,8,10,4.90,20.0
2235,tt0066870,Bunny O'Hare,1971,Fewer than 50,28,4,7,2,3,36.0,,4,1,3,4,,
2236,tt0490822,Bring It On: All or Nothing,2006,"100,000+",247250,12299,5358,9331,3.8,70.0,,5,1,4,5,3.80,20.0
2237,tt0076319,A Little Night Music,1977,100+,120,7,17,14,2.7,29.0,,11,2,9,11,3.70,18.0
2238,tt0094304,Weeds,1987,250+,494,18,15,7,3.4,55.0,,7,5,2,7,7.10,71.0
2239,tt0069992,Don't Be Afraid of the Dark,1973,500+,905,156,116,111,3.5,57.0,,7,5,2,7,6.80,71.0
2240,tt0082894,Pennies from Heaven,1981,"2,500+",3717,272,149,168,3.5,65.0,,29,24,5,29,7.00,83.0
2241,tt0290002,Meet the Fockers,2004,"250,000+",33181885,66560,48278,1434300,3.5,58.0,,166,64,102,166,5.20,39.0
2242,tt0094262,Video Violence,1987,100+,156,7,22,12,2.6,24.0,,0,0,0,0,,
2243,tt0498366,The Life of Reilly,2006,500+,866,86,17,37,4.1,83.0,,44,43,1,44,7.50,98.0
2244,tt0459424,Kalvanin Kadhali,2006,0,0,0,0,0,,,,0,0,0,0,,
2245,tt0075213,The Shootist,1976,"5,000+",9678,1300,178,537,4.1,88.0,,24,20,4,24,8.10,83.0
2246,tt0115579,Assault on Dome 4,1996,Fewer than 50,1,0,1,1,,,,0,0,0,0,,
2247,tt0910934,Urban Justice,2007,"2,500+",2739,192,300,239,3,39.0,,2,1,1,2,,
2248,tt0286620,Fareb,1996,0,0,0,0,0,,,,0,0,0,0,,
2249,tt0065484,Bombay Talkie,1970,100+,110,4,12,7,2.4,25.0,,3,1,2,3,,
2250,tt0102848,Scanners II: The New Order,1991,"1,000+",2299,26,123,51,2.5,17.0,,3,0,3,3,,
2251,tt0080771,Galaxina,1980,500+,796,29,104,51,2.2,22.0,,6,1,5,6,3.60,17.0
2252,tt0064115,Butch Cassidy and the Sundance Kid,1969,"50,000+",71375,13052,1105,3902,4.3,92.0,,58,52,6,58,8.20,90.0
2253,tt0852951,Dead On: The Life and Cinema of George A. Romero,2008,0,0,0,0,0,,,,0,0,0,0,,
2254,tt0060550,"It's the Great Pumpkin, Charlie Brown",1966,"1,000+",1761,1494,267,894,4.1,85.0,,21,20,1,21,7.30,95.0
2255,tt1196140,Daybreak,2008,Fewer than 50,1,0,1,1,,,,0,0,0,0,,
2256,tt2294729,Mansome,2012,"1,000+",2036,158,533,108,2.7,23.0,,36,9,27,36,4.90,25.0
2257,tt0055894,The Day of the Triffids,1963,"5,000+",6070,237,226,210,3.2,51.0,,23,18,5,23,6.30,78.0
2258,tt0097443,The Gods Must Be Crazy II,1989,"10,000+",12119,844,366,379,3.7,70.0,,14,7,7,14,5.80,50.0
2259,tt0236590,Perdóname todo,1995,0,0,0,0,0,,,,0,0,0,0,,
2260,tt0250266,BookWars,2000,Fewer than 50,40,3,2,4,3.3,60.0,,5,4,1,5,6.90,80.0
2261,tt1024744,I Come with the Rain,2009,"1,000+",1122,80,184,83,2.6,30.0,,3,2,1,3,,
2262,tt1243930,Dachimawa Lee,2008,50+,76,7,15,9,2.8,32.0,,0,0,0,0,,
2263,tt0097366,Fletch Lives,1989,"10,000+",17456,851,707,416,3.4,55.0,,30,11,19,30,4.60,37.0
2264,tt0313285,Black Cadillac,2003,"2,500+",2517,86,108,77,3.1,44.0,,3,2,1,3,,
2265,tt0859636,The Taste of Tea,2006,0,0,0,0,0,,,,0,0,0,0,,
2266,tt0092916,Dot Goes to Hollywood,1987,50+,89,0,1,1,,,,0,0,0,0,,
2267,tt0069847,Carry on Abroad,1972,"2,500+",3020,206,60,103,3.9,77.0,,0,0,0,0,,
2268,tt0080928,Inside Moves,1980,250+,294,60,18,35,3.9,77.0,,5,3,2,5,5.40,60.0
2269,tt0063663,The Swimmer,1968,"2,500+",3154,542,115,206,4,83.0,,27,27,0,27,7.80,100.0
2270,tt0367908,Jesus Freak,2003,0,0,0,0,0,,,,0,0,0,0,,
2271,tt10332462,Naughty Professor,2012,0,0,0,0,0,,,,0,0,0,0,,
2272,tt0091344,King Kong Lives,1986,"10,000+",11990,106,542,227,2.1,16.0,,13,1,12,13,2.60,8.0
2273,tt0056335,The Password Is Courage,1962,250+,437,20,13,19,3.5,61.0,,1,1,0,1,,
2274,tt1286124,iCarly: iGo to Japan,2008,"1,000+",1799,430,119,101,4.1,79.0,,2,2,0,2,,
2275,tt1183907,Murari,2001,0,0,0,0,0,,,,0,0,0,0,,
2276,tt0068245,Bad Company,1972,"1,000+",2306,140,57,62,3.6,71.0,,23,19,4,23,7.50,83.0
2277,tt0088031,Saaransh,1984,50+,76,8,4,5,3.6,67.0,,1,1,0,1,,
2278,tt0056897,Call Me Bwana,1963,50+,60,8,8,6,3.3,50.0,,1,1,0,1,,
2279,tt0110040,Hollywood Dreams,1994,0,0,0,0,0,,,,0,0,0,0,,
2280,tt0104670,Ladybugs,1992,"10,000+",18582,442,597,411,3.1,43.0,,19,3,16,19,3.80,16.0
2281,tt0210299,Songcatcher,2000,"1,000+",2474,233,68,147,3.8,77.0,,89,66,23,89,6.30,74.0
2282,tt0886539,Luck by Chance,2009,"5,000+",7186,385,191,257,3.6,67.0,,18,15,3,18,6.80,83.0
2283,tt0362798,Kasam Paida Karne Wale Ki,1984,50+,68,1,1,0,,,,0,0,0,0,,
2284,tt0099204,Cadillac Man,1990,"5,000+",9414,253,539,173,2.8,32.0,,12,7,5,12,5.40,58.0
2285,tt0361089,Valiant,2005,"25,000+",37316,713,1735,728,2.7,29.0,,114,36,78,114,5.00,32.0
2286,tt0155064,Pudhu Pudhu Arthangal,1989,0,0,0,0,0,,,,0,0,0,0,,
2287,tt6829596,Endrendrum Kadhal,1999,0,0,0,0,0,,,,0,0,0,0,,
2288,tt0281364,Wasabi,2001,"10,000+",12639,1634,721,609,3.7,69.0,,42,18,24,42,5.10,43.0
2289,tt0211014,Sydney: A Story of a City,1999,0,0,0,0,0,,,,0,0,0,0,,
2290,tt0255466,Pathram,1999,0,0,0,0,0,,,,0,0,0,0,,
2291,tt0103253,Whore,1991,500+,894,51,94,35,2.8,35.0,,13,5,8,13,4.90,38.0
2292,tt1307963,Let's Make Money,2008,250+,336,76,40,40,3.6,66.0,,1,1,0,1,,
2293,tt0108255,Super Mario Bros.,1993,"100,000+",173617,2108,5080,5922,2.5,29.0,,42,12,30,42,4.10,29.0
2294,tt0952682,Shotgun Stories,2007,"2,500+",4806,1233,304,445,3.8,80.0,,51,45,6,51,7.30,88.0
2295,tt0060420,"Follow Me, Boys!",1966,"1,000+",2092,146,43,76,3.9,77.0,,1,1,0,1,,
2296,tt0217660,Mohabbat,1997,100+,108,4,5,1,3.1,44.0,,0,0,0,0,,
2297,tt0844993,Hoodwinked Too! Hood vs. Evil,2011,"25,000+",35891,1163,2196,617,2.8,35.0,,64,7,57,64,3.50,11.0
2298,tt0244970,Someone Like You...,2001,"25,000+",41543,1835,1419,1098,3.4,56.0,,120,50,70,120,5.00,42.0
2299,tt0059362,The Knack ...and How to Get It,1965,"1,000+",1192,154,70,108,3.6,69.0,,18,13,5,18,6.90,72.0
2300,tt0102715,Prisoner of Honor,1991,50+,94,6,1,3,3.6,86.0,,1,0,1,1,,
2301,tt0096259,Things Change,1988,500+,739,103,26,28,3.8,80.0,,13,11,2,13,7.00,85.0
2302,tt0057076,From Russia with Love,1963,"50,000+",93866,11680,2282,3276,4,84.0,,62,60,2,62,8.00,97.0
2303,tt0308878,The Shape of Things,2003,"5,000+",7939,917,500,534,3.5,65.0,,137,88,49,137,6.30,64.0
2304,tt0100663,Sorority House Massacre II,1990,"1,000+",1465,49,91,55,2.8,34.0,,3,2,1,3,,
2305,tt0429739,Care Bears: Journey to Joke-a-Lot,2004,Fewer than 50,33,5,5,4,3.1,50.0,,2,1,1,2,,
2306,tt0451998,Absolute Zero,2006,0,0,0,0,0,,,,0,0,0,0,,
2307,tt1874708,Seedan,2011,Fewer than 50,32,1,4,2,2.6,20.0,,0,0,0,0,,
2308,tt0055928,Dr. No,1962,"100,000+",111979,12387,2714,3608,3.9,82.0,,61,58,3,61,7.80,95.0
2309,tt0092934,Duet for One,1986,500+,708,45,6,25,4.3,88.0,,5,4,1,5,6.10,80.0
2310,tt1890513,Ragini MMS,2011,50+,68,8,29,9,2.5,22.0,,1,0,1,1,,
2311,tt0408470,69,2004,50+,80,10,9,4,3.5,53.0,,1,1,0,1,,
2312,tt0098557,Under the Boardwalk,1988,50+,97,8,7,4,3.5,53.0,,0,0,0,0,,
2313,tt0165409,October 22,1998,Fewer than 50,38,0,4,0,,,,0,0,0,0,,
2314,tt0118039,An Unfinished Affair,1996,100+,149,6,15,4,2.7,29.0,,0,0,0,0,,
2315,tt0102067,Howling VI: The Freaks,1991,500+,922,30,140,58,2.3,18.0,,2,0,2,2,,
2316,tt0089217,"Goodbye, New York",1985,Fewer than 50,8,1,1,0,,,,0,0,0,0,,
2317,tt0246801,Naiyya,1979,0,0,0,0,0,,,,0,0,0,0,,
2318,tt1530509,The Human Centipede II (Full Sequence),2011,"10,000+",11252,930,3184,1141,2.1,23.0,,83,24,59,83,3.70,29.0
2319,tt0117865,Taxandria,1994,100+,111,8,9,3,3.2,47.0,,0,0,0,0,,
2320,tt0089360,Jagged Edge,1985,"5,000+",5559,428,299,161,3.4,59.0,,31,25,6,31,6.70,81.0
2321,tt0117958,Trees Lounge,1996,"5,000+",6649,903,247,307,3.8,78.0,,26,21,5,26,6.90,81.0
2322,tt0056052,Half Ticket,1962,50+,81,13,1,2,4.2,93.0,,0,0,0,0,,
2323,tt0815245,The Uninvited,2009,0,0,0,0,0,,,,0,0,0,0,,
2324,tt0331216,Chor Machaaye Shor,2002,50+,94,3,6,1,2.4,33.0,,0,0,0,0,,
2325,tt0815245,The Uninvited,2009,0,0,0,0,0,,,,0,0,0,0,,
2326,tt0368891,National Treasure,2004,"250,000+",924570,44793,14120,30340,3.8,76.0,,179,83,96,179,5.30,46.0
2327,tt1480656,Cosmopolis,2012,"25,000+",37774,2235,4995,1320,2.5,31.0,,189,126,63,189,6.10,67.0
2328,tt0054343,The Story of Ruth,1960,250+,372,42,17,20,3.8,71.0,,1,0,1,1,,
2329,tt0375571,Aayitha Ezhuthu,2004,250+,265,42,6,7,4.3,88.0,,0,0,0,0,,
2330,tt0139398,Kaajal,1965,0,0,0,0,0,,,,0,0,0,0,,
2331,tt0165866,Lucinda's Spell,1998,0,0,0,0,1,,,,4,1,3,4,,
2332,tt1056441,Tru Loved,2008,250+,411,21,33,19,3.1,39.0,,18,7,11,18,4.70,39.0
2333,tt0102025,Hello Hemingway,1990,Fewer than 50,8,2,1,2,,,,2,2,0,2,,
2334,tt1275786,Rise of the Gargoyles,2009,100+,220,15,52,26,2.5,22.0,,1,0,1,1,,
2335,tt0084865,Victor/Victoria,1982,"10,000+",16541,1850,312,699,4.1,86.0,,36,35,1,36,8.10,97.0
2336,tt0102200,Khel,1992,250+,430,9,15,3,3,38.0,,0,0,0,0,,
2337,tt0101649,Thalapathi,1991,250+,288,58,9,9,4.3,87.0,,0,0,0,0,,
2338,tt0088899,Challenge of a Lifetime,1985,Fewer than 50,41,2,0,1,,,,0,0,0,0,,
2339,tt0083248,Umrao Jaan,1981,500+,775,94,12,31,4.4,89.0,,1,1,0,1,,
2340,tt0072267,The Terminal Man,1974,250+,370,23,33,17,3,41.0,,15,8,7,15,5.10,53.0
2341,tt0319841,Megasandesam,2001,0,0,0,0,0,,,,0,0,0,0,,
2342,tt0154145,Ninaithale Inikkum,1979,50+,63,5,2,1,3.9,71.0,,0,0,0,0,,
2343,tt0100395,Postcards from the Edge,1990,"5,000+",8829,834,427,299,3.6,66.0,,36,30,6,36,7.10,83.0
2344,tt1987021,Venghai,2011,Fewer than 50,28,4,6,2,3,40.0,,0,0,0,0,,
2345,tt1082886,The Wackness,2008,"25,000+",25353,3984,1548,2421,3.7,72.0,,136,96,40,136,6.30,71.0
2346,tt1459027,Bhramaram,2009,Fewer than 50,28,4,0,2,,,,0,0,0,0,,
2347,tt0060272,Cyborg 2087,1966,100+,180,3,3,2,2.8,50.0,,0,0,0,0,,
2348,tt0491661,Locusts: The 8th Plague,2005,50+,76,4,24,5,2.2,14.0,,0,0,0,0,,
2349,tt2075108,Baishe Srabon,2011,Fewer than 50,13,9,2,1,4,82.0,,0,0,0,0,,
2350,tt13491066,ABCD,2005,0,0,0,0,0,,,,0,0,0,0,,
2351,tt0174480,Autumn in New York,2000,"25,000+",33551,1619,1409,767,3.3,53.0,,71,14,57,71,4.30,20.0
2352,tt1602476,Badmaa$h Company,2010,"1,000+",1121,156,170,105,3.2,48.0,,2,2,0,2,,
2353,tt1049405,The Other End of the Line,2007,"1,000+",2164,320,322,232,3.2,50.0,,20,7,13,20,4.90,35.0
2354,tt0061067,Tarzan and the Valley of Gold,1966,Fewer than 50,18,1,13,7,2.4,7.0,,0,0,0,0,,
2355,tt0379363,Malibu Spring Break,2003,50+,56,3,10,2,1.8,23.0,,1,0,1,1,,
2356,tt0492389,Furry Vengeance,2010,"50,000+",89933,1363,2926,1247,2.6,32.0,,98,8,90,98,2.80,8.0
2357,tt0154178,Aaina,1977,0,0,0,0,0,,,,0,0,0,0,,
2358,tt1285241,Don 2,2011,"2,500+",4580,1091,429,326,3.8,72.0,,16,10,6,16,6.50,63.0
2359,tt0120812,Rush Hour,1998,"250,000+",902837,34504,9463,19545,3.9,78.0,,77,48,29,77,6.20,62.0
2360,tt0054271,Scent of Mystery,1960,Fewer than 50,17,1,4,3,2.7,20.0,,5,4,1,5,5.80,80.0
2361,tt0216930,My 5 Wives,2000,500+,808,44,54,43,3,45.0,,5,0,5,5,3.60,0.0
2362,tt0093776,Prick Up Your Ears,1987,"2,500+",4427,400,108,146,3.9,79.0,,38,36,2,38,7.70,95.0
2363,tt0120613,A Walk on the Moon,1999,"10,000+",10028,655,263,281,3.7,71.0,,37,27,10,37,6.90,73.0
2364,tt1549589,Elles,2011,"2,500+",3606,115,309,65,2.6,27.0,,63,14,49,63,4.80,22.0
2365,tt0054047,The Magnificent Seven,1960,"50,000+",54137,6179,890,2276,4.1,87.0,,46,41,5,46,8.00,89.0
2366,tt0064188,Crescendo,1970,100+,115,6,24,10,2.7,20.0,,1,1,0,1,,
2367,tt1148165,Bran Nue Dae,2009,"2,500+",4621,177,158,142,3.3,53.0,,63,36,27,63,6.00,57.0
2368,tt0055370,Return to Peyton Place,1961,500+,876,10,21,17,2.9,32.0,,1,0,1,1,,
2369,tt0291082,Cinderella II: Dreams Come True,2001,"50,000+",57523,579,1207,950,2.7,32.0,,9,1,8,9,3.70,11.0
2370,tt1093354,Big Dreamers,2007,Fewer than 50,37,1,0,0,,,,1,1,0,1,,
2371,tt0225481,The Dead Hate the Living!,2000,"2,500+",2926,38,115,84,2.4,25.0,,1,0,1,1,,
2372,tt0077234,The Big Sleep,1978,"1,000+",1478,40,107,59,2.8,27.0,,7,4,3,7,7.00,57.0
2373,tt0110186,Jason's Lyric,1994,"5,000+",9156,980,104,381,4.4,90.0,,24,14,10,24,5.80,58.0
2374,tt0098412,Sundown: The Vampire in Retreat,1989,"1,000+",1097,78,69,72,3.4,53.0,,2,2,0,2,,
2375,tt0089646,Muthal Mariyathai,1985,0,0,0,0,0,,,,0,0,0,0,,
2376,tt0053593,The Amazing Transparent Man,1960,100+,182,13,67,35,2.3,16.0,,6,2,4,6,4.80,33.0
2377,tt0104365,Grave Secrets: The Legacy of Hilltop Drive,1992,500+,661,11,9,4,3.4,55.0,,0,0,0,0,,
2378,tt0969647,The Little Mermaid: Ariel's Beginning,2008,"5,000+",6959,746,567,437,3.5,57.0,,6,2,4,6,5.40,33.0
2379,tt0060457,The Ghost in the Invisible Bikini,1966,100+,125,14,15,12,3.2,48.0,,1,0,1,1,,
2380,tt0100816,Tridev,1989,50+,79,9,8,1,3.4,53.0,,0,0,0,0,,
2381,tt0265713,"Scotland, PA",2001,"5,000+",5754,557,197,327,3.7,74.0,,74,44,30,74,6.00,59.0
2382,tt1083844,April Fools,2007,250+,403,5,38,20,1.8,12.0,,0,0,0,0,,
2383,tt0155953,Pelli Pustakam,1991,0,0,0,0,0,,,,0,0,0,0,,
2384,tt0080707,The Exterminator,1980,"1,000+",2115,114,177,124,3,39.0,,13,5,8,13,4.00,38.0
2385,tt0494224,End of the Line,2007,"1,000+",1512,157,165,175,3.1,49.0,,3,3,0,3,,
2386,tt1234548,The Men Who Stare at Goats,2009,"100,000+",239172,10533,16234,8694,3,39.0,,218,111,107,218,5.80,51.0
2387,tt0055304,Pit and the Pendulum,1961,"5,000+",8711,855,291,365,3.8,75.0,,25,22,3,25,6.90,88.0
2388,tt1055367,Shark City,2009,100+,165,4,8,6,2.8,33.0,,0,0,0,0,,
2389,tt0096094,She's Having a Baby,1988,"10,000+",12102,561,528,357,3.4,52.0,,45,20,25,45,5.50,44.0
2390,tt0409345,Surveillance,2008,"25,000+",31913,1081,1420,1165,3,43.0,,74,41,33,74,5.20,55.0
2391,tt0080809,Gorp,1980,100+,246,8,28,19,2.4,23.0,,3,0,3,3,,
2392,tt0468988,Category 7: The End of the World,2005,"1,000+",1532,89,83,78,3.2,52.0,,1,0,1,1,,
2393,tt2326059,Ullathai Allitha,1996,Fewer than 50,19,2,1,0,,,,0,0,0,0,,
2394,tt1549585,"Kadha, Samvidhanam Kunchakko",2009,0,0,0,0,0,,,,0,0,0,0,,
2395,tt1105729,The Good Witch,2008,500+,815,151,81,58,3.8,65.0,,1,1,0,1,,
2396,tt0105165,Prelude to a Kiss,1992,"10,000+",10775,239,375,163,3,39.0,,27,17,10,27,5.80,63.0
2397,tt0074814,The Loneliest Runner,1976,50+,82,3,1,1,,,,0,0,0,0,,
2398,tt0297076,Death Train,2003,100+,206,5,13,5,2.6,28.0,,0,0,0,0,,
2399,tt0433771,"Aloha, Scooby-Doo!",2005,"10,000+",11743,169,102,113,3.6,62.0,,0,0,0,0,,
2400,tt0257374,Agni Parvatham,1985,0,0,0,0,0,,,,0,0,0,0,,
2401,tt0779982,Black Sheep,2006,Fewer than 50,43,8,5,2,3.2,62.0,,0,0,0,0,,
2402,tt0332712,My Baby's Daddy,2004,"10,000+",10103,284,288,203,3.2,50.0,,52,3,49,52,2.90,6.0
2403,tt0080488,Café Express,1980,50+,60,9,0,0,3.9,100.0,,0,0,0,0,,
2404,tt0430326,Maampazhakkaalam,2004,0,0,0,0,0,,,,0,0,0,0,,
2405,tt1601188,DC Showcase: The Spectre,2010,100+,167,68,34,23,3.7,67.0,,0,0,0,0,,
2406,tt0266489,Duplex,2003,"50,000+",72117,2151,3230,1889,3,40.0,,111,39,72,111,5.00,35.0
2407,tt2179087,I Will Follow You Into the Dark,2012,100+,176,14,55,22,2.4,20.0,,10,2,8,10,3.10,20.0
2408,tt0062885,The Devil Rides Out,1968,"2,500+",3173,408,133,213,3.8,75.0,,23,22,1,23,7.40,96.0
2409,tt0073540,Picnic at Hanging Rock,1975,"10,000+",10529,2346,489,883,4,83.0,,47,43,4,47,8.50,91.0
2410,tt0134847,Pitch Black,2000,"250,000+",278922,20277,6146,9476,3.8,77.0,,113,67,46,113,5.70,59.0
2411,tt0371257,Stay,2005,"50,000+",73270,6026,2551,3550,3.7,70.0,,121,32,89,121,4.60,26.0
2412,tt0056907,The Cardinal,1963,500+,936,79,39,36,3.7,67.0,,15,7,8,15,5.90,47.0
2413,tt0318649,Sahara,2005,"100,000+",213696,5501,4792,5170,3.3,53.0,,177,67,110,177,5.10,38.0
2414,tt0086960,Beverly Hills Cop,1984,"250,000+",377982,10165,2267,6244,3.9,82.0,,52,43,9,52,7.20,83.0
2415,tt1135095,Tell-Tale,2009,"1,000+",1404,133,395,158,2.7,25.0,,2,2,0,2,,
2416,tt1144884,The Final Destination,2009,"250,000+",603967,8231,15128,11803,2.8,35.0,,99,27,72,99,4.10,27.0
2417,tt1171226,A Bunch of Amateurs,2008,250+,421,58,77,81,3,43.0,,2,0,2,2,,
2418,tt0128278,Instinct,1999,"25,000+",31150,1551,778,713,3.7,67.0,,65,17,48,65,4.20,26.0
2419,tt0406158,"The Prize Winner of Defiance, Ohio",2005,"10,000+",18556,853,295,483,3.8,74.0,,84,50,34,84,6.10,60.0
2420,tt0252227,Alvin and the Chipmunks Meet the Wolfman,2000,"1,000+",2491,205,84,101,3.9,71.0,,2,1,1,2,,
2421,tt0414503,Shaadi Ka Laddoo,2004,Fewer than 50,48,0,1,1,,,,0,0,0,0,,
2422,tt0322653,Mere Yaar Ki Shaadi Hai,2002,500+,901,76,46,29,3.5,62.0,,0,0,0,0,,
2423,tt0457513,Scoop,2006,"50,000+",70258,6159,4971,3721,3.3,55.0,,148,61,87,148,5.40,41.0
2424,tt1403177,Hesher,2010,"10,000+",19605,3506,2274,1096,3.5,61.0,,78,43,35,78,5.80,55.0
2425,tt1587427,The Cost of Love,2011,Fewer than 50,25,2,13,3,2.3,13.0,,0,0,0,0,,
2426,tt0093648,North Shore,1987,"2,500+",4369,369,75,185,4.2,83.0,,4,2,2,4,,
2427,tt0926084,Harry Potter and the Deathly Hallows - Part 1,2010,"250,000+",353192,89387,16237,19014,4.1,85.0,,288,222,66,288,7.10,77.0
2428,tt2294629,Frozen,2013,"250,000+",307782,96585,16650,11394,4.2,85.0,,251,225,26,251,7.70,90.0
2429,tt2380698,The Filmstaar,2011,0,0,0,0,0,,,,0,0,0,0,,
2430,tt1002569,If You Only Knew,2011,Fewer than 50,1,1,0,0,,,,0,0,0,0,,
2431,tt0180316,Women Talking Dirty,1999,250+,280,22,6,8,3.8,79.0,,2,2,0,2,,
2432,tt2146950,Anna Bond,2012,Fewer than 50,13,2,1,0,,,,0,0,0,0,,
2433,tt0232657,Sleepy Hollow High,2000,0,0,0,0,0,,,,0,0,0,0,,
2434,tt0089869,The Quiet Earth,1985,"5,000+",5847,814,368,439,3.6,69.0,,17,12,5,17,7.00,71.0
2435,tt0249185,Thinkalazhcha Nalla Divasam,1985,0,0,0,0,0,,,,0,0,0,0,,
2436,tt0102070,Hudson Hawk,1991,"25,000+",44336,2142,1690,1582,3.3,56.0,,45,14,31,45,4.60,31.0
2437,tt0059821,The Tomb of Ligeia,1964,"1,000+",1395,200,132,104,3.5,60.0,,14,12,2,14,6.40,86.0
2438,tt0075945,A Distant Thunder,1978,100+,105,13,7,3,3.6,65.0,,0,0,0,0,,
2439,tt1104083,Little Ashes,2008,"50,000+",79219,940,984,658,3.2,49.0,,70,17,53,70,4.20,24.0
2440,tt0417991,My First Romance,2003,100+,237,11,3,3,3.9,79.0,,0,0,0,0,,
2441,tt0465997,The Fox and the Hound 2,2006,"5,000+",9960,377,459,313,3.1,45.0,,10,2,8,10,4.60,20.0
2442,tt0207341,Biwi No. 1,1999,250+,285,24,30,3,3,44.0,,0,0,0,0,,
2443,tt0401420,Fierce People,2005,"5,000+",8823,640,473,357,3.4,57.0,,45,11,34,45,4.70,24.0
2444,tt0090866,Combat Shock,1984,"1,000+",1829,114,62,85,3.5,65.0,,5,2,3,5,5.10,40.0
2445,tt0951385,Tata Birla Madhyalo Laila,2006,0,0,0,0,0,,,,0,0,0,0,,
2446,tt0164003,City of Ghosts,2002,"2,500+",3402,145,173,99,3.2,46.0,,65,31,34,65,5.60,48.0
2447,tt0073657,Sanyasi,1975,0,0,0,0,0,,,,0,0,0,0,,
2448,tt0108049,Scattered Dreams,1993,50+,61,3,2,1,4.2,60.0,,0,0,0,0,,
2449,tt0118736,Six-String Samurai,1998,"5,000+",7532,1010,306,664,3.9,77.0,,21,12,9,21,6.00,57.0
2450,tt0280870,Liberty Stands Still,2002,"2,500+",3903,106,194,106,2.9,35.0,,5,1,4,5,4.30,20.0
2451,tt0093186,Hiding Out,1987,"2,500+",2972,174,76,89,3.8,70.0,,7,3,4,7,4.90,43.0
2452,tt0069841,Cannibal Girls,1973,100+,202,15,51,30,2.6,23.0,,3,1,2,3,,
2453,tt0938706,The Last Lullaby,2008,100+,221,55,25,26,3.7,69.0,,3,2,1,3,,
2454,tt0085780,The Keep,1983,"2,500+",3589,373,492,348,3,43.0,,17,7,10,17,4.10,41.0
2455,tt0076780,Summer City,1977,500+,584,6,24,10,2.4,20.0,,0,0,0,0,,
2456,tt0127745,The Puppetoon Movie,1987,"1,000+",1583,11,3,7,4.1,79.0,,5,4,1,5,5.80,80.0
2457,tt0054752,Claudelle Inglish,1961,Fewer than 50,2,1,1,0,,,,0,0,0,0,,
2458,tt0055597,Victim,1961,"1,000+",1368,304,44,106,4,87.0,,31,31,0,31,7.80,100.0
2459,tt0117060,Mission: Impossible,1996,"250,000+",868331,23049,9279,15898,3.6,71.0,,65,43,22,65,6.10,66.0
2460,tt0093476,Maid to Order,1987,"5,000+",6100,124,102,105,3.3,55.0,,12,5,7,12,4.60,42.0
2461,tt0156839,Every Mother's Worst Fear,1998,Fewer than 50,21,3,3,0,3.2,50.0,,0,0,0,0,,
2462,tt0981072,The Lucky Ones,2008,"10,000+",11802,718,617,478,3.3,54.0,,74,28,46,74,5.10,38.0
2463,tt1288403,Universal Soldier: Regeneration,2009,"2,500+",2837,466,913,554,2.8,34.0,,1,0,1,1,,
2464,tt1129410,The Immortal Voyage of Captain Drake,2009,100+,121,7,19,14,2.2,27.0,,0,0,0,0,,
2465,tt0318275,Adisaya Piravi,1990,100+,124,7,3,1,3.5,70.0,,0,0,0,0,,
2466,tt0119942,Primary Colors,1998,"10,000+",19994,1243,693,546,3.5,64.0,,79,63,16,79,7.20,80.0
2467,tt1821682,Traffic,2011,Fewer than 50,23,6,4,1,3.8,60.0,,2,1,1,2,,
2468,tt1848902,Game Change,2012,"1,000+",2343,1381,432,344,3.7,76.0,,42,28,14,42,7.10,67.0
2469,tt0125319,Kitchen Party,1997,100+,196,8,12,6,3.2,40.0,,4,3,1,4,,
2470,tt0092521,Agent trouble,1987,50+,68,0,4,0,,,,0,0,0,0,,
2471,tt0168629,Dancer in the Dark,2000,"50,000+",57872,12433,1226,4072,4.3,91.0,,122,85,37,122,6.80,70.0
2472,tt0101437,Beta,1992,100+,135,16,9,1,3.5,64.0,,0,0,0,0,,
2473,tt1144579,Ghost Voyage,2008,250+,349,16,47,30,2.2,26.0,,0,0,0,0,,
2474,tt0072886,Doc Savage: The Man of Bronze,1975,250+,438,50,37,37,3.4,57.0,,2,0,2,2,,
2475,tt0335438,Starsky & Hutch,2004,"250,000+",383926,6918,7237,7369,3.2,49.0,,194,122,72,194,5.90,63.0
2476,tt0860462,Mercury Man,2006,250+,413,8,33,24,2.4,20.0,,0,0,0,0,,
2477,tt0116138,Drawing Flies,1996,"1,000+",1868,69,118,80,2.9,37.0,,5,2,3,5,5.50,40.0
2478,tt0292066,Lan Yu,2001,"1,000+",2405,270,54,99,4,83.0,,38,26,12,38,6.30,68.0
2479,tt1305008,The Bill Collector,2010,Fewer than 50,19,1,7,2,1.6,12.0,,0,0,0,0,,
2480,tt0123385,Artemisia,1997,"1,000+",1272,93,52,52,3.5,64.0,,21,14,7,21,6.40,67.0
2481,tt0053933,I Passed for White,1960,Fewer than 50,36,1,5,2,2.8,17.0,,0,0,0,0,,
2482,tt0104745,The Living End,1992,"1,000+",2171,172,111,71,3.4,61.0,,11,8,3,11,6.80,73.0
2483,tt0237820,Thaniyavartanam,1987,Fewer than 50,1,1,0,0,,,,0,0,0,0,,
2484,tt1666186,Vampires Suck,2010,"50,000+",75196,3599,8617,4087,2.4,29.0,,91,4,87,91,2.50,4.0
2485,tt1092007,Heavy Metal in Baghdad,2007,500+,996,256,41,136,4,86.0,,24,20,4,24,6.40,83.0
2486,tt1904833,Akkarakazhchakal - The Movie,2011,100+,100,8,0,1,4.8,100.0,,0,0,0,0,,
2487,tt0437405,Paper Man,2009,"2,500+",3399,788,857,392,3.2,48.0,,31,10,21,31,4.70,32.0
2488,tt0942378,Johnny Kapahala: Back on Board,2007,"1,000+",2175,170,85,81,3.7,67.0,,2,1,1,2,,
2489,tt1869296,Bbuddah... Hoga Terra Baap,2011,100+,116,34,33,18,3.1,51.0,,1,0,1,1,,
2490,tt0118565,After the Game,1997,50+,52,0,2,2,,,,1,0,1,1,,
2491,tt0116000,D3: The Mighty Ducks,1996,"100,000+",175112,1802,2187,2392,3.2,45.0,,15,3,12,15,4.30,20.0
2492,tt0077405,Days of Heaven,1978,"10,000+",16413,4181,528,1307,4.2,89.0,,61,57,4,61,8.40,93.0
2493,tt1699114,All-Star Superman,2011,"1,000+",1904,804,502,357,3.5,62.0,,5,4,1,5,7.10,80.0
2494,tt0084582,Rehearsal for Murder,1982,50+,62,10,5,6,3.5,67.0,,0,0,0,0,,
2495,tt0110939,Radioland Murders,1994,"2,500+",2883,175,121,107,3.5,59.0,,17,4,13,17,4.20,24.0
2496,tt0800981,Anthony Kaun Hai?,2006,100+,197,3,12,2,2.5,20.0,,0,0,0,0,,
2497,tt1825784,3 Geezers!,2013,100+,211,16,55,16,2.1,23.0,,4,0,4,4,,
2498,tt0893585,Detective Naani,2009,Fewer than 50,21,0,1,1,,,,1,0,1,1,,
2499,tt0076095,The Goodbye Girl,1977,"5,000+",7526,969,178,426,4,85.0,,25,20,5,25,6.80,80.0
2500,tt0250716,The Search for John Gissing,2001,500+,934,109,26,60,4,81.0,,9,8,1,9,7.40,89.0
2501,tt0421121,Cerberus,2005,500+,579,17,63,43,2.3,21.0,,1,0,1,1,,
2502,tt0162830,Twin Falls Idaho,1999,"2,500+",3897,330,66,136,4,83.0,,46,36,10,46,7.30,78.0
2503,tt0099664,Girlfriend from Hell,1989,50+,51,13,11,4,3.1,54.0,,3,0,3,3,,
2504,tt0318357,Chandralekha,1995,Fewer than 50,38,1,0,0,,,,0,0,0,0,,
2505,tt0318357,Chandralekha,1995,Fewer than 50,38,1,0,0,,,,0,0,0,0,,
2506,tt0058921,Arzoo,1965,Fewer than 50,1,0,1,0,,,,0,0,0,0,,
2507,tt1051212,Blood on the Flat Track: The Rise of the Rat City Rollergirls,2007,Fewer than 50,42,5,3,2,3.6,62.0,,0,0,0,0,,
2508,tt0169629,Blue Valley Songbird,1999,500+,762,21,11,13,3.9,66.0,,0,0,0,0,,
2509,tt0319524,How to Deal,2003,"25,000+",48757,2023,1123,1270,3.6,64.0,,98,26,72,98,4.60,27.0
2510,tt0096734,The 'Burbs,1989,"50,000+",61080,5294,2146,2596,3.8,71.0,,40,22,18,40,6.00,55.0
2511,tt0056805,Aaj Aur Kal,1963,0,0,0,0,0,,,,0,0,0,0,,
2512,tt0420548,El perro,2004,"2,500+",3819,496,112,208,3.9,82.0,,13,11,2,13,6.20,85.0
2513,tt0995851,In Her Skin,2009,"1,000+",1158,163,204,105,3.1,44.0,,4,1,3,4,,
2514,tt0151243,Kongi's Harvest,1970,0,0,0,0,0,,,,0,0,0,0,,
2515,tt0067482,A New Leaf,1971,"1,000+",1037,246,51,84,4,83.0,,68,64,4,68,8.10,94.0
2516,tt0459748,Generation P,2011,250+,276,56,10,5,3.9,85.0,,12,9,3,12,6.60,75.0
2517,tt0062865,Day of the Evil Gun,1968,100+,220,9,12,11,3.1,43.0,,1,1,0,1,,
2518,tt0366304,Chokher Bali,2003,"1,000+",1374,78,34,40,3.8,70.0,,1,1,0,1,,
2519,tt1498878,The Whisperer in Darkness,2011,100+,235,96,52,31,3.6,65.0,,7,6,1,7,6.70,86.0
2520,tt0460746,Choose Your Own Adventure: The Abominable Snowman,2006,50+,52,3,2,2,3.6,60.0,,2,2,0,2,,
2521,tt1082599,Stag Night,2008,500+,511,41,240,124,2.2,15.0,,2,0,2,2,,
2522,tt0132477,October Sky,1999,"50,000+",66281,9171,1250,3005,4.1,88.0,,74,67,7,74,7.60,91.0
2523,tt0327597,Coraline,2009,"250,000+",385751,48311,17249,17787,3.8,74.0,,271,245,26,271,7.80,90.0
2524,tt0465502,Igor,2008,"50,000+",82541,1571,2610,1810,2.9,38.0,,93,37,56,93,4.90,40.0
2525,tt0055459,"So Evil, So Young",1961,Fewer than 50,2,0,1,2,,,,0,0,0,0,,
2526,tt0106471,Boxing Helena,1993,"5,000+",7741,315,584,372,2.7,35.0,,36,6,30,36,3.80,17.0
2527,tt0187200,Karnaval,1999,0,0,0,0,0,,,,0,0,0,0,,
2528,tt0080671,The Earthling,1980,250+,413,64,9,27,4.1,88.0,,1,0,1,1,,
2529,tt0437489,Stephen Tobolowsky's Birthday Party,2005,250+,386,59,6,28,4.1,91.0,,12,12,0,12,8.00,100.0
2530,tt0087287,Lady Libertine,1984,50+,83,2,5,3,2.6,29.0,,0,0,0,0,,
2531,tt0219405,Waydowntown,2000,"1,000+",1900,175,46,88,3.8,79.0,,33,23,10,33,6.40,70.0
2532,tt0097883,Millennium,1989,"5,000+",5697,103,238,119,2.7,30.0,,9,1,8,9,3.50,11.0
2533,tt0056218,The Manchurian Candidate,1962,"25,000+",31474,4191,461,1507,4.2,90.0,,64,62,2,64,8.80,97.0
2534,tt0265662,The Rookie,2002,"50,000+",61197,3320,1428,1373,3.7,70.0,,154,129,25,154,7.20,84.0
2535,tt0408976,Krishna Cottage,2004,100+,102,3,5,4,2.9,38.0,,0,0,0,0,,
2536,tt0117276,Overnight Delivery,1998,"5,000+",6019,363,337,210,3.3,52.0,,7,3,4,7,4.90,43.0
2537,tt0313496,La presidenta municipal,1975,0,0,0,0,0,,,,0,0,0,0,,
2538,tt0084434,An Officer and a Gentleman,1982,"50,000+",51215,4004,967,1669,4,81.0,,33,26,7,33,7.50,79.0
2539,tt0108505,Voyage,1993,Fewer than 50,40,1,10,1,2.7,9.0,,2,1,1,2,,
2540,tt0155846,Maha Chor,1976,0,0,0,0,0,,,,0,0,0,0,,
2541,tt0077944,Money Movers,1978,100+,117,10,8,8,3.4,56.0,,3,1,2,3,,
2542,tt0101984,Guilty by Suspicion,1991,"2,500+",3519,231,188,70,3.4,55.0,,19,13,6,19,6.10,68.0
2543,tt0156841,The Next Best Thing,2000,"10,000+",16429,319,581,331,2.7,35.0,,94,18,76,94,3.80,19.0
2544,tt0055776,Barravento,1962,100+,223,16,8,1,3.7,67.0,,2,2,0,2,,
2545,tt0074156,Assault on Precinct 13,1976,"10,000+",24783,2972,756,1122,3.9,80.0,,50,48,2,50,7.80,96.0
2546,tt0244528,Hadh Kar Di Aapne,2000,250+,347,11,20,5,2.9,35.0,,0,0,0,0,,
2547,tt0119441,Beyond Paradise,1998,100+,127,15,4,2,4.3,79.0,,1,0,1,1,,
2548,tt0099739,Hard to Kill,1990,"25,000+",44954,946,1077,889,3.2,47.0,,15,5,10,15,4.10,33.0
2549,tt0274309,24 Hour Party People,2002,"25,000+",35284,4782,705,1634,4.1,87.0,,99,86,13,99,7.30,87.0
2550,tt0143213,Devil in the Flesh,1998,"1,000+",2305,101,124,71,3.2,45.0,,3,0,3,3,,
2551,tt0112839,Decoy,1995,Fewer than 50,49,0,7,4,1.9,0.0,,1,0,1,1,,
2552,tt2186717,Akashathinte Niram,2012,0,0,0,0,0,,,,0,0,0,0,,
2553,tt0288476,Chile 672,2006,0,0,0,0,0,,,,0,0,0,0,,
2554,tt0099342,Daddy's Dyin'... Who's Got the Will?,1990,"1,000+",1603,34,17,20,3.6,67.0,,6,3,3,6,5.20,50.0
2555,tt0102592,One False Move,1991,"2,500+",4811,561,184,188,3.8,75.0,,57,53,4,57,8.50,93.0
2556,tt0455857,When a Stranger Calls,2006,"250,000+",477516,5898,7680,16840,2.9,44.0,,91,8,83,91,3.60,9.0
2557,tt0065051,Support Your Local Sheriff!,1969,"5,000+",6778,482,109,227,4,81.0,,17,13,4,17,6.50,76.0
2558,tt0385677,Ellis in Glamourland,2004,100+,149,7,8,4,2.9,47.0,,0,0,0,0,,
2559,tt1187046,Saving God,2008,250+,396,45,36,40,3.4,56.0,,0,0,0,0,,
2560,tt0067809,Support Your Local Gunfighter,1971,"2,500+",4572,136,87,78,3.6,61.0,,13,8,5,13,6.00,62.0
2561,tt0105606,To Grandmother's House We Go,1992,"2,500+",2684,212,144,87,3.6,59.0,,1,0,1,1,,
2562,tt0445620,Paradise Now,2005,"25,000+",27402,3229,485,1193,4.1,87.0,,104,93,11,104,7.50,89.0
2563,tt0107448,Love Bites,1993,100+,130,20,7,5,4,74.0,,0,0,0,0,,
2564,tt0287978,Daredevil,2003,"250,000+",468782,7762,14553,13793,2.8,35.0,,228,98,130,228,5.20,43.0
2565,tt2229996,Aanandham,2001,0,0,0,0,0,,,,0,0,0,0,,
2566,tt0331468,Cold Creek Manor,2003,"25,000+",30686,430,1477,648,2.5,23.0,,111,13,98,111,3.80,12.0
2567,tt0115820,The Canterville Ghost,1996,"2,500+",4186,104,78,89,3.4,57.0,,1,1,0,1,,
2568,tt1641831,Doomsday Prophecy,2011,50+,91,7,46,18,2,13.0,,0,0,0,0,,
2569,tt0120681,From Hell,2001,"100,000+",203373,11504,6048,6259,3.6,66.0,,152,86,66,152,5.70,57.0
2570,tt1606253,Itlu Sravani Subramanyam,2001,0,0,0,0,0,,,,0,0,0,0,,
2571,tt0478305,Triloquist,2008,250+,469,17,97,71,1.9,15.0,,1,0,1,1,,
2572,tt0138704,Pi,1998,"100,000+",108672,22542,4030,6612,4,85.0,,59,52,7,59,7.40,88.0
2573,tt0368896,Nijam,2003,0,0,0,0,0,,,,0,0,0,0,,
2574,tt1224153,Jerichow,2008,"10,000+",16222,101,73,43,3.4,58.0,,39,35,4,39,7.00,90.0
2575,tt0085970,Mr. Mom,1983,"25,000+",36824,1074,804,635,3.4,57.0,,25,19,6,25,6.10,76.0
2576,tt1433108,Faster,2010,"25,000+",46337,7222,6574,3105,3.4,52.0,,130,53,77,130,4.90,41.0
2577,tt1046930,Headless Horseman,2007,250+,443,19,74,42,2.3,20.0,,1,0,1,1,,
2578,tt0372884,Eating Out,2004,"5,000+",7709,600,428,338,3.5,58.0,,26,5,21,26,4.30,19.0
2579,tt0133046,Teaching Mrs. Tingle,1999,"25,000+",45107,574,1267,687,2.8,31.0,,69,13,56,69,4.00,19.0
2580,tt0074226,Blue Sunshine,1977,"1,000+",1943,85,106,102,3.1,45.0,,7,6,1,7,5.80,86.0
2581,tt0397312,Anonymous Rex,2004,100+,122,15,14,13,2.9,52.0,,1,0,1,1,,
2582,tt0075836,The Chicken Chronicles,1977,100+,185,12,10,5,3.3,55.0,,0,0,0,0,,
2583,tt0113947,Nelly & Monsieur Arnaud,1995,Fewer than 50,1,1,0,0,,,,0,0,0,0,,
2584,tt0070735,The Sting,1973,"50,000+",61952,12218,652,3591,4.4,95.0,,108,100,8,108,8.30,93.0
2585,tt0071819,La Mary,1974,0,0,0,0,0,,,,0,0,0,0,,
2586,tt1288636,Cell 213,2011,50+,66,4,13,4,2.1,24.0,,6,1,5,6,4.40,17.0
2587,tt0231246,Belli Moda,1967,0,0,0,0,0,,,,0,0,0,0,,
2588,tt0361748,Inglourious Basterds,2009,"250,000+",777569,98333,13693,36687,4.2,88.0,,335,298,37,335,7.80,89.0
2589,tt0097733,Lethal Weapon 2,1989,"250,000+",251119,9061,2640,3689,3.8,77.0,,44,36,8,44,6.90,82.0
2590,tt0070124,Gordon's War,1973,50+,81,9,10,11,3.3,47.0,,5,3,2,5,5.00,60.0
2591,tt0816683,Troubled Waters,2006,500+,600,19,29,22,3.1,40.0,,0,0,0,0,,
2592,tt0297162,Half Past Dead,2002,"10,000+",18504,447,748,384,2.8,37.0,,88,3,85,88,3.10,3.0
2593,tt0060074,Agent for H.A.R.M.,1966,50+,74,0,23,7,1.5,0.0,,0,0,0,0,,
2594,tt0064110,The Bridge at Remagen,1969,"2,500+",3130,155,113,80,3.5,58.0,,5,1,4,5,5.60,20.0
2595,tt0061810,In Like Flint,1967,"2,500+",2976,165,156,121,3.3,51.0,,19,13,6,19,6.10,68.0
2596,tt0126029,Shrek,2001,"250,000+",1378744,90504,10347,84689,3.9,90.0,,211,185,26,211,7.80,88.0
2597,tt0250638,PTU,2003,"2,500+",4313,549,141,176,3.8,80.0,,16,10,6,16,5.90,63.0
2598,tt1318522,Before You Say 'I Do',2009,250+,292,53,53,19,3.4,50.0,,0,0,0,0,,
2599,tt1193138,Up in the Air,2009,"100,000+",228692,37267,9750,14118,3.8,79.0,,288,260,28,288,8.10,90.0
2600,tt0386650,Mounam Pesiyadhe,2002,0,0,0,0,0,,,,0,0,0,0,,
2601,tt0386693,Say It in Russian,2007,50+,58,12,1,6,4.7,92.0,,0,0,0,0,,
2602,tt0116414,Girl 6,1996,"5,000+",5732,192,342,135,2.9,36.0,,36,14,22,36,4.80,39.0
2603,tt0082340,Escape from New York,1981,"50,000+",73049,8667,2648,3463,3.8,77.0,,72,63,9,72,7.30,88.0
2604,tt1341341,Ceremony,2010,"1,000+",2436,151,330,93,2.8,31.0,,38,15,23,38,4.90,39.0
2605,tt0299905,The Frightening,2002,250+,407,5,32,18,2,14.0,,0,0,0,0,,
2606,tt0087363,Gremlins,1984,"250,000+",452389,17910,5082,12677,3.9,78.0,,80,69,11,80,7.50,86.0
2607,tt0361818,Kushi,2000,0,0,0,0,0,,,,0,0,0,0,,
2608,tt1858396,Arai Enn 305-il Kadavul,2008,0,0,0,0,0,,,,0,0,0,0,,
2609,tt0089789,The Peanut Butter Solution,1985,"2,500+",4958,204,153,221,3.5,57.0,,2,2,0,2,,
2610,tt0245865,Devanthakudu,1984,0,0,0,0,0,,,,0,0,0,0,,
2611,tt0098362,Sons of Steel,1988,Fewer than 50,2,1,1,1,,,,0,0,0,0,,
2612,tt0116762,Keys to Tulsa,1997,500+,568,10,33,12,2.7,23.0,,10,1,9,10,4.10,10.0
2613,tt0104854,Mere Sajana Saath Nibhana,1992,Fewer than 50,1,1,0,0,,,,0,0,0,0,,
2614,tt0963807,I.O.U.S.A.,2008,"1,000+",1811,372,61,208,4,86.0,,65,57,8,65,7.20,88.0
2615,tt0100161,Mister Frost,1990,"1,000+",1073,59,35,39,3.6,63.0,,9,3,6,9,5.00,33.0
2616,tt0062384,Torture Garden,1967,"1,000+",1207,52,64,47,3.2,45.0,,2,1,1,2,,
2617,tt1027658,Absurdistan,2008,500+,583,146,50,81,3.7,74.0,,23,19,4,23,6.60,83.0
2618,tt0054469,Where the Boys Are,1960,"1,000+",2105,151,64,84,3.8,70.0,,8,7,1,8,5.90,88.0
2619,tt0246875,Purely Belter,2000,"1,000+",1481,147,42,83,4,78.0,,4,3,1,4,,
2620,tt0289685,Daava,1997,Fewer than 50,45,1,2,0,,,,0,0,0,0,,
2621,tt0125837,Little Girl... Big Tease,1976,0,0,0,0,0,,,,0,0,0,0,,
2622,tt0187178,Jagadeka Veerudu Athiloka Sundari,1990,Fewer than 50,1,1,0,0,,,,0,0,0,0,,
2623,tt0109809,FleshEater,1988,"1,000+",1067,36,94,79,2.5,28.0,,1,1,0,1,,
2624,tt0233277,Back to the Secret Garden,2000,"5,000+",6441,52,82,68,3,38.0,,3,1,2,3,,
2625,tt0424320,Ober da bakod: The Movie,1994,0,0,0,0,0,,,,0,0,0,0,,
2626,tt0100029,Lionheart,1990,"10,000+",15464,919,834,439,3.3,52.0,,18,7,11,18,4.40,39.0
2627,tt0901686,Mater and the Ghostlight,2006,"5,000+",6744,220,130,101,3.6,63.0,,0,0,0,0,,
2628,tt0103596,3 Ninjas,1992,"100,000+",202542,1735,1549,3000,3.4,53.0,,22,7,15,22,4.40,32.0
2629,tt1673430,Superman/Batman: Apocalypse,2010,"2,500+",3168,1067,612,438,3.6,64.0,,5,1,4,5,6.10,20.0
2630,tt0411131,Autograph,2004,100+,110,12,1,4,4,92.0,,0,0,0,0,,
2631,tt0313250,Baltic Storm,2003,50+,88,3,14,6,2.5,18.0,,1,0,1,1,,
2632,tt0289229,Hukkle,2002,"1,000+",1390,252,52,90,4,83.0,,33,33,0,33,7.70,100.0
2633,tt0057986,The Curse of the Mummy's Tomb,1964,500+,613,30,80,51,2.9,28.0,,2,0,2,2,,
2634,tt0390197,Young Alexander the Great,2010,Fewer than 50,3,2,1,1,,,,0,0,0,0,,
2635,tt0098554,Uncle Buck,1989,"100,000+",200171,7265,2217,4815,3.9,77.0,,26,16,10,26,5.90,62.0
2636,tt1159914,Baksha Rahasya,1996,0,0,0,0,0,,,,0,0,0,0,,
2637,tt1241250,Small Voices: The Stories of Cambodia's Children,2008,Fewer than 50,16,5,0,1,4.6,100.0,,0,0,0,0,,
2638,tt0104427,Hoffa,1992,"5,000+",9683,899,639,337,3.4,58.0,,25,13,12,25,5.40,52.0
2639,tt0077699,House Calls,1978,"1,000+",1284,27,29,17,3.3,48.0,,9,3,6,9,5.10,33.0
2640,tt0330152,The Christmas Shoes,2002,"2,500+",2949,462,88,250,4.2,84.0,,1,0,1,1,,
2641,tt0083946,Fitzcarraldo,1982,"10,000+",12859,2837,239,852,4.3,92.0,,32,24,8,32,7.50,75.0
2642,tt0107427,Little Miss Millions,1993,"1,000+",1715,11,13,7,3.3,46.0,,0,0,0,0,,
2643,tt1949548,Heroine,2012,"1,000+",1956,74,177,59,2.7,29.0,,6,3,3,6,4.60,50.0
2644,tt0463948,Disaster Zone: Volcano in New York,2006,250+,343,6,49,22,1.9,11.0,,1,0,1,1,,
2645,tt1603362,Prasthanam,2010,50+,53,24,2,5,4.4,92.0,,0,0,0,0,,
2646,tt0120467,Vulgar,2000,"5,000+",5031,258,365,308,2.9,41.0,,26,6,20,26,4.00,23.0
2647,tt0110428,The Madness of King George,1994,"5,000+",8409,993,246,347,3.9,80.0,,47,44,3,47,7.80,94.0
2648,tt0471037,Still Green,2007,"10,000+",11324,10,18,13,2.7,36.0,,0,0,0,0,,
2649,tt0443632,The Sentinel,2006,"50,000+",84713,2799,4104,2730,3.1,41.0,,132,46,86,132,5.10,35.0
2650,tt0063612,Skidoo,1968,250+,443,40,62,52,2.8,39.0,,12,5,7,12,4.90,42.0
2651,tt0280353,Big Mama,2000,0,0,0,0,0,,,,0,0,0,0,,
2652,tt0103268,The Willies,1990,250+,333,25,59,37,2.9,30.0,,0,0,0,0,,
2653,tt0071200,The Beast Must Die,1974,500+,849,77,132,104,3,37.0,,7,3,4,7,5.30,43.0
2654,tt0108551,What's Love Got to Do with It,1993,"50,000+",52342,3157,441,1495,4.3,88.0,,59,57,2,59,7.50,97.0
2655,tt1174730,City Island,2009,"25,000+",29965,3297,853,1122,3.8,79.0,,105,87,18,105,6.80,83.0
2656,tt0944101,Good Dick,2008,"5,000+",5732,638,605,423,3.2,51.0,,42,21,21,42,5.20,50.0
2657,tt0313844,16 December,2002,100+,100,7,7,1,3.2,50.0,,0,0,0,0,,
2658,tt0073601,Rafferty and the Gold Dust Twins,1975,50+,57,7,9,5,3.3,44.0,,7,5,2,7,5.80,71.0
2659,tt0345594,Love at Times Square,2003,0,0,0,0,0,,,,4,1,3,4,,
2660,tt0388183,King's Ransom,2005,"5,000+",6275,127,270,112,2.6,32.0,,49,1,48,49,2.60,2.0
2661,tt0171135,Brown's Requiem,1998,500+,501,13,26,12,2.8,33.0,,6,3,3,6,6.10,50.0
2662,tt0090252,Verführung: Die grausame Frau,1985,0,0,0,0,0,,,,0,0,0,0,,
2663,tt0259442,The Monkey's Mask,2000,500+,978,9,52,22,2.3,15.0,,31,13,18,31,5.20,42.0
2664,tt0079640,North Dallas Forty,1979,"2,500+",2540,224,91,87,3.6,71.0,,26,22,4,26,7.00,85.0
2665,tt0481509,Displaced,2006,Fewer than 50,12,0,2,1,,,,0,0,0,0,,
2666,tt1691012,The Dog Who Saved Christmas Vacation,2010,Fewer than 50,46,6,19,3,2.6,24.0,,0,0,0,0,,
2667,tt1350917,Crazy Girls Undercover,2008,50+,83,3,10,3,2,23.0,,0,0,0,0,,
2668,tt0056904,Captain Sindbad,1963,100+,185,6,13,6,2.8,32.0,,0,0,0,0,,
2669,tt0928152,Malliswari,2004,0,0,0,0,0,,,,0,0,0,0,,
2670,tt0089003,Death Wish 3,1985,"5,000+",8797,681,583,519,3.4,54.0,,19,3,16,19,3.40,16.0
2671,tt0284123,Follow the Stars Home,2001,"1,000+",1208,106,28,66,4.1,80.0,,0,0,0,0,,
2672,tt1548542,Bornova Bornova,2009,100+,109,18,17,4,3.2,51.0,,0,0,0,0,,
2673,tt0442933,Beowulf,2007,"250,000+",339269,28218,28137,29796,3.2,50.0,,194,138,56,194,6.50,71.0
2674,tt1095180,Forgotten Pills,2010,0,0,0,0,0,,,,0,0,0,0,,
2675,tt0109456,Color of Night,1994,"10,000+",17104,433,1011,410,2.7,30.0,,51,11,40,51,4.40,22.0
2676,tt0112604,Butterfly Kiss,1995,"1,000+",1716,91,61,30,3.5,60.0,,14,11,3,14,6.30,79.0
2677,tt0104036,The Crying Game,1992,"25,000+",31941,4032,1116,1288,3.8,78.0,,72,68,4,72,8.30,94.0
2678,tt0432006,Puppy,2005,100+,134,19,8,14,3.7,70.0,,3,2,1,3,,
2679,tt0106536,The Cemetery Club,1993,"1,000+",1196,12,27,13,2.8,31.0,,7,4,3,7,6.40,57.0
2680,tt0061770,Hombre,1967,"2,500+",3986,498,124,168,3.9,80.0,,15,14,1,15,8.10,93.0
2681,tt0079366,The Jericho Mile,1979,100+,206,39,11,11,3.8,78.0,,2,2,0,2,,
2682,tt1145144,Center Stage: Turn It Up,2008,"10,000+",10835,522,382,318,3.5,58.0,,5,3,2,5,4.90,60.0
2683,tt1375670,Grown Ups,2010,"250,000+",271431,60219,36574,9655,3.6,62.0,,172,18,154,172,3.50,10.0
2684,tt1725133,Taintlight,2009,250+,430,28,79,47,1.9,26.0,,0,0,0,0,,
2685,tt1053926,Lost Stallions: The Journey Home,2008,100+,190,6,7,5,3.4,46.0,,0,0,0,0,,
2686,tt0964185,Tetro,2009,"10,000+",11730,1062,464,477,3.6,70.0,,111,79,32,111,6.40,71.0
2687,tt0318590,Cazuza: O Tempo Não Pára,2004,500+,563,87,52,14,3.6,62.0,,1,1,0,1,,
2688,tt0059298,I'll Take Sweden,1965,250+,302,9,20,14,3,31.0,,1,0,1,1,,
2689,tt0120540,Yes Boss,1997,"2,500+",2995,135,99,45,3.5,58.0,,0,0,0,0,,
2690,tt0079652,The Odd Angry Shot,1979,500+,631,95,26,56,4.1,78.0,,3,1,2,3,,
2691,tt0210257,Road Rage,1999,0,0,0,0,0,,,,0,0,0,0,,
2692,tt0072409,Willie Dynamite,1974,500+,867,80,39,58,3.8,68.0,,2,1,1,2,,
2693,tt1312222,Last Will,2011,50+,87,2,20,8,1.8,9.0,,0,0,0,0,,
2694,tt0339526,Shooting Gallery,2005,"1,000+",1263,70,70,60,3.2,50.0,,0,0,0,0,,
2695,tt0221431,The Newcomers,2000,250+,341,8,16,7,2.8,33.0,,0,0,0,0,,
2696,tt0244870,Uzumaki,2000,"5,000+",6389,540,406,441,3.4,57.0,,27,16,11,27,6.10,59.0
2697,tt0251834,Meghasandesam,1983,0,0,0,0,0,,,,0,0,0,0,,
2698,tt0089798,Perfect,1985,"5,000+",5811,67,176,68,2.6,28.0,,17,3,14,17,3.60,18.0
2699,tt0274188,Valliettan,2000,0,0,0,0,0,,,,0,0,0,0,,
2700,tt1368860,Daylight Fades,2010,Fewer than 50,37,5,5,3,3,50.0,,0,0,0,0,,
2701,tt0117271,"Our Son, the Matchmaker",1996,0,0,0,0,0,,,,0,0,0,0,,
2702,tt1573482,Striker,2010,100+,160,22,23,21,3.2,49.0,,1,1,0,1,,
2703,tt0285993,Rhythm,2000,0,0,0,0,0,,,,0,0,0,0,,
2704,tt0099018,Almost an Angel,1990,"5,000+",6010,110,117,76,3.2,49.0,,9,3,6,9,4.30,33.0
2705,tt0214037,Raja Aur Runk,1968,Fewer than 50,25,2,0,0,,,,0,0,0,0,,
2706,tt0099938,Kindergarten Cop,1990,"250,000+",328892,7456,6973,8938,3.3,52.0,,38,20,18,38,5.50,53.0
2707,tt0099280,Club Fed,1990,50+,87,4,9,9,2.2,31.0,,0,0,0,0,,
2708,tt0353978,Santhana Gopalam,1994,0,0,0,0,0,,,,0,0,0,0,,
2709,tt2411908,Akam,2012,Fewer than 50,3,0,3,0,,,,0,0,0,0,,
2710,tt0064505,The Italian Job,1969,"50,000+",71225,5203,899,2633,4.1,85.0,,32,26,6,32,7.40,81.0
2711,tt0354922,Snegithiye,2000,Fewer than 50,1,1,0,0,,,,0,0,0,0,,
2712,tt1245735,Smash Cut,2009,250+,378,32,129,72,2.1,20.0,,2,1,1,2,,
2713,tt0118971,The Devil's Advocate,1997,"100,000+",230902,16097,4147,6172,3.9,80.0,,60,38,22,60,6.20,63.0
2714,tt0411427,One Day in Europe,2005,250+,451,57,36,25,3.4,61.0,,1,0,1,1,,
2715,tt0285861,Owning Mahowny,2003,"5,000+",6554,772,252,329,3.7,75.0,,96,75,21,96,7.00,78.0
2716,tt0464071,Sillunu Oru Kadhal,2006,500+,989,73,11,32,4.3,87.0,,0,0,0,0,,
2717,tt0758766,Music and Lyrics,2007,"250,000+",514973,34814,16236,26286,3.6,68.0,,168,106,62,168,6.00,63.0
2718,tt0101455,Bingo,1991,"10,000+",10267,102,168,131,3,38.0,,3,0,3,3,,
2719,tt0363504,Bigger Than the Sky,2005,"1,000+",1435,56,48,48,3.3,54.0,,17,2,15,17,3.90,12.0
2720,tt1792794,Almighty Thor,2011,250+,293,14,129,53,1.4,10.0,,2,0,2,2,,
2721,tt0058402,Night Train to Paris,1964,Fewer than 50,42,1,9,2,2.2,10.0,,0,0,0,0,,
2722,tt0273950,Pasumponn,1995,0,0,0,0,0,,,,0,0,0,0,,
2723,tt0106758,The Double 0 Kid,1992,0,0,0,0,0,,,,0,0,0,0,,
2724,tt0256415,Sweet Home Alabama,2002,"250,000+",802842,34352,9729,18633,4,78.0,,160,61,99,160,5.20,38.0
2725,tt0088919,Chronos,1985,"1,000+",1028,180,36,69,4,83.0,,0,0,0,0,,
2726,tt0433649,Thicker Than Water,2005,0,0,0,0,0,,,,0,0,0,0,,
2727,tt2367996,Mugamoodi,2012,250+,284,34,54,19,2.6,39.0,,0,0,0,0,,
2728,tt0157503,Drop Dead Gorgeous,1999,"50,000+",60328,4289,1420,2547,3.9,75.0,,74,35,39,74,5.50,47.0
2729,tt0070016,Charlotte's Web,1973,"100,000+",227240,2582,1270,3227,3.7,67.0,,21,16,5,21,6.60,76.0
2730,tt1339618,Tapologo,2008,0,0,0,0,0,,,,0,0,0,0,,
2731,tt1617620,A Horrible Way to Die,2010,500+,621,111,211,103,2.7,34.0,,10,6,4,10,6.40,60.0
2732,tt0378647,Ramana,2002,Fewer than 50,1,1,0,0,,,,0,0,0,0,,
2733,tt0067630,Psychomania,1973,"1,000+",1287,97,83,87,3.5,54.0,,7,6,1,7,6.80,86.0
2734,tt0439289,Running with Scissors,2006,"100,000+",132786,7543,5962,6016,3.3,56.0,,136,43,93,136,5.10,32.0
2735,tt1205489,Gran Torino,2008,"250,000+",332978,70320,7783,31663,4.2,90.0,,237,192,45,237,7.10,81.0
2736,tt1437367,Thanks Maa,2009,50+,68,12,4,6,3.7,75.0,,1,1,0,1,,
2737,tt0274114,Summer in Bethlehem,1998,0,0,0,0,0,,,,0,0,0,0,,
2738,tt0140534,Sathi Leelavathi,1995,Fewer than 50,1,1,0,0,,,,0,0,0,0,,
2739,tt0390323,On the Downlow,2004,0,0,0,0,0,,,,0,0,0,0,,
2740,tt0277371,Not Another Teen Movie,2001,"250,000+",442799,10062,8101,9827,3.3,55.0,,100,31,69,100,4.40,31.0
2741,tt0207104,Sins of the Fleshapoids,1966,250+,369,22,10,14,3.7,69.0,,0,0,0,0,,
2742,tt0355167,Aadyathe Kanmani,1995,0,0,0,0,0,,,,0,0,0,0,,
2743,tt0246258,Subhalekha,1982,Fewer than 50,1,1,0,0,,,,0,0,0,0,,
2744,tt0072219,The Stranger Within,1974,50+,69,1,1,0,,,,0,0,0,0,,
2745,tt0079981,El Super,1979,50+,54,4,2,3,3.3,67.0,,13,12,1,13,7.50,92.0
2746,tt0388213,Loverboy,2005,"10,000+",21760,151,274,230,2.8,36.0,,33,6,27,33,4.20,18.0
2747,tt0387596,Silmido,2003,"1,000+",1958,302,59,106,4,84.0,,1,1,0,1,,
2748,tt0364647,Virumandi,2004,Fewer than 50,1,1,0,0,,,,0,0,0,0,,
2749,tt1549572,Another Earth,2011,"10,000+",19088,5506,2862,1706,3.5,66.0,,134,89,45,134,6.30,66.0
2750,tt0331479,Ek Chhotisi Love Story,2002,100+,129,2,5,2,2.1,29.0,,0,0,0,0,,
2751,tt0111256,Speechless,1994,"2,500+",4528,92,183,86,2.9,33.0,,29,3,26,29,4.00,10.0
2752,tt0118735,Blackrock,1997,"1,000+",1895,67,37,42,3.5,64.0,,2,0,2,2,,
2753,tt0119896,Picture Perfect,1997,"25,000+",42026,854,1468,642,3,37.0,,43,20,23,43,5.40,47.0
2754,tt0075968,The Duellists,1977,"5,000+",6284,1103,222,382,4,83.0,,60,44,16,60,7.20,73.0
2755,tt0077669,A Hero Ain't Nothin' But a Sandwich,1977,50+,73,10,5,2,3.8,67.0,,1,1,0,1,,
2756,tt0120728,The Last Days of Disco,1998,"5,000+",6294,668,353,256,3.5,65.0,,62,45,17,62,6.50,73.0
2757,tt0284137,Gadar: Ek Prem Katha,2001,"1,000+",1046,115,26,32,4,81.0,,1,1,0,1,,
2758,tt0151331,Let the Devil Wear Black,1999,100+,229,6,16,6,2.8,27.0,,7,4,3,7,5.80,57.0
2759,tt0082427,The Funhouse,1981,"5,000+",7418,447,620,376,3.1,42.0,,21,14,7,21,6.20,67.0
2760,tt0115988,The Crucible,1996,"25,000+",32019,2667,1384,1298,3.6,66.0,,64,45,19,64,7.30,70.0
2761,tt1192621,Crushed,2009,0,0,0,0,0,,,,0,0,0,0,,
2762,tt0299172,Home on the Range,2004,"25,000+",32371,689,1676,716,2.7,29.0,,129,67,62,129,5.70,52.0
2763,tt0101745,Doc Hollywood,1991,"25,000+",43981,1139,1111,565,3.3,51.0,,51,35,16,51,6.10,69.0
2764,tt0120584,All the Little Animals,1998,"2,500+",3501,297,89,128,3.9,77.0,,21,14,7,21,5.30,67.0
2765,tt0362771,Ishq Vishk,2003,"2,500+",3099,245,54,95,4.2,82.0,,0,0,0,0,,
2766,tt0055207,Mysterious Island,1961,"2,500+",3274,268,148,141,3.6,64.0,,16,13,3,16,6.40,81.0
2767,tt0060897,Return of the Seven,1966,"2,500+",4245,65,123,83,3,34.0,,8,1,7,8,4.10,13.0
2768,tt0057590,Tom Jones,1963,"5,000+",5525,399,289,239,3.4,58.0,,43,35,8,43,7.50,81.0
2769,tt0107315,Kika,1993,"5,000+",7274,1126,464,220,3.7,71.0,,17,10,7,17,5.50,59.0
2770,tt0460745,Chaos Theory,2007,"10,000+",12627,2250,1621,1399,3.4,58.0,,60,18,42,60,5.10,30.0
2771,tt0080626,Diary of the Dead,1976,Fewer than 50,28,5,6,4,3,45.0,,3,0,3,3,,
2772,tt0465538,Michael Clayton,2007,"250,000+",300164,47833,21171,21726,3.6,69.0,,206,186,20,206,7.60,90.0
2773,tt0056181,Life for Ruth,1962,Fewer than 50,1,1,0,1,,,,0,0,0,0,,
2774,tt1589487,Meteor Storm,2010,100+,105,7,53,20,1.9,12.0,,0,0,0,0,,
2775,tt0348593,The Door in the Floor,2004,"5,000+",9039,971,539,499,3.5,64.0,,142,96,46,142,6.50,68.0
2776,tt1183147,Lights Camera Dead,2007,0,0,0,0,0,,,,0,0,0,0,,
2777,tt1524131,Knucklehead,2010,"2,500+",4661,169,319,141,2.9,35.0,,10,1,9,10,3.00,10.0
2778,tt0104897,Mo' Money,1992,"5,000+",9005,335,326,189,3.3,51.0,,25,4,21,25,4.20,16.0
2779,tt0055871,The Counterfeit Traitor,1962,500+,960,56,11,22,3.9,84.0,,4,3,1,4,,
2780,tt0079940,Spirit of the Wind,1979,0,0,0,0,0,,,,0,0,0,0,,
2781,tt5226670,Vishnu,1995,0,0,0,0,0,,,,0,0,0,0,,
2782,tt0795363,"Crouching Tiger, Hidden Dragon",2003,"250,000+",427893,29181,4725,13700,4.1,86.0,,170,166,4,170,8.70,98.0
2783,tt0094288,Walk Like a Man,1987,"2,500+",4551,84,78,83,3.2,52.0,,0,0,0,0,,
2784,tt0430589,Shaadi Karke Phas Gaya Yaar,2006,"1,000+",1684,35,26,33,3.4,57.0,,0,0,0,0,,
2785,tt0795363,"Crouching Tiger, Hidden Dragon",2003,"250,000+",427893,29181,4725,13700,4.1,86.0,,170,166,4,170,8.70,98.0
2786,tt0084893,We of the Never Never,1982,250+,256,13,9,10,3.4,59.0,,2,0,2,2,,
2787,tt0107212,Indian Summer,1993,0,0,0,0,0,,,,0,0,0,0,,
2788,tt0105792,Waxwork II: Lost in Time,1992,"2,500+",3120,87,181,106,2.9,32.0,,4,0,4,4,,
2789,tt0077912,Mardi Gras Massacre,1978,50+,81,3,20,11,2,13.0,,1,0,1,1,,
2790,tt0220580,Intacto,2001,"5,000+",8068,1241,270,473,3.9,82.0,,71,52,19,71,6.50,73.0
2791,tt0105483,A Stranger Among Us,1992,"5,000+",7180,64,102,57,2.9,39.0,,41,9,32,41,4.70,22.0
2792,tt0286152,Stark Raving Mad,2002,"2,500+",4465,213,171,127,3.3,55.0,,5,1,4,5,4.80,20.0
2793,tt0991346,Bhoothnath,2008,"1,000+",2432,186,163,142,3.3,53.0,,5,3,2,5,6.30,60.0
2794,tt0449599,Hood of the Living Dead,2005,Fewer than 50,36,2,8,3,1.8,20.0,,1,0,1,1,,
2795,tt0071408,Deranged,1974,"1,000+",1256,185,144,129,3.3,56.0,,5,2,3,5,6.10,40.0
2796,tt1675852,Coyote Falls,2010,0,0,0,0,0,,,,0,0,0,0,,
2797,tt0117104,Mrs. Winterbourne,1996,"10,000+",17720,662,387,450,3.6,63.0,,33,5,28,33,4.20,15.0
2798,tt0112435,The Baby-Sitters Club,1995,"5,000+",9977,321,361,327,3.2,47.0,,15,10,5,15,6.20,67.0
2799,tt0410057,Hail the New Puritan,1987,0,0,0,0,0,,,,0,0,0,0,,
2800,tt0245046,Charlotte Gray,2001,"5,000+",7685,685,412,321,3.5,62.0,,89,29,60,89,4.70,33.0
2801,tt0100369,The Pit and the Pendulum,1991,"1,000+",2257,101,147,108,3,41.0,,9,5,4,9,6.10,56.0
2802,tt0426396,Alien Abduction,2005,"1,000+",1794,16,31,29,2.5,34.0,,1,1,0,1,,
2803,tt1742683,Too Big to Fail,2011,"1,000+",1051,550,180,111,3.8,75.0,,30,23,7,30,6.00,77.0
2804,tt0489281,Stop-Loss,2008,"250,000+",748319,15532,43644,4230,2.5,26.0,,143,92,51,143,6.30,64.0
2805,tt0129290,Patch Adams,1998,"250,000+",265294,9183,3350,6519,3.8,73.0,,71,15,56,71,4.20,21.0
2806,tt1431122,No Problem,2010,500+,724,15,57,26,2.2,21.0,,3,1,2,3,,
2807,tt0341376,Gettin' Square,2003,"2,500+",3013,300,62,184,4,83.0,,1,1,0,1,,
2808,tt0104695,Leap of Faith,1992,"10,000+",10948,470,554,229,3.2,46.0,,22,14,8,22,6.40,64.0
2809,tt0092076,The Texas Chainsaw Massacre 2,1986,"50,000+",51045,1546,1858,1445,3.1,45.0,,32,16,16,32,5.10,50.0
2810,tt8929166,Aayudham Seivom,2008,0,0,0,0,0,,,,0,0,0,0,,
2811,tt1270850,The Waiting City,2009,500+,854,65,61,50,3.3,52.0,,16,12,4,16,6.40,75.0
2812,tt0317198,Bridget Jones: The Edge of Reason,2004,"250,000+",408385,8732,5856,8117,3.5,60.0,,158,43,115,158,4.70,27.0
2813,tt0102593,One Good Cop,1991,"5,000+",6778,65,141,65,2.8,32.0,,14,2,12,14,4.80,14.0
2814,tt0076591,"Race for Your Life, Charlie Brown",1977,"5,000+",6720,286,69,132,4,81.0,,6,3,3,6,5.80,50.0
2815,tt0179477,Storm Catcher,1999,500+,741,10,35,9,2,22.0,,4,0,4,4,,
2816,tt0226494,The Street: A Film with the Homeless,1997,Fewer than 50,1,1,0,0,,,,0,0,0,0,,
2817,tt6448728,Modhi Vilayadu,2009,0,0,0,0,0,,,,0,0,0,0,,
2818,tt1756474,Desperate Endeavors,2012,50+,80,11,2,5,4,85.0,,3,0,3,3,,
2819,tt0468526,Old Joy,2006,"5,000+",5589,774,311,383,3.7,71.0,,95,81,14,95,7.30,85.0
2820,tt1410205,The Land That Time Forgot,2009,250+,374,8,85,41,1.8,9.0,,1,1,0,1,,
2821,tt0217249,An American Daughter,2000,50+,55,0,1,0,,,,1,1,0,1,,
2822,tt1655460,Wanderlust,2012,"25,000+",42394,6473,9995,2227,3,39.0,,147,86,61,147,5.60,59.0
2823,tt0075357,Tunnel Vision,1976,0,0,0,0,0,,,,0,0,0,0,,
2824,tt0248126,Kabhi Khushi Kabhie Gham...,2001,"25,000+",28960,2846,406,1235,4.3,88.0,,11,11,0,11,8.80,100.0
2825,tt0057583,A Ticklish Affair,1963,100+,124,8,8,6,3.3,50.0,,0,0,0,0,,
2826,tt0283486,Millennium Stars,2000,0,0,0,0,0,,,,0,0,0,0,,
2827,tt0369441,Fun with Dick and Jane,2005,"250,000+",759651,11848,12202,17820,3.2,49.0,,134,39,95,134,4.90,29.0
2828,tt1567609,Get the Gringo,2012,"5,000+",9769,4619,2196,1135,3.6,68.0,,57,46,11,57,6.30,81.0
2829,tt0079766,Quadrophenia,1979,"2,500+",3415,1005,211,299,4,83.0,,15,15,0,15,7.40,100.0
2830,tt0138075,Satan in High Heels,1962,50+,70,4,11,3,2.7,27.0,,3,2,1,3,,
2831,tt0139134,Cruel Intentions,1999,"250,000+",436567,30274,7335,15780,4,80.0,,117,63,54,117,5.20,54.0
2832,tt0085874,Lucien Brouillard,1983,0,0,0,0,0,,,,0,0,0,0,,
2833,tt0116552,Homeward Bound II: Lost in San Francisco,1996,"25,000+",49754,939,1182,915,3.2,44.0,,18,10,8,18,6.10,56.0
2834,tt0376591,Empire Falls,2005,"5,000+",5800,342,114,143,3.8,75.0,,4,2,2,4,,
2835,tt0201394,The Shrink Is In,2001,"1,000+",1423,60,70,48,3.2,46.0,,0,0,0,0,,
2836,tt0079596,My Brilliant Career,1979,500+,500,120,60,49,3.6,66.0,,21,18,3,21,7.70,86.0
2837,tt0058101,The Flesh Eaters,1964,"1,000+",1388,35,42,36,3.1,45.0,,4,1,3,4,,
2838,tt0164018,Dirt Merchant,1999,100+,122,4,10,5,2.6,29.0,,0,0,0,0,,
2839,tt0273822,Mockingbird Don't Sing,2001,"1,000+",1738,153,59,73,3.7,72.0,,1,0,1,1,,
2840,tt0479651,Dasavatharam,2008,"1,000+",1397,158,116,120,3.4,58.0,,4,2,2,4,,
2841,tt0259263,Daivathinte Vikrithikal,1992,0,0,0,0,0,,,,0,0,0,0,,
2842,tt0065372,Adam's Woman,1970,Fewer than 50,3,1,0,0,,,,0,0,0,0,,
2843,tt0454941,The Sensei,2008,100+,176,29,15,21,3.6,66.0,,0,0,0,0,,
2844,tt1465505,Red White & Blue,2010,"1,000+",1259,394,202,172,3.6,66.0,,25,21,4,25,7.00,84.0
2845,tt0101343,And You Thought Your Parents Were Weird,1991,250+,274,11,25,11,2.8,31.0,,4,0,4,4,,
2846,tt0192194,Julien Donkey-Boy,1999,"5,000+",6127,737,292,317,3.7,72.0,,38,11,27,38,5.30,29.0
2847,tt0422091,Dhoom,2004,"10,000+",12202,820,259,421,3.9,76.0,,1,0,1,1,,
2848,tt0093693,Overboard,1987,"50,000+",68413,3907,1394,2101,3.9,74.0,,35,16,19,35,5.20,46.0
2849,tt1122836,Alien Trespass,2009,"10,000+",11954,137,301,227,2.8,31.0,,66,25,41,66,5.00,38.0
2850,tt0452592,Borderland,2007,"2,500+",4208,497,658,503,3.1,43.0,,8,8,0,8,6.80,100.0
2851,tt2955162,Moggina Manasu,2008,0,0,0,0,0,,,,0,0,0,0,,
2852,tt1172522,Machan,2008,250+,311,94,15,40,4,86.0,,0,0,0,0,,
2853,tt0398414,Amnesia,2004,Fewer than 50,8,0,2,0,,,,3,2,1,3,,
2854,tt0087277,Footloose,1984,"250,000+",270509,10731,4337,7519,3.8,71.0,,45,24,21,45,5.80,53.0
2855,tt0273799,Max Keeble's Big Move,2001,"10,000+",19911,412,672,339,2.9,38.0,,56,16,40,56,4.40,29.0
2856,tt0070825,The Train Robbers,1973,"2,500+",3762,129,92,58,3.4,58.0,,6,2,4,6,4.40,33.0
2857,tt0120723,Kissing a Fool,1998,"5,000+",6485,165,205,133,3.2,45.0,,31,9,22,31,4.60,29.0
2858,tt0268131,Alag Alag,1985,0,0,0,0,0,,,,0,0,0,0,,
2859,tt1179034,From Paris with Love,2010,"100,000+",155798,9332,8015,5816,3.3,54.0,,162,60,102,162,4.70,37.0
2860,tt1092633,"The Goods: Live Hard, Sell Hard",2009,"50,000+",74223,2849,4822,2723,2.9,37.0,,104,28,76,104,4.20,27.0
2861,tt0385056,Lonesome Jim,2005,"10,000+",22371,734,561,510,3.4,57.0,,90,54,36,90,6.00,60.0
2862,tt0208911,The King Is Alive,2000,"1,000+",1094,75,53,33,3.4,59.0,,68,41,27,68,6.00,60.0
2863,tt0090264,A View to a Kill,1985,"50,000+",74108,2510,3776,2311,3,40.0,,62,23,39,62,4.90,37.0
2864,tt0282123,A Ring of Endless Light,2002,"2,500+",3436,124,99,80,3.5,56.0,,4,2,2,4,,
2865,tt0087538,The Karate Kid,1984,"250,000+",317177,12539,2670,8926,4,82.0,,45,40,5,45,7.00,89.0
2866,tt0053644,The Bellboy,1960,"2,500+",4742,193,92,117,3.7,68.0,,11,8,3,11,6.90,73.0
2867,tt0103976,City of Joy,1992,"5,000+",6246,358,124,158,3.8,74.0,,17,9,8,17,5.40,53.0
2868,tt0069293,Solyaris,1972,"25,000+",27295,5641,669,1496,4.3,89.0,,66,61,5,66,8.60,92.0
2869,tt1714203,Piranha 3DD,2012,"10,000+",22634,1483,5191,1257,2.2,22.0,,53,6,47,53,3.40,11.0
2870,tt1928242,Who Is Simon Miller?,2011,0,0,0,0,0,,,,0,0,0,0,,
2871,tt0349159,"The Book of Mormon Movie, Volume 1: The Journey",2003,50+,58,4,14,3,2.1,22.0,,6,1,5,6,4.20,17.0
2872,tt0309452,The Circuit,2002,50+,77,1,8,5,2.3,11.0,,0,0,0,0,,
2873,tt0087332,Ghostbusters,1984,"250,000+",1041319,56200,7545,26724,4.2,88.0,,78,74,4,78,8.10,95.0
2874,tt0365407,Kill the Poor,2003,100+,146,6,12,6,2.8,33.0,,8,2,6,8,5.30,25.0
2875,tt1712170,Alex Cross,2012,"25,000+",44703,5821,6562,1766,3.1,47.0,,128,14,114,128,3.60,11.0
2876,tt0255664,Ustaad,1999,0,0,0,0,0,,,,0,0,0,0,,
2877,tt0337652,Jeena Sirf Merre Liye,2002,500+,623,15,24,10,2.7,38.0,,0,0,0,0,,
2878,tt1105721,Chirutha,2007,100+,118,5,8,4,3.2,38.0,,0,0,0,0,,
2879,tt0118261,Asteroid,1997,"5,000+",8101,23,58,52,2.5,28.0,,2,0,2,2,,
2880,tt0240900,Slackers,2002,"25,000+",28387,1024,1012,683,3.2,50.0,,105,11,94,105,3.30,10.0
2881,tt0086593,Without a Trace,1983,"1,000+",1496,94,31,42,3.9,75.0,,7,6,1,7,6.60,86.0
2882,tt2690596,Thoranai,2009,Fewer than 50,3,0,2,0,,,,0,0,0,0,,
2883,tt0079831,The Runner Stumbles,1979,Fewer than 50,23,2,0,0,,,,12,6,6,12,5.90,50.0
2884,tt0918554,Plaguers,2008,100+,169,1,40,23,1.4,2.0,,0,0,0,0,,
2885,tt7897230,Aalukkoru Aasai,2003,0,0,0,0,0,,,,0,0,0,0,,
2886,tt0104521,Into the Sun,1991,100+,123,10,21,10,3,32.0,,2,0,2,2,,
2887,tt0488147,Legend of Frosty the Snowman,2005,"5,000+",7010,47,73,61,2.9,39.0,,2,1,1,2,,
2888,tt0889573,The Switch,2010,"50,000+",79140,7348,9222,2989,3.2,44.0,,156,83,73,156,5.50,53.0
2889,tt1239401,Bank Bang,2008,100+,247,28,37,12,2.9,43.0,,1,1,0,1,,
2890,tt0068636,Ooh... You Are Awful,1972,Fewer than 50,1,1,0,1,,,,1,1,0,1,,
2891,tt0080917,In God We Tru$t,1980,100+,158,14,15,5,3.4,48.0,,4,1,3,4,,
2892,tt12771950,Andipatti Arasanpatti,2002,0,0,0,0,0,,,,0,0,0,0,,
2893,tt0084412,Night Shift,1982,"5,000+",8929,743,438,302,3.5,63.0,,28,26,2,28,6.70,93.0
2894,tt0857275,Wonderful World,2009,"1,000+",1741,123,251,120,2.8,33.0,,31,13,18,31,5.00,42.0
2895,tt0457477,Silver Bells,2005,250+,279,36,17,14,3.6,68.0,,1,0,1,1,,
2896,tt1212451,April Showers,2009,500+,725,95,64,56,3.5,60.0,,1,1,0,1,,
2897,tt0496436,White Noise 2: The Light,2007,"10,000+",12186,887,1181,1094,3,43.0,,8,6,2,8,5.10,75.0
2898,tt0102713,The Prince of Tides,1991,"5,000+",9265,922,388,403,3.7,70.0,,34,23,11,34,6.60,68.0
2899,tt1043757,Not Another B Movie,2010,0,0,0,0,0,,,,0,0,0,0,,
2900,tt0160495,Luckytown,2000,100+,227,6,22,7,2.5,21.0,,3,0,3,3,,
2901,tt0082096,Das Boot,1981,"25,000+",47572,9045,426,2948,4.5,96.0,,58,57,1,58,9.10,98.0
2902,tt0087268,Flashpoint,1984,"1,000+",1721,34,43,34,3.2,43.0,,14,8,6,14,5.60,57.0
2903,tt1584917,Bolo Raam,2009,0,0,0,0,0,,,,0,0,0,0,,
2904,tt0429589,The Ant Bully,2006,"50,000+",89000,2203,3040,1585,3.1,42.0,,118,73,45,118,6.20,62.0
2905,tt0090750,Blood Hook,1986,Fewer than 50,21,1,9,5,1.6,10.0,,3,0,3,3,,
2906,tt0098725,Sweetie,1989,"1,000+",1557,208,73,81,3.6,74.0,,20,18,2,20,7.60,90.0
2907,tt1214974,Men's Group,2008,50+,96,22,5,9,3.9,81.0,,7,6,1,7,6.80,86.0
2908,tt0271581,Johnnie Walker,1992,0,0,0,0,0,,,,0,0,0,0,,
2909,tt0121766,Star Wars: Episode III - Revenge of the Sith,2005,"250,000+",33683838,99570,51865,1608216,3.1,66.0,,305,242,63,305,7.30,79.0
2910,tt0096101,Short Circuit 2,1988,"50,000+",54825,1398,1199,1175,3.4,54.0,,13,5,8,13,4.40,38.0
2911,tt0105719,The Vagrant,1992,250+,381,19,36,21,3,33.0,,0,0,0,0,,
2912,tt0490181,Mutant Chronicles,2008,"25,000+",26623,763,2428,1502,2.4,24.0,,35,6,29,35,3.50,17.0
2913,tt0936471,Transylmania,2009,"1,000+",2315,87,317,147,2.2,22.0,,21,0,21,21,2.20,0.0
2914,tt0119115,Fierce Creatures,1997,"10,000+",14857,920,656,493,3.5,58.0,,32,17,15,32,5.50,53.0
2915,tt0101882,Fires Within,1991,250+,297,3,7,2,2.4,30.0,,1,1,0,1,,
2916,tt0083186,Texas Lightning,1981,Fewer than 50,48,1,5,3,1.8,17.0,,0,0,0,0,,
2917,tt0439878,Before It Had a Name,2005,100+,172,2,23,11,1.7,8.0,,0,0,0,0,,
2918,tt0406046,The Magic of Ordinary Days,2005,500+,921,259,42,102,4.2,86.0,,0,0,0,0,,
2919,tt0206240,Raja Rani,1973,Fewer than 50,25,1,0,0,,,,0,0,0,0,,
2920,tt0109855,Fun,1994,"1,000+",1328,81,29,57,3.8,73.0,,11,9,2,11,7.00,82.0
2921,tt0236640,Prozac Nation,2001,"10,000+",21376,1783,1292,951,3.4,58.0,,25,7,18,25,4.70,28.0
2922,tt1202222,Lies & Illusions,2009,"1,000+",1679,33,773,183,1,4.0,,2,0,2,2,,
2923,tt0825245,Dragonlance: Dragons of Autumn Twilight,2008,"2,500+",4748,98,395,323,2.3,20.0,,2,0,2,2,,
2924,tt0119695,Money Talks,1997,"25,000+",39028,2049,857,831,3.8,71.0,,19,3,16,19,4.00,16.0
2925,tt0115837,Carried Away,1996,Fewer than 50,26,1,0,0,,,,0,0,0,0,,
2926,tt0106770,Dragon: The Bruce Lee Story,1993,"50,000+",57824,2567,679,1348,3.9,79.0,,22,16,6,22,6.80,73.0
2927,tt0068742,Innocent Bystanders,1972,50+,56,2,2,1,,,,2,1,1,2,,
2928,tt1369845,Wizards of Waverly Place: The Movie,2009,"10,000+",23021,1404,680,411,3.8,67.0,,3,1,2,3,,
2929,tt0465436,December Boys,2007,"10,000+",22770,1496,1394,1302,3.3,52.0,,70,29,41,70,5.00,41.0
2930,tt0247638,The Princess Diaries,2001,"250,000+",758170,27448,12999,17302,3.7,68.0,,117,57,60,117,5.30,49.0
2931,tt1346983,Loving Leah,2009,250+,410,80,32,36,3.8,71.0,,0,0,0,0,,
2932,tt0096409,Walker,1987,500+,884,208,110,144,3.5,65.0,,16,7,9,16,6.20,44.0
2933,tt0097889,Miracle Mile,1988,"2,500+",3779,442,166,214,3.7,73.0,,32,29,3,32,6.90,91.0
2934,tt1570417,Accident on Hill Road,2010,Fewer than 50,16,1,4,2,2.5,20.0,,1,0,1,1,,
2935,tt0099623,Funny About Love,1990,"1,000+",1522,10,60,18,2.3,14.0,,8,0,8,8,3.30,0.0
2936,tt0120885,Wag the Dog,1997,"25,000+",44694,4519,1407,1508,3.8,76.0,,78,67,11,78,7.50,86.0
2937,tt0080467,The Boy Who Drank Too Much,1980,0,0,0,0,0,,,,0,0,0,0,,
2938,tt0993778,Ploy,2007,500+,751,130,80,77,3.5,62.0,,0,0,0,0,,
2939,tt0414344,The War Within,2005,500+,883,110,61,58,3.6,64.0,,56,40,16,56,6.60,71.0
2940,tt1284656,Twists of Fate,2009,50+,88,4,7,4,3.3,36.0,,0,0,0,0,,
2941,tt0097965,New York Stories,1989,"5,000+",9769,942,739,392,3.4,56.0,,25,19,6,25,6.30,76.0
2942,tt0117571,Scream,1996,"250,000+",480656,29543,7482,15482,4,80.0,,89,72,17,89,7.40,81.0
2943,tt0844671,College,2008,"50,000+",67983,641,1733,1037,2.5,27.0,,43,2,41,43,2.70,5.0
2944,tt0272045,Claymation Christmas Celebration,1987,"1,000+",1407,96,13,57,4.4,88.0,,1,1,0,1,,
2945,tt0070633,Satan's School for Girls,1973,50+,71,8,31,14,2.5,21.0,,0,0,0,0,,
2946,tt1450328,Mooz-Lum,2010,500+,629,201,57,70,4,78.0,,10,8,2,10,7.10,80.0
2947,tt0280969,My Little Eye,2002,"5,000+",9049,342,564,390,2.8,38.0,,23,16,7,23,5.40,70.0
2948,tt0290498,By Hook or by Crook,2001,"1,000+",1008,24,7,12,4,77.0,,14,9,5,14,5.60,64.0
2949,tt0964539,Pathology,2008,"25,000+",49467,1741,2685,2198,2.9,39.0,,23,11,12,23,4.70,48.0
2950,tt0062860,Danger Route,1967,100+,134,2,0,1,,,,1,0,1,1,,
2951,tt0926341,Terror Inside,2008,50+,58,7,15,8,2.3,32.0,,0,0,0,0,,
2952,tt0271692,Ormakalundayirikkanam,1995,0,0,0,0,0,,,,0,0,0,0,,
2953,tt0074279,Cannonball!,1976,"5,000+",8311,85,162,71,3,35.0,,4,0,4,4,,
2954,tt0059484,The Murder Game,1965,0,0,0,0,0,,,,0,0,0,0,,
2955,tt0276011,Children of the Living Dead,2001,"5,000+",7977,21,146,133,1.5,13.0,,4,0,4,4,,
2956,tt0137799,Ground Control,1998,500+,846,42,80,38,2.9,34.0,,5,2,3,5,4.60,40.0
2957,tt0086877,Alphabet City,1984,500+,765,14,29,16,3,33.0,,1,0,1,1,,
2958,tt1293561,Gingerdead Man 3: Saturday Night Cleaver,2011,500+,895,17,83,40,1.9,17.0,,1,0,1,1,,
2959,tt0159995,Angel's Dance,1999,500+,679,25,23,14,3.4,52.0,,4,0,4,4,,
2960,tt2446108,Monster High: Ghouls Rule!,2012,500+,714,137,26,24,4.4,84.0,,2,1,1,2,,
2961,tt1606162,Aakhari Decision,2010,0,0,0,0,0,,,,0,0,0,0,,
2962,tt0863080,The House Next Door,2006,250+,424,23,68,41,2.5,25.0,,1,0,1,1,,
2963,tt1273675,Rent: Filmed Live on Broadway,2008,"1,000+",1668,372,22,154,4.5,94.0,,0,0,0,0,,
2964,tt1266545,Chamku,2008,250+,276,2,27,12,1.9,7.0,,1,0,1,1,,
2965,tt0307351,Prey for Rock & Roll,2003,"2,500+",4401,206,119,148,3.7,63.0,,50,29,21,50,5.80,58.0
2966,tt0245998,Khaidi No. 786,1988,Fewer than 50,1,1,0,0,,,,0,0,0,0,,
2967,tt0086349,Spasms,1983,250+,345,3,20,7,2.7,13.0,,2,0,2,2,,
2968,tt0114048,Operation Dumbo Drop,1995,"25,000+",32019,279,682,459,2.7,29.0,,24,6,18,24,4.40,25.0
2969,tt0245562,Windtalkers,2002,"50,000+",66942,3733,3773,2185,3.2,50.0,,166,55,111,166,5.20,33.0
2970,tt1579526,Anjaneyulu,2009,0,0,0,0,0,,,,0,0,0,0,,
2971,tt0063571,Secret Ceremony,1968,250+,477,50,41,29,3.1,54.0,,14,9,5,14,6.30,64.0
2972,tt0473488,A Guide to Recognizing Your Saints,2006,"100,000+",101464,4761,1721,2529,3.7,73.0,,94,71,23,94,6.60,76.0
2973,tt0216707,Dil Kya Kare,1999,100+,240,8,12,1,3.1,40.0,,0,0,0,0,,
2974,tt0118647,The Assignment,1997,"2,500+",4434,214,137,98,3.5,61.0,,21,13,8,21,5.80,62.0
2975,tt0295289,A Guy Thing,2003,"50,000+",73273,787,1434,779,2.9,35.0,,104,26,78,104,4.10,25.0
2976,tt0499448,The Chronicles of Narnia: Prince Caspian,2008,"250,000+",553162,45363,16916,30032,3.8,73.0,,193,128,65,193,6.30,66.0
2977,tt1910605,Rags,2012,Fewer than 50,21,8,3,4,3.6,73.0,,0,0,0,0,,
2978,tt0335034,Deacons for Defense,2003,250+,400,24,3,10,4.1,89.0,,0,0,0,0,,
2979,tt1197628,Observe and Report,2009,"250,000+",641831,5665,9827,6915,2.8,37.0,,211,108,103,211,5.60,51.0
2980,tt1549901,The One Lamb,2009,Fewer than 50,28,1,1,1,,,,0,0,0,0,,
2981,tt0073637,Rosebud,1975,50+,70,3,11,4,2.8,21.0,,9,4,5,9,5.10,44.0
2982,tt0181947,3 Dev Adam,1973,Fewer than 50,9,6,1,1,4.2,83.0,,1,1,0,1,,
2983,tt0337579,Barbershop 2: Back in Business,2004,"50,000+",73622,976,1058,662,3.3,48.0,,127,87,40,127,6.30,69.0
2984,tt1315044,How Much Do You Love Me?,2008,Fewer than 50,2,1,1,0,,,,0,0,0,0,,
2985,tt1064728,Candy Boy,2007,0,0,0,0,0,,,,0,0,0,0,,
2986,tt0069400,Trafic,1971,"1,000+",2049,337,103,123,3.9,77.0,,22,21,1,22,7.90,95.0
2987,tt0981224,Midnight Movie,2008,"5,000+",7599,145,355,257,2.6,29.0,,1,1,0,1,,
2988,tt0091329,Kate's Secret,1986,Fewer than 50,10,4,0,1,,,,0,0,0,0,,
2989,tt1067774,Monte Carlo,2011,"25,000+",25979,3166,3216,836,3.3,50.0,,92,37,55,92,4.80,40.0
2990,tt0283054,Thunderpants,2002,"5,000+",5592,226,290,247,3,44.0,,6,4,2,6,5.50,67.0
2991,tt0291376,Nayak: The Real Hero,2001,500+,976,94,40,29,3.7,70.0,,0,0,0,0,,
2992,tt1629241,Bumm Bumm Bole,2010,Fewer than 50,16,6,4,2,3.4,60.0,,0,0,0,0,,
2993,tt0082640,Lady Chatterley's Lover,1981,"1,000+",1430,40,92,44,2.8,30.0,,1,0,1,1,,
2994,tt0268146,Anurodh,1977,0,0,0,0,0,,,,0,0,0,0,,
2995,tt0114694,Tommy Boy,1995,"250,000+",252645,26493,2992,10937,4.3,90.0,,46,18,28,46,5.20,39.0
2996,tt0818682,Islam: What the West Needs to Know,2006,"2,500+",3449,62,25,41,3.6,71.0,,2,0,2,2,,
2997,tt0100842,The Unbelievable Truth,1989,"2,500+",3695,391,57,87,4.1,87.0,,10,10,0,10,7.70,100.0
2998,tt0295254,Feardotcom,2002,"50,000+",57893,357,1677,1127,2,18.0,,101,3,98,101,2.90,3.0
2999,tt0074216,The Blank Generation,1976,Fewer than 50,33,6,2,3,4.2,75.0,,1,1,0,1,,
3000,tt0107750,Only the Strong,1993,"5,000+",6863,535,157,317,4,77.0,,15,2,13,15,3.60,13.0
3001,tt0193164,A Flintstones Christmas Carol,1994,250+,349,47,37,25,3.5,56.0,,1,0,1,1,,
3002,tt0075629,Across the Great Divide,1976,500+,580,18,18,9,3.6,50.0,,2,2,0,2,,
3003,tt1259571,The Twilight Saga: New Moon,2009,"250,000+",578336,58741,38055,35081,3.5,61.0,,231,66,165,231,4.80,29.0
3004,tt0390418,The Raspberry Reich,2004,500+,976,109,61,70,3.6,65.0,,16,9,7,16,5.10,56.0
3005,tt1077368,Dark Shadows,2012,"250,000+",257670,25469,30181,8077,3.2,46.0,,262,93,169,262,5.30,35.0
3006,tt1754123,Lidice,2011,Fewer than 50,35,15,7,5,3.7,68.0,,0,0,0,0,,
3007,tt0066819,The Beguiled,1971,"5,000+",5694,588,231,234,3.7,72.0,,21,19,2,21,7.30,90.0
3008,tt0065832,Hercules in New York,1970,"5,000+",8094,307,827,514,2.4,27.0,,7,1,6,7,2.60,14.0
3009,tt0366548,Happy Feet,2006,"250,000+",617682,58046,25263,40529,3.7,70.0,,170,129,41,170,6.90,76.0
3010,tt0164810,Pipe Dream,2002,500+,899,14,31,13,3,31.0,,18,13,5,18,6.40,72.0
3011,tt0782695,Manasellaam,2003,0,0,0,0,0,,,,0,0,0,0,,
3012,tt0824747,Changeling,2008,0,0,0,0,0,,,,0,0,0,0,,
3013,tt2278074,Manushya Mrugam,2011,0,0,0,0,0,,,,0,0,0,0,,
3014,tt0084296,The Man from Snowy River,1982,"25,000+",26364,1661,207,801,4.3,89.0,,13,11,2,13,6.50,85.0
3015,tt2404027,Arjun: The Warrior Prince,2012,"1,000+",1818,71,39,41,3.7,65.0,,9,6,3,9,5.70,67.0
3016,tt0900357,Boogeyman 2,2007,"25,000+",26359,435,850,680,2.8,34.0,,3,2,1,3,,
3017,tt0337692,On the Road,2012,0,0,0,0,0,,,,0,0,0,0,,
3018,tt0105813,White Sands,1992,"2,500+",3636,121,175,69,3.2,41.0,,16,7,9,16,5.10,44.0
3019,tt0306047,Scary Movie 3,2003,"250,000+",804574,15061,12846,17778,3.3,54.0,,129,45,84,129,4.80,35.0
3020,tt0237572,The Pledge,2001,"10,000+",22208,1888,1314,807,3.4,59.0,,125,97,28,125,6.90,78.0
3021,tt0286504,Beti No. 1,2000,Fewer than 50,12,3,1,1,,,,0,0,0,0,,
3022,tt1825813,Ikaw ang pag-ibig,2011,0,0,0,0,0,,,,0,0,0,0,,
3023,tt0858437,Ed Gein: The Butcher of Plainfield,2007,"2,500+",3226,71,260,199,2.3,21.0,,1,0,1,1,,
3024,tt1130080,The Informant!,2009,"250,000+",359325,7261,9281,5588,3,44.0,,231,184,47,231,6.80,80.0
3025,tt1094249,Hotel Chevalier,2007,"10,000+",10900,2288,753,697,3.8,75.0,,1,1,0,1,,
3026,tt0107665,Needful Things,1993,"10,000+",17122,555,708,495,3.1,44.0,,28,9,19,28,4.80,32.0
3027,tt0105271,Roja,1992,500+,585,131,19,21,4.2,87.0,,0,0,0,0,,
3028,tt1560139,Boy,2010,0,0,0,0,0,,,,0,0,0,0,,
3029,tt1906453,Sadgamaya,2010,0,0,0,0,0,,,,0,0,0,0,,
3030,tt0482163,Bats: Human Harvest,2007,250+,357,8,57,35,1.6,12.0,,1,0,1,1,,
3031,tt0337631,The Boys from County Clare,2003,"1,000+",1413,100,65,71,3.5,61.0,,27,13,14,27,6.10,48.0
3032,tt0890870,Saw IV,2007,"250,000+",569671,42933,26363,23995,3.5,62.0,,84,15,69,84,3.80,18.0
3033,tt0094793,Brain Damage,1988,"5,000+",5159,433,247,236,3.5,64.0,,15,10,5,15,6.20,67.0
3034,tt0231135,Amrutha Ghalige,1984,0,0,0,0,0,,,,0,0,0,0,,
3035,tt0109951,Guarding Tess,1994,"10,000+",19764,675,745,356,3.3,47.0,,34,19,15,34,5.70,56.0
3036,tt0104299,Freejack,1992,"10,000+",14327,252,740,283,2.6,25.0,,19,5,14,19,4.20,26.0
3037,tt0118541,8 Heads in a Duffel Bag,1997,"10,000+",21319,331,626,288,2.8,35.0,,20,2,18,20,4.00,10.0
3038,tt0423116,Sam's Lake,2006,250+,427,10,80,46,2.2,11.0,,3,1,2,3,,
3039,tt0073107,Hester Street,1975,500+,599,64,31,28,3.6,67.0,,29,23,6,29,7.40,79.0
3040,tt0491152,Something Borrowed,2011,"25,000+",43445,5661,6149,2399,3.2,48.0,,117,17,100,117,4.00,15.0
3041,tt0362204,Supari,2003,100+,146,3,3,0,2.8,50.0,,0,0,0,0,,
3042,tt0772173,Interkosmos,2006,250+,374,12,13,14,2.9,48.0,,0,0,0,0,,
3043,tt0273689,It's All About Love,2003,"1,000+",1319,93,249,88,2.5,27.0,,31,6,25,31,3.90,19.0
3044,tt0357110,The Ballad of Jack and Rose,2005,"5,000+",8343,961,598,563,3.5,61.0,,114,54,60,114,5.70,47.0
3045,tt0342804,My Flesh and Blood,2003,"1,000+",1401,209,16,91,4.3,93.0,,29,26,3,29,7.60,90.0
3046,tt0081520,Sir Henry at Rawlinson End,1980,500+,791,59,7,39,4.2,89.0,,2,1,1,2,,
3047,tt0075132,The Return of a Man Called Horse,1976,"1,000+",1739,26,33,21,3.2,43.0,,11,6,5,11,5.80,55.0
3048,tt0158371,Sweet and Lowdown,1999,"10,000+",13999,1980,448,514,3.8,82.0,,61,47,14,61,6.70,77.0
3049,tt0082970,Ragtime,1981,"2,500+",2983,297,92,119,3.8,76.0,,18,15,3,18,7.50,83.0
3050,tt0114436,Showgirls,1995,"50,000+",57036,1796,2997,2934,2.7,37.0,,66,15,51,66,3.90,23.0
3051,tt0107290,Jurassic Park,1993,"250,000+",1074005,82819,8027,38239,4.3,91.0,,141,129,12,141,8.50,91.0
3052,tt0451957,Urban Legends: Bloody Mary,2005,"10,000+",13767,344,680,445,2.8,34.0,,5,2,3,5,4.40,40.0
3053,tt0084117,If You Could See What I Hear,1982,250+,282,26,8,11,3.9,76.0,,2,0,2,2,,
3054,tt0488658,Unaccompanied Minors,2006,"25,000+",45520,1441,1261,1273,3.3,53.0,,91,27,64,91,4.60,30.0
3055,tt0273090,Arayannangalude Veedu,2000,0,0,0,0,0,,,,0,0,0,0,,
3056,tt0309926,Noorie,1979,100+,191,12,2,4,4,86.0,,0,0,0,0,,
3057,tt0473075,Prince of Persia: The Sands of Time,2010,"250,000+",437091,25315,18455,13538,3.4,58.0,,231,84,147,231,5.10,36.0
3058,tt0115531,American Strays,1996,"1,000+",2327,17,10,6,3.5,63.0,,0,0,0,0,,
3059,tt0496350,The Marsh,2006,"1,000+",2388,120,258,190,2.8,32.0,,4,0,4,4,,
3060,tt0105128,Pet Sematary II,1992,"25,000+",38658,530,1196,716,2.7,31.0,,24,5,19,24,3.70,21.0
3061,tt0082418,Friday the 13th Part 2,1981,"50,000+",68801,3373,3612,2214,3.3,48.0,,47,15,32,47,4.60,32.0
3062,tt0082816,The Night the Lights Went Out in Georgia,1981,500+,828,56,18,20,4,76.0,,1,1,0,1,,
3063,tt0214673,Ente Sooryaputhrikku,1991,0,0,0,0,0,,,,0,0,0,0,,
3064,tt0213890,Mohabbatein,2000,"5,000+",8129,818,206,328,4.1,80.0,,1,1,0,1,,
3065,tt1430615,Big Miracle,2012,"25,000+",38953,4536,2534,835,3.6,64.0,,105,78,27,105,6.20,74.0
3066,tt0244055,The Man in the Back Seat,1961,0,0,0,0,0,,,,0,0,0,0,,
3067,tt0368008,The Manchurian Candidate,2004,"50,000+",68509,5404,3196,2586,3.5,63.0,,210,167,43,210,7.10,80.0
3068,tt1620719,Dabangg,2010,"1,000+",1991,497,322,257,3.5,61.0,,5,3,2,5,6.00,60.0
3069,tt0874854,Anjaane: The Unknown,2005,0,0,0,0,0,,,,0,0,0,0,,
3070,tt0304023,Flower & Garnet,2002,250+,449,37,7,22,3.8,84.0,,6,4,2,6,6.50,67.0
3071,tt0351283,Madagascar,2005,"50,000+",65506,43537,21969,29778,3.6,66.0,,192,106,86,192,6.10,55.0
3072,tt0119365,Incognito,1997,0,0,0,0,0,,,,0,0,0,0,,
3073,tt0097257,Earth Girls Are Easy,1988,"25,000+",41067,1095,1476,1002,3.1,43.0,,37,25,12,37,5.50,68.0
3074,tt0203933,The Soul Collector,1999,100+,231,6,3,1,4.1,67.0,,0,0,0,0,,
3075,tt1424381,Predators,2010,"100,000+",160307,16027,14888,10121,3.3,52.0,,203,131,72,203,5.80,65.0
3076,tt0430735,Vesham,2004,0,0,0,0,0,,,,0,0,0,0,,
3077,tt0054115,Never Let Go,1960,250+,314,21,14,12,3.5,60.0,,2,1,1,2,,
3078,tt0902967,The Crimson Wing: Mystery of the Flamingos,2008,250+,399,113,39,45,3.8,74.0,,20,15,5,20,6.50,75.0
3079,tt0103060,Teenage Mutant Ninja Turtles II: The Secret of the Ooze,1991,"100,000+",192129,7159,3553,5084,3.7,67.0,,42,15,27,42,4.70,36.0
3080,tt0075950,The Domino Principle,1977,100+,165,9,36,17,2.7,20.0,,7,1,6,7,4.10,14.0
3081,tt0094597,976-EVIL,1988,"5,000+",9232,113,293,218,2.6,28.0,,13,2,11,13,2.80,15.0
3082,tt0302436,To Kill a King,2003,500+,968,117,119,101,3.2,50.0,,5,3,2,5,5.70,60.0
3083,tt1571243,Sniper: Reloaded,2011,500+,653,115,222,73,2.8,34.0,,0,0,0,0,,
3084,tt1212450,Lawless,2012,"100,000+",108375,24782,8502,4095,3.8,74.0,,221,148,73,221,6.50,67.0
3085,tt2078644,Indian Rupee,2011,Fewer than 50,14,5,3,1,3.8,62.0,,0,0,0,0,,
3086,tt1260995,Meteor,2009,100+,174,14,46,15,2.2,23.0,,2,0,2,2,,
3087,tt0075222,Silent Movie,1976,"10,000+",13264,1177,459,489,3.7,72.0,,28,23,5,28,7.00,82.0
3088,tt0079098,Ek Din Pratidin,1979,0,0,0,0,0,,,,0,0,0,0,,
3089,tt0104201,Equinox,1992,"1,000+",1321,56,79,83,2.9,41.0,,9,3,6,9,5.00,33.0
3090,tt1533084,The Traveler,2010,500+,681,65,353,146,2,16.0,,4,0,4,4,,
3091,tt0417686,Forest of the Damned,2005,500+,655,8,54,34,2,13.0,,1,0,1,1,,
3092,tt0369036,Udhaya,2004,0,0,0,0,0,,,,0,0,0,0,,
3093,tt0278413,Distance,2001,250+,435,69,22,16,3.6,76.0,,5,4,1,5,6.30,80.0
3094,tt1483820,Aadhavan,2009,100+,246,30,34,24,3.2,47.0,,0,0,0,0,,
3095,tt0114615,Taqdeerwala,1995,0,0,0,0,0,,,,0,0,0,0,,
3096,tt0082402,Fort Apache the Bronx,1981,"5,000+",5672,193,100,75,3.6,66.0,,15,12,3,15,6.60,80.0
3097,tt0316732,Taxi,2004,"100,000+",183884,2278,3002,3462,3,43.0,,106,10,96,106,3.50,9.0
3098,tt0490172,Mahasamudram,2006,0,0,0,0,0,,,,0,0,0,0,,
3099,tt0106864,A Family Torn Apart,1993,250+,325,19,15,7,3.4,56.0,,0,0,0,0,,
3100,tt0116517,Her Costly Affair,1996,0,0,0,0,0,,,,0,0,0,0,,
3101,tt0090357,Young Sherlock Holmes,1985,"10,000+",11311,956,564,414,3.5,63.0,,23,15,8,23,5.70,65.0
3102,tt0092675,Bloodsport,1988,"50,000+",68682,5120,1770,2864,3.9,74.0,,28,13,15,28,5.10,46.0
3103,tt1507378,Two Shadows,2012,0,0,0,0,0,,,,0,0,0,0,,
3104,tt0056993,Diary of a Madman,1963,"1,000+",1366,63,53,43,3.5,54.0,,3,2,1,3,,
3105,tt0082562,Innamorato pazzo,1981,0,0,0,0,0,,,,0,0,0,0,,
3106,tt1456957,Hareendran Oru Nishkalankan?,2007,0,0,0,0,0,,,,0,0,0,0,,
3107,tt0267675,The Life & Adventures of Santa Claus,2000,100+,246,14,4,3,3.9,78.0,,0,0,0,0,,
3108,tt0804461,Death Sentence,2007,"50,000+",97656,8728,5722,7098,3.4,60.0,,114,23,91,114,4.20,20.0
3109,tt0066448,There Was a Crooked Man...,1970,250+,494,90,34,34,3.6,73.0,,11,9,2,11,7.00,82.0
3110,tt0158423,NetForce,1999,"1,000+",1385,12,24,14,2.9,33.0,,1,0,1,1,,
3111,tt1671456,Dhrona 2010,2010,0,0,0,0,0,,,,0,0,0,0,,
3112,tt0238380,Equilibrium,2002,"250,000+",268444,38105,8771,18172,4,81.0,,90,36,54,90,4.90,40.0
3113,tt0892391,The Meerkats,2008,500+,504,101,26,39,3.9,80.0,,11,8,3,11,5.90,73.0
3114,tt1176957,In the Crease,2006,Fewer than 50,42,5,0,1,4.4,100.0,,0,0,0,0,,
3115,tt0902348,The Waiting Room,2007,250+,350,57,44,41,3.2,56.0,,5,3,2,5,5.40,60.0
3116,tt0102318,A Little Piece of Heaven,1991,50+,59,2,5,3,2.1,29.0,,0,0,0,0,,
3117,tt0103919,Candyman,1992,"100,000+",134740,3924,2320,3018,3.5,63.0,,82,65,17,82,6.60,79.0
3118,tt0110322,Legends of the Fall,1994,"100,000+",184532,17199,2636,6569,4.2,87.0,,58,34,24,58,5.90,59.0
3119,tt0472205,Watching the Detectives,2007,"25,000+",32092,368,323,308,3.3,53.0,,2,0,2,2,,
3120,tt1454718,Heliopolis,2009,50+,74,12,25,7,2.8,32.0,,0,0,0,0,,
3121,tt0083624,Basket Case,1982,"10,000+",11652,839,716,612,3.3,54.0,,26,20,6,26,6.30,77.0
3122,tt0076023,Fight for Your Life,1977,"1,000+",1661,77,69,84,3.2,52.0,,3,0,3,3,,
3123,tt0091225,Howard the Duck,1986,"50,000+",55731,2121,3456,2672,2.8,38.0,,83,11,72,83,3.80,13.0
3124,tt0361746,Inaam Dus Hazaar,1987,0,0,0,0,0,,,,0,0,0,0,,
3125,tt0948470,The Amazing Spider-Man,2012,"250,000+",818068,123339,37388,22321,3.9,77.0,,339,240,99,339,6.60,71.0
3126,tt5334704,Twin Peaks: The Missing Pieces,2014,Fewer than 50,42,35,4,1,4.2,90.0,,0,0,0,0,,
3127,tt0097940,Mystery Train,1989,"10,000+",10627,2205,340,514,4,87.0,,36,32,4,36,7.30,89.0
3128,tt0064757,On Her Majesty's Secret Service,1969,"50,000+",51744,5151,2846,2938,3.5,64.0,,58,47,11,58,6.90,81.0
3129,tt1027812,Fog Warning,2008,0,0,0,0,0,,,,0,0,0,0,,
3130,tt3399998,The Address,2014,Fewer than 50,12,6,4,1,3.3,60.0,,4,4,0,4,,
3131,tt0076141,High Anxiety,1977,"10,000+",15316,1530,750,731,3.6,67.0,,31,23,8,31,6.60,74.0
3132,tt0118925,"Dancer, Texas Pop. 81",1998,"1,000+",1695,119,48,47,3.6,71.0,,15,12,3,15,6.60,80.0
3133,tt0269095,City by the Sea,2002,"10,000+",16090,632,944,350,3.1,40.0,,143,69,74,143,5.80,48.0
3134,tt0433482,Wild Country,2005,250+,464,4,40,28,2.2,9.0,,0,0,0,0,,
3135,tt0363282,New York Minute,2004,"50,000+",84071,2458,2751,2299,3.1,47.0,,118,13,105,118,3.80,11.0
3136,tt0486597,The Hunt for Eagle One,2006,"10,000+",14702,19,93,48,2.1,17.0,,0,0,0,0,,
3137,tt0457452,The Reception,2005,100+,233,3,7,5,2.8,30.0,,22,15,7,22,5.90,68.0
3138,tt0454788,Bloodshed,2005,50+,80,0,6,2,1.2,0.0,,0,0,0,0,,
3139,tt1669582,Do Re Mi Fa So La Si Do,2008,250+,386,66,31,50,3.6,68.0,,0,0,0,0,,
3140,tt0120112,She's So Lovely,1997,"5,000+",5807,385,240,141,3.5,61.0,,41,27,14,41,6.10,66.0
3141,tt1295072,The Trotsky,2009,"1,000+",1972,692,292,291,3.6,70.0,,14,11,3,14,6.90,79.0
3142,tt0374853,Malice in Wonderland,2009,500+,898,184,195,123,3.1,49.0,,10,1,9,10,4.00,10.0
3143,tt0242981,Un aller simple,2001,0,0,0,0,0,,,,0,0,0,0,,
3144,tt0406304,Undercover Kids,2004,50+,90,2,1,2,,,,0,0,0,0,,
3145,tt0096769,After Midnight,1989,250+,419,22,53,28,2.8,29.0,,3,1,2,3,,
3146,tt0091766,Playing Beatie Bow,1986,100+,120,10,10,5,3.3,50.0,,1,1,0,1,,
3147,tt0424055,Drowned Out,2002,0,0,0,0,0,,,,1,1,0,1,,
3148,tt0098237,The Ryan White Story,1989,Fewer than 50,28,12,6,1,3.7,67.0,,0,0,0,0,,
3149,tt0309778,Kony,1984,0,0,0,0,0,,,,0,0,0,0,,
3150,tt0054049,Make Mine Mink,1960,100+,184,22,15,10,3.6,59.0,,2,1,1,2,,
3151,tt0059237,Gonks Go Beat,1964,Fewer than 50,43,2,2,6,,,,0,0,0,0,,
3152,tt0459566,Thotti Jaya,2005,0,0,0,0,0,,,,0,0,0,0,,
3153,tt0074263,Caddie,1976,Fewer than 50,16,4,5,3,3.4,44.0,,3,1,2,3,,
3154,tt1029097,Anna's Storm,2007,Fewer than 50,1,1,0,0,,,,0,0,0,0,,
3155,tt0082958,The Pursuit of D.B. Cooper,1981,50+,58,5,19,9,2.9,21.0,,2,2,0,2,,
3156,tt0088960,Creator,1985,"1,000+",1494,135,44,76,3.9,75.0,,13,5,8,13,5.00,38.0
3157,tt1261978,Wrong Turn 3: Left for Dead,2009,"25,000+",31121,493,1602,747,2.4,24.0,,5,0,5,5,2.50,0.0
3158,tt1326954,Oh My God,2009,0,0,0,0,0,,,,0,0,0,0,,
3159,tt0096018,Running on Empty,1988,"10,000+",10490,1925,874,449,3.7,69.0,,31,25,6,31,6.70,81.0
3160,tt0367153,Toolbox Murders,2004,"5,000+",8222,228,467,315,2.8,33.0,,14,7,7,14,5.90,50.0
3161,tt0402014,Ab Tak Chhappan,2004,500+,794,129,12,39,4.1,91.0,,0,0,0,0,,
3162,tt0303714,Barbershop,2002,"50,000+",55630,2200,1330,857,3.5,62.0,,125,103,22,125,6.60,82.0
3163,tt0489554,Scary Godmother: The Revenge of Jimmy,2005,50+,60,42,18,9,4,70.0,,0,0,0,0,,
3164,tt0372588,Team America: World Police,2004,"250,000+",403100,25989,6505,19168,3.9,80.0,,199,153,46,199,7.00,77.0
3165,tt0120483,The Man Who Knew Too Little,1997,"25,000+",34534,2126,954,1175,3.7,69.0,,38,14,24,38,5.30,37.0
3166,tt0093879,The Room Upstairs,1987,50+,84,0,1,0,,,,0,0,0,0,,
3167,tt0086886,American Dreamer,1984,"2,500+",3350,127,27,66,4.2,83.0,,6,1,5,6,4.30,17.0
3168,tt0371246,Spanglish,2004,"100,000+",201074,7174,4808,5798,3.4,60.0,,168,90,78,168,6.00,54.0
3169,tt0420332,Veer-Zaara,2004,"10,000+",16225,1995,273,787,4.3,88.0,,15,14,1,15,7.60,93.0
3170,tt0061020,The Spy in the Green Hat,1967,Fewer than 50,1,1,0,0,,,,0,0,0,0,,
3171,tt1122775,Rosencrantz and Guildenstern Are Undead,2009,"2,500+",3606,56,106,51,2.8,35.0,,15,6,9,15,5.10,40.0
3172,tt0131349,Darkness Falls,1999,100+,201,10,9,2,3.3,53.0,,0,0,0,0,,
3173,tt0289765,Red Dragon,2002,"250,000+",275878,17873,6175,8244,3.7,74.0,,191,131,60,191,6.40,69.0
3174,tt0422934,Perazhagan,2004,100+,151,5,1,0,3.8,83.0,,0,0,0,0,,
3175,tt0056870,Bitter Harvest,1963,Fewer than 50,12,1,2,1,,,,0,0,0,0,,
3176,tt0327698,The Even Stevens Movie,2003,"10,000+",22614,785,720,457,3.3,52.0,,6,3,3,6,5.60,50.0
3177,tt0419434,American Hardcore,2006,"25,000+",34892,1029,294,622,3.9,78.0,,60,43,17,60,6.40,72.0
3178,tt0119557,The Locusts,1997,"1,000+",1068,38,44,27,3.1,46.0,,10,2,8,10,5.60,20.0
3179,tt0341564,Scarecrow,2002,"1,000+",1585,20,101,66,2.1,17.0,,0,0,0,0,,
3180,tt1464607,Yuddha,2005,0,0,0,0,0,,,,0,0,0,0,,
3181,tt0074486,Eraserhead,1977,"50,000+",57785,11345,2444,4742,4.1,82.0,,66,59,7,66,8.40,89.0
3182,tt0392950,Ishq Hai Tumse,2004,0,0,0,0,0,,,,0,0,0,0,,
3183,tt0312278,Skinwalkers,2002,500+,995,54,20,40,3.8,73.0,,2,1,1,2,,
3184,tt0435719,Cool Money,2005,"1,000+",1113,45,22,37,3.7,67.0,,0,0,0,0,,
3185,tt0120479,Warriors of Virtue,1997,"5,000+",5741,201,228,210,3.1,47.0,,11,2,9,11,4.40,18.0
3186,tt1564585,Skyline,2010,"50,000+",67355,3429,15790,7093,2.1,18.0,,86,13,73,86,3.60,15.0
3187,tt0368323,Ang tanging ina,2003,250+,267,17,7,7,3.5,71.0,,0,0,0,0,,
3188,tt0101005,Zapped Again!,1990,"1,000+",1397,16,49,24,2.5,25.0,,5,0,5,5,2.80,0.0
3189,tt0096976,Breaking In,1989,"1,000+",1312,31,43,14,3.2,42.0,,10,8,2,10,7.50,80.0
3190,tt0094933,D.O.A.,1988,"5,000+",7135,112,268,105,2.9,29.0,,21,13,8,21,5.10,62.0
3191,tt0076527,Parvarish,1977,0,0,0,0,0,,,,0,0,0,0,,
3192,tt0252299,Buffalo Soldiers,2001,"10,000+",15693,1260,494,548,3.7,72.0,,114,83,31,114,6.50,73.0
3193,tt0322259,2 Fast 2 Furious,2003,"250,000+",32791717,46415,46397,1175569,3.1,50.0,,161,59,102,161,4.80,37.0
3194,tt0395434,Aafat,1977,0,0,0,0,0,,,,0,0,0,0,,
3195,tt0396961,Not Only Mrs. Raut,2003,0,0,0,0,0,,,,0,0,0,0,,
3196,tt0155996,Radha Kalyanam,1981,0,0,0,0,0,,,,0,0,0,0,,
3197,tt0439754,Pyaar Mein Twist,2005,100+,190,3,8,4,2.7,27.0,,0,0,0,0,,
3198,tt1687905,The Economics of Happiness,2011,Fewer than 50,23,9,0,1,4.4,100.0,,0,0,0,0,,
3199,tt0069765,Bang the Drum Slowly,1973,"2,500+",3809,271,161,136,3.5,63.0,,39,35,4,39,7.40,90.0
3200,tt1411664,Bucky Larson: Born to Be a Star,2011,"10,000+",13050,765,2252,619,2.2,25.0,,36,1,35,36,2.30,3.0
3201,tt0308772,Pure,2002,50+,51,1,1,1,,,,0,0,0,0,,
3202,tt1807950,Ask Tesadüfleri Sever,2011,100+,184,87,36,14,3.8,71.0,,0,0,0,0,,
3203,tt1151309,Bigger Stronger Faster*,2008,"100,000+",106410,2153,520,944,3.9,81.0,,76,73,3,76,7.70,96.0
3204,tt0064893,Ring of Bright Water,1969,"1,000+",1959,125,21,82,4.1,86.0,,5,4,1,5,7.00,80.0
3205,tt0245844,The Count of Monte Cristo,2002,"100,000+",209581,17495,2441,8322,4.2,88.0,,143,105,38,143,6.70,73.0
3206,tt0088414,The Woman in Red,1984,"5,000+",8687,253,411,168,3,38.0,,19,6,13,19,4.30,32.0
3207,tt0463959,Desolation Canyon,2006,Fewer than 50,36,0,6,1,2.3,0.0,,0,0,0,0,,
3208,tt0376006,Book of Love,2004,"1,000+",1313,47,72,45,2.9,39.0,,4,1,3,4,,
3209,tt0814373,UnCivil Liberties,2006,0,0,0,0,0,,,,0,0,0,0,,
3210,tt0376006,Book of Love,2004,"1,000+",1313,47,72,45,2.9,39.0,,4,1,3,4,,
3211,tt0249164,Srivaariki Premalekha,1984,0,0,0,0,0,,,,0,0,0,0,,
3212,tt0089750,The Other Lover,1985,100+,136,3,1,1,,,,0,0,0,0,,
3213,tt0348088,Spirit Warriors: The Shortcut,2003,0,0,0,0,0,,,,0,0,0,0,,
3214,tt0288192,Return to Innocence,2001,500+,611,7,2,3,3.6,78.0,,0,0,0,0,,
3215,tt0096166,Stars and Bars,1988,250+,286,8,11,3,3.1,42.0,,2,1,1,2,,
3216,tt0404827,Bombay Dreams,2004,50+,66,2,8,4,2.6,20.0,,0,0,0,0,,
3217,tt0314498,The Perfect Score,2004,"50,000+",50795,1560,2025,1260,3.1,44.0,,109,17,92,109,3.80,16.0
3218,tt1767319,In the Name of the King: Two Worlds,2011,250+,287,27,137,35,2.1,16.0,,3,0,3,3,,
3219,tt1575660,Premaku Velaayera,1999,0,0,0,0,0,,,,0,0,0,0,,
3220,tt0056671,Walk on the Wild Side,1962,"1,000+",1247,48,33,33,3.4,59.0,,6,4,2,6,6.10,67.0
3221,tt0161109,The Young Girl and the Monsoon,1999,250+,363,3,4,8,3.4,43.0,,19,10,9,19,5.10,53.0
3222,tt0172669,Komodo,1999,"2,500+",3259,31,125,59,2.4,20.0,,3,0,3,3,,
3223,tt0120338,Titanic,1997,"250,000+",35797635,295888,130124,2889107,3.3,69.0,,254,223,31,254,8.10,88.0
3224,tt1618430,Dum Maaro Dum,2011,500+,636,102,133,73,3,43.0,,6,3,3,6,5.00,50.0
3225,tt0172586,Imagine,1972,0,0,0,0,0,,,,0,0,0,0,,
3226,tt0109642,Dolores Claiborne,1995,"25,000+",30344,2142,482,865,3.9,82.0,,48,41,7,48,6.90,85.0
3227,tt0060186,"Boy, Did I Get a Wrong Number!",1966,100+,119,12,16,13,3.2,43.0,,1,0,1,1,,
3228,tt0978702,Sankranthi,2005,Fewer than 50,16,1,2,0,,,,0,0,0,0,,
3229,tt1525835,Gantz,2010,500+,962,363,261,194,3.3,58.0,,2,1,1,2,,
3230,tt0071269,California Split,1974,"2,500+",2944,374,77,116,3.9,83.0,,30,26,4,30,7.50,87.0
3231,tt0112346,The American President,1995,"50,000+",55172,4400,1313,1901,3.9,77.0,,56,51,5,56,7.00,91.0
3232,tt1301308,Mixed Kebab,2012,Fewer than 50,46,14,27,7,3,34.0,,0,0,0,0,,
3233,tt0055423,The Secret Ways,1961,Fewer than 50,1,0,1,0,,,,0,0,0,0,,
3234,tt0069736,Ash Wednesday,1973,250+,278,3,10,4,2.2,23.0,,11,1,10,11,3.40,9.0
3235,tt0166280,My Dog Vincent,1997,Fewer than 50,40,0,1,1,,,,0,0,0,0,,
3236,tt1381404,The Company You Keep,2012,"10,000+",13575,1803,2197,524,3.2,45.0,,122,66,56,122,6.10,54.0
3237,tt0109303,Blown Away,1994,"25,000+",31924,648,966,469,3.1,40.0,,23,9,14,23,5.20,39.0
3238,tt0831299,I Really Hate My Job,2007,500+,624,42,135,95,2.4,23.0,,3,0,3,3,,
3239,tt0109303,Blown Away,1994,"25,000+",31924,648,966,469,3.1,40.0,,23,9,14,23,5.20,39.0
3240,tt0488539,Farce of the Penguins,2006,"10,000+",12944,596,1087,1017,2.7,35.0,,4,0,4,4,,
3241,tt0113211,The Grass Harp,1995,"1,000+",1452,490,34,46,4.8,94.0,,14,7,7,14,5.90,50.0
3242,tt1504320,The King's Speech,2010,"100,000+",144906,60568,5444,14934,4.3,92.0,,305,288,17,305,8.60,94.0
3243,tt0160429,The King and I,1999,"10,000+",20115,212,309,271,2.9,41.0,,24,3,21,24,3.80,13.0
3244,tt0107065,Gypsy,1993,"2,500+",4583,204,65,116,3.9,76.0,,8,5,3,8,6.20,63.0
3245,tt0486420,Love's Long Journey,2005,"5,000+",8246,764,122,291,4.3,86.0,,0,0,0,0,,
3246,tt1245104,Presto,2008,"2,500+",3577,614,55,221,4.3,92.0,,1,1,0,1,,
3247,tt0087359,"Grandview, U.S.A.",1984,"1,000+",1745,41,65,23,3.2,39.0,,3,0,3,3,,
3248,tt0082045,Banana Joe,1982,250+,416,64,48,9,3.4,57.0,,0,0,0,0,,
3249,tt0065616,A Day at the Beach,1970,Fewer than 50,14,4,1,0,3.3,80.0,,2,1,1,2,,
3250,tt0328007,K-9: P.I.,2002,"5,000+",7627,80,139,75,3.1,37.0,,5,0,5,5,4.20,0.0
3251,tt0348691,Nuvve Kavali,2000,0,0,0,0,0,,,,0,0,0,0,,
3252,tt1596343,Fast Five,2011,"100,000+",140392,48302,9980,11954,4.1,83.0,,208,162,46,208,6.40,78.0
3253,tt0101635,Curly Sue,1991,"25,000+",49694,880,876,684,3.3,50.0,,15,2,13,15,3.70,13.0
3254,tt0093075,The Gate,1987,"5,000+",9408,582,717,485,3.2,45.0,,10,5,5,10,5.50,50.0
3255,tt0092205,Where the River Runs Black,1986,50+,85,13,0,1,4.6,100.0,,5,3,2,5,6.50,60.0
3256,tt2292817,My Kontrabida Girl,2012,0,0,0,0,0,,,,0,0,0,0,,
3257,tt1423592,Kinatay,2009,250+,285,62,34,31,3.4,65.0,,8,6,2,8,6.10,75.0
3258,tt0091913,Second Serve,1986,Fewer than 50,9,3,0,1,,,,2,1,1,2,,
3259,tt1456635,Goon,2011,"10,000+",22883,9889,4111,2147,3.7,71.0,,106,86,20,106,6.60,81.0
3260,tt0120184,Sphere,1998,"50,000+",58619,2148,3440,1893,2.9,38.0,,55,7,48,55,4.00,13.0
3261,tt0101587,City Slickers,1991,"100,000+",161207,3634,2005,1851,3.5,64.0,,44,39,5,44,7.10,89.0
3262,tt0238660,There's Only One Jimmy Grimble,2000,"2,500+",3653,210,72,135,4,74.0,,7,5,2,7,6.90,71.0
3263,tt0930072,Beyond Loch Ness,2008,250+,446,21,133,84,2.2,14.0,,0,0,0,0,,
3264,tt0100608,The Shrimp on the Barbie,1990,500+,926,43,64,32,3.1,40.0,,0,0,0,0,,
3265,tt1617049,Chennai Kadhal,2006,50+,69,0,3,1,,,,0,0,0,0,,
3266,tt0056162,Lad: A Dog,1962,100+,116,3,0,0,,,,0,0,0,0,,
3267,tt1398941,Superman/Batman: Public Enemies,2009,"2,500+",3278,1132,569,469,3.7,67.0,,4,1,3,4,,
3268,tt0179116,But I'm a Cheerleader,1999,"25,000+",41103,3822,1310,1853,3.9,75.0,,90,38,52,90,5.20,42.0
3269,tt0409724,Bardaasht,2004,100+,107,4,9,3,2.6,31.0,,0,0,0,0,,
3270,tt0099459,Down the Drain,1990,Fewer than 50,33,0,2,0,,,,0,0,0,0,,
3271,tt0120859,Telling You,1998,"1,000+",1335,9,37,11,2.4,20.0,,5,1,4,5,5.60,20.0
3272,tt0472071,Death Defying Acts,2007,"2,500+",4390,338,954,517,2.8,26.0,,38,16,22,38,5.00,42.0
3273,tt0087727,Missing in Action,1984,"10,000+",12368,429,572,329,3.1,43.0,,16,3,13,16,4.20,19.0
3274,tt0482571,The Prestige,2006,"250,000+",552653,104237,9001,43669,4.3,92.0,,206,158,48,206,7.10,77.0
3275,tt0282171,Slap Shot 2: Breaking the Ice,2002,"5,000+",6630,141,253,156,2.7,36.0,,5,0,5,5,3.60,0.0
3276,tt0250310,Corky Romano,2001,"25,000+",47205,899,1404,1010,2.8,39.0,,84,6,78,84,3.00,7.0
3277,tt0081178,The Monster Club,1981,250+,338,48,77,50,3.1,38.0,,7,5,2,7,5.70,71.0
3278,tt0452624,The Good German,2006,"25,000+",36707,1570,3133,2184,2.9,33.0,,153,52,101,153,5.10,34.0
3279,tt0110678,No Escape,1994,"5,000+",9712,376,537,238,3.1,41.0,,21,12,9,21,5.30,57.0
3280,tt1188113,Peacock,2010,"2,500+",2727,577,625,366,3.2,48.0,,4,4,0,4,,
3281,tt0304971,Ziggy's Gift,1982,500+,988,36,5,13,4.3,88.0,,0,0,0,0,,
3282,tt0099790,Honeymoon Academy,1989,50+,54,0,9,3,2.1,0.0,,0,0,0,0,,
3283,tt0156666,Kalathur Kannamma,1960,0,0,0,0,0,,,,0,0,0,0,,
3284,tt0063607,Single Room Furnished,1966,100+,185,9,13,8,2.9,41.0,,0,0,0,0,,
3285,tt1347280,Pendragon: Sword of His Father,2008,50+,67,10,17,12,2.6,37.0,,0,0,0,0,,
3286,tt0103955,Child of Rage,1992,100+,124,9,14,5,2.9,39.0,,0,0,0,0,,
3287,tt0073760,The Strongest Man in the World,1975,"2,500+",2970,74,116,64,3.1,39.0,,1,0,1,1,,
3288,tt0327056,Mystic River,2003,"100,000+",204005,24610,2995,7594,4.1,89.0,,204,181,23,204,7.80,89.0
3289,tt0126604,Pecker,1998,"10,000+",15725,1136,626,515,3.6,64.0,,46,24,22,46,5.90,52.0
3290,tt1286811,Kanchivaram,2008,50+,75,23,5,9,3.9,82.0,,0,0,0,0,,
3291,tt0382357,Land of Plenty,2004,"1,000+",2255,238,145,103,3.5,62.0,,27,17,10,27,6.10,63.0
3292,tt1899287,Shakespeare M.A. Malayalam,2008,50+,59,0,2,1,,,,0,0,0,0,,
3293,tt0814075,Deliver Us from Evil,2006,250+,270,66,41,40,3.4,61.0,,5,4,1,5,7.00,80.0
3294,tt0260320,Repli-Kate,2002,"1,000+",2172,83,92,73,3.2,47.0,,0,0,0,0,,
3295,tt0978570,Bhageeratha,2005,0,0,0,0,0,,,,0,0,0,0,,
3296,tt0365914,A Way of Life,2004,500+,602,55,19,33,3.6,75.0,,7,6,1,7,6.70,86.0
3297,tt0401729,John Carter,2012,"100,000+",115105,25494,17242,8581,3.5,60.0,,239,124,115,239,5.80,52.0
3298,tt0120838,Sour Grapes,1998,"1,000+",1923,88,152,95,2.9,37.0,,15,4,11,15,5.10,27.0
3299,tt12089310,Raajjiyam,2002,0,0,0,0,0,,,,0,0,0,0,,
3300,tt0124179,Two Girls and a Guy,1997,"5,000+",7179,220,317,181,3,41.0,,62,31,31,62,5.70,50.0
3301,tt0102048,Homicide,1991,250+,292,129,50,31,3.6,72.0,,25,22,3,25,7.60,88.0
3302,tt0844319,Kaidan,2007,250+,331,32,56,31,3,36.0,,0,0,0,0,,
3303,tt13612770,Maasilamani,2009,Fewer than 50,2,0,1,0,,,,0,0,0,0,,
3304,tt1422020,Dog Pound,2010,"1,000+",1950,633,283,220,3.6,69.0,,27,17,10,27,6.20,63.0
3305,tt0110948,Raw Justice,1994,250+,451,10,41,16,2.2,20.0,,1,1,0,1,,
3306,tt1594562,The Innkeepers,2011,"50,000+",93151,3434,4797,1448,3,42.0,,121,97,24,121,6.70,80.0
3307,tt0094737,Big,1988,"250,000+",402325,18822,4127,9818,3.9,82.0,,80,78,2,80,7.90,98.0
3308,tt0173840,Final Fantasy: The Spirits Within,2001,"100,000+",141726,3960,4301,4616,3.2,48.0,,144,63,81,144,5.20,44.0
3309,tt2241367,Njanum Ente Familiyum,2012,0,0,0,0,0,,,,0,0,0,0,,
3310,tt0088879,Il camorrista,1986,50+,97,19,10,5,3.5,66.0,,2,2,0,2,,
3311,tt0110022,The Hidden II,1993,100+,132,4,20,8,2,17.0,,3,0,3,3,,
3312,tt0228750,Proof of Life,2000,"25,000+",47210,1375,1810,755,3.1,43.0,,118,46,72,118,5.40,39.0
3313,tt0279889,Joe Somebody,2001,"25,000+",31317,301,794,319,2.6,27.0,,86,18,68,86,4.20,21.0
3314,tt0091383,The Last Days of Patton,1986,500+,578,40,20,19,3.4,67.0,,0,0,0,0,,
3315,tt0091178,Haunted Honeymoon,1986,"5,000+",7655,378,331,280,3.4,53.0,,11,2,9,11,3.60,18.0
3316,tt1558250,GasLand,2010,"5,000+",8476,1525,269,485,4,85.0,,41,40,1,41,7.00,98.0
3317,tt0104293,Four Eyes and Six-Guns,1992,50+,62,1,8,2,2.8,11.0,,1,0,1,1,,
3318,tt0117496,Robinson Crusoe,1997,"5,000+",6974,157,241,102,3,39.0,,3,1,2,3,,
3319,tt0081505,The Shining,1980,"250,000+",483708,80087,6246,28519,4.4,93.0,,105,87,18,105,8.60,83.0
3320,tt0481400,Afghan Muscles,2006,Fewer than 50,7,0,1,0,,,,0,0,0,0,,
3321,tt2040257,A Buddy Story,2010,Fewer than 50,34,8,8,5,3.3,50.0,,0,0,0,0,,
3322,tt0756725,Where God Left His Shoes,2007,250+,437,93,38,57,3.7,71.0,,12,8,4,12,6.50,67.0
3323,tt0770203,Rasathanthram,2006,Fewer than 50,2,1,1,0,,,,0,0,0,0,,
3324,tt0088818,Blastfighter,1984,250+,294,19,16,7,3.3,54.0,,3,3,0,3,,
3325,tt1448755,Killer Elite,2011,"25,000+",32498,5239,7200,2195,3.1,42.0,,127,35,92,127,4.70,28.0
3326,tt0898943,Raqeeb,2007,0,0,0,0,0,,,,0,0,0,0,,
3327,tt1155076,The Karate Kid,2010,"250,000+",283411,27076,13501,11678,3.6,67.0,,211,139,72,211,6.20,66.0
3328,tt0067345,The Light at the Edge of the World,1971,0,0,0,0,0,,,,3,2,1,3,,
3329,tt0132563,To Walk with Lions,1999,"1,000+",1377,47,14,25,3.9,77.0,,4,2,2,4,,
3330,tt0108265,Swing Kids,1993,"25,000+",27963,2328,633,1080,4,79.0,,18,10,8,18,4.90,56.0
3331,tt0057227,Kissin' Cousins,1964,"2,500+",2519,59,75,70,3.2,44.0,,1,1,0,1,,
3332,tt0107979,Robot Wars,1993,500+,713,18,50,36,2.6,26.0,,0,0,0,0,,
3333,tt0486822,Disturbia,2007,"250,000+",1452823,96646,28489,67263,3.9,77.0,,178,124,54,178,6.30,70.0
3334,tt0413895,Charlotte's Web,2006,"250,000+",380047,6110,3690,7144,3.6,62.0,,148,117,31,148,7.00,79.0
3335,tt0219965,Bandits,2001,"50,000+",58883,2707,1990,1369,3.4,58.0,,135,86,49,135,6.10,64.0
3336,tt0117103,Mrs. Santa Claus,1996,"2,500+",4002,66,43,62,3.6,61.0,,0,0,0,0,,
3337,tt0068763,The Jerusalem File,1972,0,0,0,0,0,,,,0,0,0,0,,
3338,tt0061477,Chuka,1967,"1,000+",1048,2,8,2,2.8,20.0,,2,1,1,2,,
3339,tt0076070,The Gauntlet,1977,"5,000+",9427,669,575,352,3.3,54.0,,28,21,7,28,6.00,75.0
3340,tt0369452,Geometria,1987,Fewer than 50,2,1,1,1,,,,0,0,0,0,,
3341,tt0082406,The Fox and the Hound,1981,"250,000+",313550,10371,2952,9778,4,78.0,,28,21,7,28,6.50,75.0
3342,tt0123965,Life Classes,1988,100+,174,3,2,3,3.7,60.0,,0,0,0,0,,
3343,tt1366344,The Sitter,2011,"25,000+",40810,6354,9864,2087,3,39.0,,112,24,88,112,4.30,21.0
3344,tt0072026,Prem Nagar,1974,0,0,0,0,0,,,,0,0,0,0,,
3345,tt1023111,Never Back Down,2008,"250,000+",609842,24990,47472,7359,2.7,34.0,,84,18,66,84,4.40,21.0
3346,tt0102388,The Man in the Moon,1991,"25,000+",33361,2437,432,1230,4.2,85.0,,22,20,2,22,7.90,91.0
3347,tt0412535,Brice de Nice,2005,"2,500+",4899,353,352,179,3.2,50.0,,0,0,0,0,,
3348,tt0067546,Pakeezah,1972,500+,616,89,17,51,4.1,84.0,,3,3,0,3,,
3349,tt0098282,"See No Evil, Hear No Evil",1989,"25,000+",47985,2553,987,1441,3.8,72.0,,30,8,22,30,3.90,27.0
3350,tt0340149,Hatley High,2003,50+,96,5,5,3,3.4,50.0,,0,0,0,0,,
3351,tt1280558,A Wednesday,2008,"2,500+",2676,812,103,373,4.1,89.0,,3,3,0,3,,
3352,tt1403865,True Grit,2010,"100,000+",158753,61206,10451,15413,4.1,85.0,,279,266,13,279,8.30,95.0
3353,tt0088392,What Waits Below,1984,250+,289,2,13,8,2.4,13.0,,1,0,1,1,,
3354,tt0475330,Love and Mary,2007,Fewer than 50,7,1,2,3,,,,1,0,1,1,,
3355,tt0418131,The Sandlot 2,2005,"25,000+",33770,599,872,786,2.8,41.0,,5,2,3,5,4.70,40.0
3356,tt0308443,Just for Kicks,2003,500+,508,77,15,33,4.1,84.0,,0,0,0,0,,
3357,tt0119861,Pardes,1997,"2,500+",4860,235,91,79,3.9,72.0,,0,0,0,0,,
3358,tt0116861,Leprechaun 4: In Space,1996,"10,000+",10268,188,739,427,2.1,20.0,,6,1,5,6,4.20,17.0
3359,tt0055235,"No, My Darling Daughter",1961,Fewer than 50,25,3,4,2,3.4,43.0,,0,0,0,0,,
3360,tt1581835,Daydream Nation,2010,"2,500+",4074,746,753,253,3.3,50.0,,22,15,7,22,6.00,68.0
3361,tt0165361,Highway,2002,"5,000+",8943,639,293,328,3.7,69.0,,4,1,3,4,,
3362,tt0265651,Ripley's Game,2002,"5,000+",8179,895,438,350,3.6,67.0,,25,23,2,25,7.20,92.0
3363,tt0426550,Popstar,2005,Fewer than 50,4,1,2,0,,,,0,0,0,0,,
3364,tt0055618,Whistle Down the Wind,1961,"1,000+",1595,256,26,113,4.3,91.0,,11,11,0,11,7.40,100.0
3365,tt2119474,Maximum Conviction,2012,250+,484,86,259,77,2.6,25.0,,0,0,0,0,,
3366,tt0431193,Killer Bash,2005,100+,122,7,16,9,2.5,32.0,,0,0,0,0,,
3367,tt0384806,The Amityville Horror,2005,"250,000+",360880,8040,7497,10202,3.3,52.0,,164,39,125,164,4.20,24.0
3368,tt0076425,Murder in Peyton Place,1977,0,0,0,0,0,,,,0,0,0,0,,
3369,tt1708483,Irumbukkottai Murattu Singam,2010,Fewer than 50,41,0,5,2,1.7,0.0,,0,0,0,0,,
3370,tt0097125,Criminal Law,1988,"1,000+",1035,58,157,58,2.8,27.0,,9,3,6,9,4.60,33.0
3371,tt1757717,Davpech,2010,0,0,0,0,0,,,,0,0,0,0,,
3372,tt0290685,Jhuk Gaya Aasman,1968,0,0,0,0,0,,,,0,0,0,0,,
3373,tt1956697,Vettai,2012,Fewer than 50,3,2,1,0,,,,1,1,0,1,,
3374,tt0061620,Elvira Madigan,1967,"1,000+",1062,88,28,31,3.9,76.0,,7,4,3,7,6.70,57.0
3375,tt0463034,"You, Me and Dupree",2006,"250,000+",448284,14393,14524,12333,3.2,50.0,,167,34,133,167,4.40,20.0
3376,tt0065184,Viva Max,1969,250+,424,15,11,8,3.6,58.0,,0,0,0,0,,
3377,tt0114736,True Crime,1995,"2,500+",2553,60,86,32,3,41.0,,5,0,5,5,3.30,0.0
3378,tt0083567,Antonieta,1982,0,0,0,0,0,,,,0,0,0,0,,
3379,tt0995829,XXY,2007,"5,000+",5396,1453,372,538,3.8,80.0,,53,44,9,53,6.90,83.0
3380,tt0850307,Liberty Kid,2007,100+,139,12,5,7,3.9,71.0,,17,15,2,17,7.10,88.0
3381,tt1144546,Holyman Undercover,2010,Fewer than 50,27,4,6,4,2.8,40.0,,0,0,0,0,,
3382,tt1462044,Enemies Among Us,2010,100+,161,2,38,15,1.3,5.0,,0,0,0,0,,
3383,tt1311082,The Pit and the Pendulum,2009,50+,79,2,17,9,1.8,11.0,,0,0,0,0,,
3384,tt0159421,The Adventures of Elmo in Grouchland,1999,"5,000+",7612,314,176,279,3.6,64.0,,44,34,10,44,6.70,77.0
3385,tt1411704,Hop,2011,"100,000+",107560,32201,29105,2591,3.4,53.0,,140,34,106,140,4.30,24.0
3386,tt1078885,Deep in the Valley,2009,500+,695,43,130,63,2.3,25.0,,0,0,0,0,,
3387,tt1037004,American Son,2008,500+,606,76,72,42,3.2,51.0,,13,13,0,13,7.00,100.0
3388,tt0269422,Kanamarayathu,1984,0,0,0,0,0,,,,0,0,0,0,,
3389,tt0092991,Evil Dead II,1987,"100,000+",149019,21094,2626,8093,4.3,89.0,,83,73,10,83,7.50,88.0
3390,tt0098115,Prancer,1989,"5,000+",8416,303,217,242,3.5,58.0,,24,16,8,24,6.10,67.0
3391,tt2367056,Chal Pichchur Banate Hain,2012,0,0,0,0,0,,,,0,0,0,0,,
3392,tt0115571,The Arrival,1996,Fewer than 50,1,1,0,0,,,,0,0,0,0,,
3393,tt1418646,Beneath Hill 60,2010,"1,000+",2160,390,114,187,3.7,77.0,,14,12,2,14,7.10,86.0
3394,tt1392100,Bandhana,1984,Fewer than 50,19,1,1,0,,,,0,0,0,0,,
3395,tt1243381,A Very Special Love,2008,"1,000+",1485,102,25,97,4.1,80.0,,0,0,0,0,,
3396,tt0403933,Chasing Ghosts,2005,500+,992,22,39,23,2.9,36.0,,2,1,1,2,,
3397,tt0199161,Yogi's First Christmas,1980,100+,247,47,26,17,3.7,64.0,,1,1,0,1,,
3398,tt0119296,His and Hers,1997,100+,126,2,2,2,,,,1,0,1,1,,
3399,tt0441902,Thommanum Makkalum,2005,0,0,0,0,0,,,,0,0,0,0,,
3400,tt0990407,The Green Hornet,2011,"100,000+",116562,15963,21470,9417,3.1,43.0,,241,108,133,241,5.20,45.0
3401,tt0084132,Inchon,1981,250+,259,2,27,16,1.6,7.0,,8,0,8,8,3.00,0.0
3402,tt0483607,Doomsday,2008,"50,000+",84857,6603,8293,8168,3,44.0,,76,38,38,76,5.20,50.0
3403,tt1164999,Biutiful,2010,"10,000+",21457,5246,1788,1700,3.7,75.0,,155,103,52,155,6.40,66.0
3404,tt0189070,Scooby-Doo Meets the Boo Brothers,1987,500+,621,140,56,29,3.8,71.0,,1,1,0,1,,
3405,tt0323443,Nousukausi,2003,250+,310,64,33,11,3.5,66.0,,0,0,0,0,,
3406,tt0974583,Lake Placid 2,2007,"2,500+",2969,93,621,373,1.8,13.0,,9,1,8,9,3.70,11.0
3407,tt0264761,Kissing Jessica Stein,2001,"10,000+",16577,1440,782,702,3.5,65.0,,121,101,20,121,7.10,83.0
3408,tt1680019,Tilt,2010,Fewer than 50,11,4,3,1,3.5,57.0,,0,0,0,0,,
3409,tt0109655,Double Happiness,1994,"1,000+",1776,117,50,79,3.6,70.0,,12,9,3,12,7.00,75.0
3410,tt0112985,Escape to Witch Mountain,1995,"2,500+",2593,141,77,70,3.6,65.0,,0,0,0,0,,
3411,tt0770802,Samsara,2011,"10,000+",12503,2145,320,438,4.1,87.0,,79,60,19,79,7.00,76.0
3412,tt0109635,Disclosure,1994,"25,000+",31525,861,1254,544,3,41.0,,63,37,26,63,6.20,59.0
3413,tt1227762,Aladin,2009,500+,935,96,118,70,3.1,45.0,,3,0,3,3,,
3414,tt0082695,Madame X,1981,0,0,0,0,0,,,,0,0,0,0,,
3415,tt0100935,Wild at Heart,1990,0,0,0,0,0,,,,0,0,0,0,,
3416,tt1114677,Hannah Montana: The Movie,2009,"250,000+",379969,7452,3747,6081,3.7,67.0,,134,58,76,134,5.20,43.0
3417,tt0094596,36 fillette,1988,"1,000+",1555,33,25,21,3.3,57.0,,8,7,1,8,7.20,88.0
3418,tt0083926,Far East,1982,0,0,0,0,0,,,,0,0,0,0,,
3419,tt0064699,Mosquito Squadron,1969,500+,630,15,43,29,2.8,26.0,,1,0,1,1,,
3420,tt0469686,Dreaming Lhasa,2005,500+,947,26,17,15,3.6,60.0,,17,7,10,17,5.00,41.0
3421,tt0795368,Death at a Funeral,2007,"100,000+",103071,5252,6437,3324,3.1,45.0,,138,59,79,138,5.00,43.0
3422,tt1243957,The Tourist,2010,"50,000+",95164,12406,17257,7327,3,42.0,,175,36,139,175,4.40,21.0
3423,tt0100376,The Plot to Kill Hitler,1990,50+,92,9,8,3,3.4,53.0,,0,0,0,0,,
3424,tt0795368,Death at a Funeral,2007,"100,000+",103071,5252,6437,3324,3.1,45.0,,138,59,79,138,5.00,43.0
3425,tt1298721,The Telling,2009,250+,266,13,75,35,1.9,15.0,,1,0,1,1,,
3426,tt0281168,Sarah... ang munting prinsesa,1995,0,0,0,0,0,,,,0,0,0,0,,
3427,tt0116592,"I Love You, I Love You Not",1996,"5,000+",7932,185,272,135,3.1,40.0,,5,2,3,5,5.40,40.0
3428,tt0120533,Celebrity,1998,"5,000+",9613,755,1026,357,3.1,42.0,,43,18,25,43,5.50,42.0
3429,tt1109520,The Singles 2nd Ward,2007,250+,382,28,22,21,3.4,57.0,,0,0,0,0,,
3430,tt0374271,Tere Naam,2003,"2,500+",4200,279,71,149,4.1,80.0,,0,0,0,0,,
3431,tt0079437,Last Embrace,1979,500+,546,28,60,21,2.9,32.0,,24,14,10,24,5.20,58.0
3432,tt0869152,They Wait,2007,"1,000+",1469,122,201,161,3,38.0,,5,2,3,5,5.80,40.0
3433,tt0093116,The Great Land of Small,1987,100+,131,8,9,4,3.4,50.0,,0,0,0,0,,
3434,tt0104291,Forever Young,1992,"50,000+",59742,2251,2021,1125,3.3,53.0,,24,13,11,24,5.40,54.0
3435,tt0231402,Crocodile Dundee in Los Angeles,2001,"100,000+",171837,364,1108,1213,2.5,25.0,,82,9,73,82,3.60,11.0
3436,tt0089279,Hitler's S.S.: Portrait in Evil,1985,100+,200,12,19,7,3.1,39.0,,1,1,0,1,,
3437,tt0144142,Committed,2000,"2,500+",3897,116,212,90,2.9,35.0,,46,20,26,46,5.40,43.0
3438,tt0087921,Places in the Heart,1984,"5,000+",6770,725,149,244,4,83.0,,38,34,4,38,8.00,89.0
3439,tt1310637,Dance Star,2010,0,0,0,0,0,,,,0,0,0,0,,
3440,tt1470173,Three Veils,2011,Fewer than 50,34,5,0,2,4.5,100.0,,0,0,0,0,,
3441,tt0095963,Red Heat,1988,"25,000+",37149,1058,1770,686,3,37.0,,26,18,8,26,5.60,69.0
3442,tt0271355,Adharvam,1989,0,0,0,0,0,,,,0,0,0,0,,
3443,tt0084504,The Pirate Movie,1982,"10,000+",10105,724,220,614,4,77.0,,11,1,10,11,2.70,9.0
3444,tt0083296,Visiting Hours,1982,"1,000+",1342,47,146,70,2.7,24.0,,14,2,12,14,4.10,14.0
3445,tt0251107,Gundagardi,1997,0,0,0,0,0,,,,0,0,0,0,,
3446,tt0238829,Alien Adventure,1999,"1,000+",2390,1,3,3,,,,1,1,0,1,,
3447,tt0102299,Liebestraum,1991,500+,682,29,31,21,3.2,48.0,,11,5,6,11,5.70,45.0
3448,tt0107048,Groundhog Day,1993,"250,000+",417530,32059,4474,14892,4.2,88.0,,145,136,9,145,7.90,94.0
3449,tt1587411,"I, Anna",2012,250+,346,82,84,23,3.3,49.0,,28,17,11,28,5.70,61.0
3450,tt0097575,Incident at Dark River,1989,Fewer than 50,40,1,0,0,,,,0,0,0,0,,
3451,tt0222012,Hey Ram,2000,"1,000+",1688,202,55,53,4,79.0,,0,0,0,0,,
3452,tt0113755,Man of the House,1995,"50,000+",55719,485,983,806,2.8,33.0,,15,2,13,15,3.50,13.0
3453,tt0810834,Dil Apna Punjabi,2006,500+,816,44,7,21,4.2,86.0,,0,0,0,0,,
3454,tt0308113,Chinna Thambi Periya Thambi,1987,0,0,0,0,0,,,,0,0,0,0,,
3455,tt0093582,Munchies,1987,500+,591,28,87,52,2.4,24.0,,1,0,1,1,,
3456,tt0076263,Killer of Sheep,1978,"2,500+",4699,782,151,394,4.1,84.0,,80,78,2,80,8.90,98.0
3457,tt0110966,Relentless IV: Ashes to Ashes,1994,100+,239,2,8,0,2.5,20.0,,1,0,1,1,,
3458,tt0097236,Dream a Little Dream,1989,"5,000+",9477,729,363,450,3.7,67.0,,11,1,10,11,3.50,9.0
3459,tt0387460,The Off Season,2004,Fewer than 50,8,0,5,2,1.6,0.0,,0,0,0,0,,
3460,tt0448134,Sunshine,2007,"100,000+",168687,30818,11395,20773,3.7,73.0,,169,129,40,169,6.80,76.0
3461,tt0387412,Metallica: Some Kind of Monster,2004,"10,000+",23705,2592,528,1299,4,83.0,,122,107,15,122,7.60,88.0
3462,tt0089201,Ghulami,1985,Fewer than 50,1,1,0,0,,,,0,0,0,0,,
3463,tt0117802,Swingers,1996,"50,000+",58693,11676,1518,4135,4.2,89.0,,56,49,7,56,7.70,88.0
3464,tt0089114,Explorers,1985,"10,000+",14510,1379,700,716,3.6,66.0,,29,21,8,29,5.90,72.0
3465,tt1331329,The Final Storm,2010,250+,298,19,116,55,2,14.0,,0,0,0,0,,
3466,tt0077594,Game of Death,1978,"25,000+",32598,1519,889,985,3.5,63.0,,13,6,7,13,5.10,46.0
3467,tt0255212,Hamara Dil Aapke Paas Hai,2000,250+,266,17,13,9,3.2,57.0,,0,0,0,0,,
3468,tt1532503,Beginners,2010,"25,000+",25247,7964,2379,1928,3.8,77.0,,162,139,23,162,7.50,86.0
3469,tt1756632,Mwansa the Great,2011,Fewer than 50,2,1,0,0,,,,0,0,0,0,,
3470,tt0087365,"Greystoke: The Legend of Tarzan, Lord of the Apes",1984,"10,000+",15049,519,341,276,3.5,60.0,,15,11,4,15,6.00,73.0
3471,tt0204350,Poor White Trash,2000,"1,000+",1379,28,61,35,2.8,31.0,,10,6,4,10,5.10,60.0
3472,tt0120772,The Object of My Affection,1998,"25,000+",41058,1317,1271,763,3.3,51.0,,60,32,28,60,5.80,53.0
3473,tt0083099,So Fine,1981,250+,271,8,18,8,2.9,31.0,,7,5,2,7,5.90,71.0
3474,tt0490701,You Are Here,2007,100+,136,4,7,5,3,36.0,,12,10,2,12,7.00,83.0
3475,tt0103112,Toy Soldiers,1991,"25,000+",39459,986,514,660,3.6,66.0,,17,7,10,17,4.60,41.0
3476,tt0843625,You Are the One,2006,0,0,0,0,0,,,,0,0,0,0,,
3477,tt0075151,Rogue Male,1976,Fewer than 50,28,7,7,4,3.2,50.0,,1,1,0,1,,
3478,tt0109830,Forrest Gump,1994,"250,000+",1244237,170818,8770,92568,4.1,95.0,,108,77,31,108,7.50,71.0
3479,tt0086973,Blame It on Rio,1984,"5,000+",6823,219,331,162,3,40.0,,26,2,24,26,3.40,8.0
3480,tt0384504,Saving Face,2004,"5,000+",8602,1653,228,678,4.1,88.0,,89,78,11,89,6.70,88.0
3481,tt0409694,Anandam,2001,0,0,0,0,0,,,,0,0,0,0,,
3482,tt0107718,Nurses on the Line: The Crash of Flight 7,1993,Fewer than 50,1,0,1,0,,,,0,0,0,0,,
3483,tt0858433,Diamond Dogs,2007,500+,518,17,112,64,2.1,13.0,,2,0,2,2,,
3484,tt0078480,Watership Down,1978,"25,000+",34025,3015,493,1781,4.1,86.0,,34,27,7,34,7.10,79.0
3485,tt1576440,Good Neighbours,2010,"2,500+",2601,262,477,170,2.9,36.0,,30,20,10,30,5.90,67.0
3486,tt0100404,Presumed Innocent,1990,"10,000+",23138,2846,1396,481,3.7,67.0,,57,49,8,57,7.30,86.0
3487,tt1821692,United Six,2011,0,0,0,0,0,,,,0,0,0,0,,
3488,tt0070640,Save the Tiger,1973,"1,000+",2316,217,76,123,3.7,74.0,,28,24,4,28,7.20,86.0
3489,tt0080472,Bronco Billy,1980,"5,000+",7270,244,260,129,3.3,48.0,,20,15,5,20,6.60,75.0
3490,tt0299658,Chicago,2002,"250,000+",439772,36407,7388,17491,4,83.0,,263,227,36,263,8.00,86.0
3491,tt0070290,The Last Detail,1973,"5,000+",7421,1422,214,453,4,87.0,,38,33,5,38,8.10,87.0
3492,tt0061191,The Wild World of Batwoman,1966,500+,886,9,100,57,1.2,8.0,,1,1,0,1,,
3493,tt0079946,Starcrash,1978,"1,000+",1453,149,264,200,2.7,36.0,,8,2,6,8,4.40,25.0
3494,tt0071357,Confessions of a Window Cleaner,1974,100+,221,14,33,14,2.7,30.0,,1,0,1,1,,
3495,tt1040028,The Orange Thief,2007,250+,280,17,7,9,3.9,71.0,,0,0,0,0,,
3496,tt0067789,Stariki-razboyniki,1972,50+,89,7,4,0,3.9,64.0,,0,0,0,0,,
3497,tt1017429,Champions of Faith: Baseball Edition,2007,50+,85,1,1,1,,,,0,0,0,0,,
3498,tt0436724,Rize,2005,"5,000+",8862,1146,206,613,4.2,85.0,,94,79,15,94,7.00,84.0
3499,tt0116036,Dating the Enemy,1996,"1,000+",1524,52,38,46,3.5,58.0,,1,0,1,1,,
3500,tt1446192,Rise of the Guardians,2012,"100,000+",124693,33624,8203,4294,4,80.0,,161,119,42,161,6.60,74.0
3501,tt0075612,3 Women,1977,"5,000+",6881,1187,194,379,4.1,86.0,,54,46,8,54,8.00,85.0
3502,tt0099460,Downtown,1990,"1,000+",1183,26,53,22,3,33.0,,4,1,3,4,,
3503,tt0107242,Jack Be Nimble,1993,250+,353,13,11,12,3.3,54.0,,2,2,0,2,,
3504,tt0339436,Nate and the Colonel,2003,500+,729,2,3,0,3.3,40.0,,0,0,0,0,,
3505,tt0057543,Sunday in New York,1963,500+,527,96,30,39,3.9,76.0,,8,8,0,8,7.30,100.0
3506,tt0317351,Dharma Chakram,1996,0,0,0,0,0,,,,0,0,0,0,,
3507,tt0469903,The Express,2008,"250,000+",820248,2299,764,1146,3.8,75.0,,122,76,46,122,6.20,62.0
3508,tt0176234,Forever Fabulous,1999,0,0,0,0,0,,,,0,0,0,0,,
3509,tt0450345,The Wicker Man,2006,"50,000+",88684,1709,8394,6141,2,17.0,,108,16,92,108,3.70,15.0
3510,tt0481598,Pathogen,2006,50+,76,5,5,6,3.4,50.0,,0,0,0,0,,
3511,tt1049413,Up,2009,"250,000+",1205145,112611,12739,42280,4.3,90.0,,297,290,7,297,8.70,98.0
3512,tt0345551,Latter Days,2003,"10,000+",11226,2062,570,924,4,78.0,,48,22,26,48,5.40,46.0
3513,tt0116024,Daraar,1996,Fewer than 50,8,0,2,0,,,,0,0,0,0,,
3514,tt0243155,Bridget Jones's Diary,2001,"250,000+",496171,33920,8025,14136,4,81.0,,162,129,33,162,6.90,80.0
3515,tt1097643,Fifty Dead Men Walking,2008,"2,500+",4664,951,440,441,3.6,68.0,,52,43,9,52,6.70,83.0
3516,tt0324407,Valente Quintero,1973,0,0,0,0,0,,,,0,0,0,0,,
3517,tt0443559,Killshot,2008,"10,000+",21780,545,1396,815,2.8,28.0,,8,3,5,8,5.00,38.0
3518,tt0090713,The Best of Times,1986,"5,000+",6546,197,261,124,3.1,43.0,,14,4,10,14,4.70,29.0
3519,tt0087291,Frankenweenie,1984,"10,000+",22377,1405,489,646,3.8,74.0,,2,2,0,2,,
3520,tt0331632,Scooby-Doo 2: Monsters Unleashed,2004,"100,000+",207583,2482,3626,3135,3,41.0,,119,26,93,119,4.30,22.0
3521,tt1228953,Big Fan,2009,"25,000+",33756,1665,1004,958,3.4,62.0,,89,76,13,89,7.10,85.0
3522,tt1568927,I Am Virgin,2010,100+,141,9,22,12,2.2,29.0,,1,1,0,1,,
3523,tt0240510,The Four Feathers,2002,"2,500+",3280,2118,1162,1090,3.6,65.0,,150,63,87,150,5.40,42.0
3524,tt0056960,The Cracksman,1963,Fewer than 50,2,1,0,0,,,,0,0,0,0,,
3525,tt0131027,Squeeze a Flower,1970,0,0,0,0,0,,,,0,0,0,0,,
3526,tt0274558,The Hours,2002,"50,000+",86056,14835,2736,4501,4.1,84.0,,195,155,40,195,7.50,79.0
3527,tt0081777,Xanadu,1980,"10,000+",19744,1295,933,1238,3.5,58.0,,43,13,30,43,4.80,30.0
3528,tt0124595,Return to Paradise,1998,"5,000+",8179,766,270,335,3.8,74.0,,44,31,13,44,6.60,70.0
3529,tt0083349,Yaarana,1981,250+,390,21,13,10,3.6,62.0,,0,0,0,0,,
3530,tt0770214,Kabul Express,2006,"2,500+",4192,184,110,123,3.5,63.0,,0,0,0,0,,
3531,tt0070300,Lemora: A Child's Tale of the Supernatural,1973,"1,000+",2172,75,54,60,3.4,58.0,,6,5,1,6,7.10,83.0
3532,tt0408847,Hiling,1998,0,0,0,0,0,,,,0,0,0,0,,
3533,tt0453486,Falling in Love with the Girl Next Door,2006,100+,126,3,16,3,2.4,16.0,,0,0,0,0,,
3534,tt1684233,Welcome to the Punch,2013,"5,000+",7985,1228,2139,435,3,36.0,,57,27,30,57,5.60,47.0
3535,tt1284596,Walking on Dead Fish,2008,50+,62,1,1,0,,,,0,0,0,0,,
3536,tt0814255,Percy Jackson & the Olympians: The Lightning Thief,2010,"250,000+",254777,19023,17055,12502,3.3,53.0,,151,73,78,151,5.30,48.0
3537,tt0246315,Vijetha,1985,Fewer than 50,28,3,0,0,,,,0,0,0,0,,
3538,tt1092005,Golmaal Returns,2008,"1,000+",1848,100,202,148,2.7,33.0,,6,0,6,6,3.70,0.0
3539,tt1478480,Do It Again,2010,50+,69,1,3,0,,,,2,2,0,2,,
3540,tt0765128,Océans,2009,"50,000+",98521,2433,809,937,3.8,75.0,,80,65,15,80,7.50,81.0
3541,tt0246134,Lucky Break,2001,"1,000+",1411,41,45,25,3.3,48.0,,44,21,23,44,5.60,48.0
3542,tt0473267,Solstice,2008,"2,500+",3156,215,542,304,2.7,28.0,,1,0,1,1,,
3543,tt0074512,Family Plot,1976,"5,000+",7592,838,516,398,3.5,62.0,,40,37,3,40,7.00,93.0
3544,tt0489018,Day of the Dead,2008,"10,000+",11130,681,2426,1584,2.3,22.0,,8,1,7,8,3.70,13.0
3545,tt0096786,Alienator,1990,100+,105,3,33,15,1.9,8.0,,0,0,0,0,,
3546,tt0344777,Six: The Mark Unleashed,2004,"1,000+",1310,72,27,51,3.8,73.0,,1,0,1,1,,
3547,tt0189633,Kareeb,1998,250+,303,15,10,8,3.6,58.0,,0,0,0,0,,
3548,tt0116594,I Shot Andy Warhol,1996,"5,000+",6315,600,252,263,3.7,70.0,,31,24,7,31,6.80,77.0
3549,tt1217613,Battle: Los Angeles,2011,"50,000+",93896,17815,19413,10815,3.1,48.0,,213,79,134,213,4.90,37.0
3550,tt0085204,BMX Bandits,1983,"5,000+",5468,275,231,234,3.5,54.0,,9,6,3,9,6.30,67.0
3551,tt0081031,The Last Flight of Noah's Ark,1980,"1,000+",1508,23,34,17,3.1,40.0,,4,1,3,4,,
3552,tt0058479,The Pleasure Seekers,1964,50+,97,5,13,7,2.8,28.0,,1,1,0,1,,
3553,tt1439229,High School Musical: O Desafio,2010,Fewer than 50,27,13,14,6,3,48.0,,0,0,0,0,,
3554,tt0090799,Care Bears Movie II: A New Generation,1986,250+,430,44,45,34,3.1,49.0,,2,0,2,2,,
3555,tt0120394,Twin Town,1997,"5,000+",8001,1392,171,621,4.4,89.0,,13,6,7,13,5.40,46.0
3556,tt0095816,Pancho Barnes,1988,Fewer than 50,33,3,0,0,,,,0,0,0,0,,
3557,tt0056127,Journey to the Seventh Planet,1962,100+,150,5,50,21,2.3,9.0,,1,0,1,1,,
3558,tt0253126,High Heels and Low Lifes,2001,"2,500+",3952,92,93,92,3.3,50.0,,30,6,24,30,4.30,20.0
3559,tt0067989,Wild Rovers,1971,100+,129,19,25,16,3.1,43.0,,15,9,6,15,6.00,60.0
3560,tt0453003,Can This Be Love,2005,0,0,0,0,0,,,,0,0,0,0,,
3561,tt0100504,Rock 'n' Roll High School Forever,1991,"5,000+",5869,103,85,101,3.3,55.0,,1,0,1,1,,
3562,tt0120654,Dirty Work,1998,"25,000+",31627,2128,1122,1174,3.7,65.0,,28,4,24,28,3.80,14.0
3563,tt0093555,Mohre,1987,0,0,0,0,0,,,,0,0,0,0,,
3564,tt0175159,Shiloh 2: Shiloh Season,1999,"2,500+",4279,90,56,66,3.6,62.0,,20,14,6,20,6.60,70.0
3565,tt0113674,Live Nude Girls,1995,"1,000+",1028,42,66,25,3,39.0,,8,3,5,8,4.40,38.0
3566,tt0274711,People I Know,2002,"5,000+",6942,192,426,131,2.8,31.0,,56,25,31,56,5.50,45.0
3567,tt0078345,Superdome,1978,0,0,0,0,0,,,,0,0,0,0,,
3568,tt0844760,Starship Troopers 3: Marauder,2008,"5,000+",5949,437,1851,1140,2.3,19.0,,7,3,4,7,4.90,43.0
3569,tt0236493,The Mexican,2001,"100,000+",132394,3560,4577,2237,3.1,44.0,,135,73,62,135,5.50,54.0
3570,tt0382621,Crónicas,2004,"2,500+",2897,316,95,123,3.7,77.0,,73,52,21,73,6.60,71.0
3571,tt0218067,The Calling,2000,0,0,0,0,0,,,,0,0,0,0,,
3572,tt0116503,Head of the Family,1996,"1,000+",1675,33,66,51,2.8,33.0,,3,0,3,3,,
3573,tt0118957,Deewana Mastana,1997,100+,230,8,16,1,2.8,33.0,,0,0,0,0,,
3574,tt1275861,Under the Mountain,2009,500+,753,60,200,87,2.5,23.0,,2,1,1,2,,
3575,tt0375782,"Gone, But Not Forgotten",2003,250+,319,31,28,26,3.1,53.0,,1,0,1,1,,
3576,tt0073924,Zameer,1975,Fewer than 50,21,1,1,0,,,,0,0,0,0,,
3577,tt0059858,La Valentina,1966,0,0,0,0,0,,,,0,0,0,0,,
3578,tt0079063,Don Giovanni,1979,500+,538,71,7,23,4.2,91.0,,6,6,0,6,7.50,100.0
3579,tt0113533,Born to Be Wild,1995,"10,000+",10951,105,116,86,3.1,47.0,,9,0,9,9,3.40,0.0
3580,tt0138703,Phantasm IV: Oblivion,1998,"5,000+",6878,252,344,197,3,42.0,,7,2,5,7,4.20,29.0
3581,tt0339091,Gang of Roses,2003,"2,500+",2741,135,44,67,3.9,75.0,,1,0,1,1,,
3582,tt0150111,Children of the Corn V: Fields of Terror,1998,"10,000+",11261,71,253,106,2.4,22.0,,7,1,6,7,3.00,14.0
3583,tt0089299,Horror House on Highway Five,1985,100+,129,4,24,14,1.8,14.0,,0,0,0,0,,
3584,tt0110521,Mina Tannenbaum,1994,250+,428,80,8,16,4.4,91.0,,2,2,0,2,,
3585,tt0161815,El ministro y yo,1976,50+,56,6,2,0,3.9,75.0,,0,0,0,0,,
3586,tt0173716,Cecil B. Demented,2000,"5,000+",9649,1066,531,563,3.6,67.0,,82,43,39,82,5.60,52.0
3587,tt0265104,The Breed,2001,"2,500+",4572,58,121,94,2.6,32.0,,3,1,2,3,,
3588,tt1242548,The Perfect Age of Rock 'n' Roll,2009,500+,622,38,38,23,3.2,50.0,,14,0,14,14,3.00,0.0
3589,tt0482629,The Ultimate Gift,2006,"25,000+",40132,4685,871,2555,4.2,84.0,,60,20,40,60,5.20,33.0
3590,tt0346136,Webs,2003,100+,155,8,16,13,2.6,33.0,,0,0,0,0,,
3591,tt0120177,Spawn,1997,"100,000+",186291,3158,5507,3951,2.8,36.0,,47,8,39,47,3.90,17.0
3592,tt0072235,Sweet Movie,1974,"2,500+",2584,320,190,222,3.5,63.0,,22,11,11,22,5.40,50.0
3593,tt0119360,In & Out,1997,"25,000+",39016,1382,1291,820,3.3,52.0,,56,41,15,56,6.80,73.0
3594,tt0117427,Race the Sun,1996,"2,500+",4799,106,152,86,3,41.0,,9,2,7,9,4.80,22.0
3595,tt1043695,Journal of a Contract Killer,2008,100+,181,9,16,14,2.7,36.0,,0,0,0,0,,
3596,tt0072034,The Prisoner of Second Avenue,1975,"1,000+",1093,102,50,41,3.7,67.0,,9,4,5,9,5.70,44.0
3597,tt0102768,Regarding Henry,1991,"10,000+",21252,1476,867,644,3.5,63.0,,33,15,18,33,5.20,45.0
3598,tt0090968,Dr. Otto and the Riddle of the Gloom Beam,1985,250+,259,19,33,30,2.7,37.0,,1,1,0,1,,
3599,tt0276515,Southern Comfort,2001,"1,000+",1211,101,16,48,4.1,86.0,,21,20,1,21,8.00,95.0
3600,tt1564349,Dolphin Tale,2011,"25,000+",45397,9950,2477,1871,4,80.0,,113,92,21,113,6.50,81.0
3601,tt1637976,#1 Cheerleader Camp,2010,500+,521,38,122,39,2.2,24.0,,1,1,0,1,,
3602,tt0076054,Freaky Friday,1976,"50,000+",65786,1422,1058,1096,3.4,57.0,,24,17,7,24,6.30,71.0
3603,tt0337639,A Hole in One,2004,100+,120,1,3,2,,,,12,2,10,12,4.30,17.0
3604,tt0065874,I Walk the Line,1970,250+,259,43,18,18,3.6,70.0,,4,1,3,4,,
3605,tt0078913,Buffet Froid,1979,"1,000+",1583,286,33,48,4.3,90.0,,2,2,0,2,,
3606,tt0109765,F.T.W.,1994,100+,126,11,11,2,3.2,50.0,,0,0,0,0,,
3607,tt0104743,Live Wire,1992,"1,000+",2022,38,94,43,2.7,29.0,,5,0,5,5,3.00,0.0
3608,tt0266732,Love Is the Drug,2006,"1,000+",1408,51,51,32,3.2,49.0,,5,3,2,5,5.20,60.0
3609,tt0307692,Zapata - El sueño del héroe,2004,500+,587,12,24,14,2.2,33.0,,0,0,0,0,,
3610,tt1579937,Brahmastram,2007,0,0,0,0,0,,,,0,0,0,0,,
3611,tt0262037,Thenali,2000,Fewer than 50,1,1,0,0,,,,0,0,0,0,,
3612,tt0475431,Permanent Vacation,2007,100+,112,1,22,10,1.7,4.0,,0,0,0,0,,
3613,tt0064997,Slaves,1969,Fewer than 50,27,1,3,1,,,,0,0,0,0,,
3614,tt0280707,Gosford Park,2001,"25,000+",48631,6162,1742,2471,3.8,78.0,,165,144,21,165,7.60,87.0
3615,tt1130980,Three and Out,2008,"1,000+",1843,152,223,210,3,41.0,,6,1,5,6,4.30,17.0
3616,tt1104001,Tron: Legacy,2010,"100,000+",172167,40796,23495,17527,3.6,63.0,,249,127,122,249,5.80,51.0
3617,tt0758764,Little Chenier,2006,500+,553,71,27,48,3.9,72.0,,6,4,2,6,6.60,67.0
3618,tt0116336,For My Daughter's Honor,1996,500+,956,29,14,15,3.7,67.0,,0,0,0,0,,
3619,tt0073629,The Rocky Horror Picture Show,1975,"250,000+",366880,34919,6052,20661,4.2,85.0,,48,38,10,48,6.90,79.0
3620,tt0104403,Hedd Wyn,1992,250+,334,26,3,17,4,90.0,,0,0,0,0,,
3621,tt0096061,Scrooged,1988,"50,000+",77769,5107,2097,2545,3.7,71.0,,51,36,15,51,6.10,71.0
3622,tt1336608,Rock of Ages,2012,"100,000+",209722,16351,13141,5036,3.4,55.0,,231,98,133,231,5.20,42.0
3623,tt0114108,The Pebble and the Penguin,1995,"10,000+",13463,374,453,314,3.1,45.0,,13,4,9,13,4.20,31.0
3624,tt0104149,Duel of Hearts,1991,50+,77,6,4,5,3.4,60.0,,0,0,0,0,,
3625,tt0431114,Today You Die,2005,"5,000+",8163,165,205,148,3,45.0,,1,0,1,1,,
3626,tt0146882,High Fidelity,2000,"100,000+",211972,31623,3687,11172,4.2,90.0,,165,150,15,165,7.60,91.0
3627,tt0100649,Solar Crisis,1990,100+,158,6,31,14,2.1,16.0,,0,0,0,0,,
3628,tt0071777,Love at First Sight,1977,Fewer than 50,30,0,6,1,2.3,0.0,,0,0,0,0,,
3629,tt0311361,Jesus Christ Vampire Hunter,2001,"5,000+",8232,701,493,762,3.3,59.0,,10,8,2,10,6.90,80.0
3630,tt1789098,Vindication,2010,Fewer than 50,13,1,2,2,,,,0,0,0,0,,
3631,tt1612573,Rokkk,2010,Fewer than 50,10,0,3,0,,,,0,0,0,0,,
3632,tt2058024,Nasi Lemak 2.0,2011,Fewer than 50,14,6,4,3,3.2,60.0,,0,0,0,0,,
3633,tt0077521,Evening in Byzantium,1978,0,0,0,0,0,,,,0,0,0,0,,
3634,tt0075900,Curse of the Black Widow,1977,Fewer than 50,30,4,6,7,2.4,40.0,,0,0,0,0,,
3635,tt0060711,Moment to Moment,1966,Fewer than 50,23,2,1,1,,,,3,1,2,3,,
3636,tt1315214,Hannah Free,2009,100+,219,25,28,19,3.3,47.0,,10,2,8,10,3.70,20.0
3637,tt0459733,12 Tangos - Adios Buenos Aires,2005,Fewer than 50,3,1,1,0,,,,0,0,0,0,,
3638,tt0288045,The Medallion,2003,"50,000+",59337,789,2133,1018,2.6,27.0,,126,21,105,126,4.00,17.0
3639,tt1368068,Deli Deli Olma,2009,Fewer than 50,6,4,0,1,,,,0,0,0,0,,
3640,tt0433398,Journey from the Fall,2006,"1,000+",1750,210,27,122,4.2,89.0,,24,22,2,24,7.50,92.0
3641,tt0111397,Teresa's Tattoo,1994,50+,62,3,4,2,3.5,50.0,,0,0,0,0,,
3642,tt0306734,Le divorce,2003,"10,000+",17717,410,1163,497,2.6,26.0,,140,50,90,140,5.20,36.0
3643,tt0091575,Murphy's Law,1986,"2,500+",2968,86,108,75,3.1,44.0,,5,2,3,5,5.20,40.0
3644,tt0108101,Shadowlands,1993,"10,000+",10086,1651,204,658,4.3,89.0,,30,29,1,30,8.00,97.0
3645,tt0383975,Chameli,2003,500+,743,60,44,28,3.4,58.0,,0,0,0,0,,
3646,tt0810928,The Last Sin Eater,2007,"5,000+",7137,547,215,474,3.8,72.0,,37,8,29,37,4.40,22.0
3647,tt0120701,Holy Man,1998,"25,000+",39994,311,959,414,2.5,24.0,,50,6,44,50,3.80,12.0
3648,tt0104452,Housesitter,1992,"25,000+",39894,817,907,566,3.2,47.0,,22,8,14,22,5.00,36.0
3649,tt0054891,Foxhole in Cairo,1960,0,0,0,0,0,,,,0,0,0,0,,
3650,tt0172396,The End of the Affair,1999,"5,000+",9808,1258,438,444,3.8,74.0,,66,44,22,66,6.60,67.0
3651,tt0093051,From the Hip,1987,"1,000+",1550,87,58,58,3.5,60.0,,23,7,16,23,4.70,30.0
3652,tt0093604,Nazrana,1987,Fewer than 50,29,0,1,0,,,,0,0,0,0,,
3653,tt0069738,The Asphyx,1972,500+,947,51,57,35,3.2,47.0,,9,6,3,9,6.10,67.0
3654,tt0100107,Maniac Cop 2,1990,"2,500+",3202,232,263,164,3.2,47.0,,13,8,5,13,5.40,62.0
3655,tt0095286,Heart of Midnight,1988,500+,634,19,35,12,3,35.0,,1,0,1,1,,
3656,tt1273193,"Apocalypse, CA",2011,Fewer than 50,31,13,2,3,4.1,87.0,,0,0,0,0,,
3657,tt0452594,The Break-Up,2006,"250,000+",450455,18668,22304,20727,3.1,46.0,,194,65,129,194,5.00,34.0
3658,tt0107093,The Heartbreak Kid,1993,500+,508,27,16,20,3.5,63.0,,0,0,0,0,,
3659,tt0066921,A Clockwork Orange,1971,"250,000+",437740,101124,7896,29750,4.4,93.0,,82,71,11,82,8.80,87.0
3660,tt0062089,Our Mother's House,1967,100+,151,34,10,12,3.8,77.0,,5,3,2,5,7.10,60.0
3661,tt1564367,Just Go with It,2011,"50,000+",88892,18193,12636,5856,3.5,59.0,,139,26,113,139,3.90,19.0
3662,tt0058414,Nothing But a Man,1964,500+,770,103,14,45,4.2,88.0,,46,45,1,46,8.50,98.0
3663,tt0290673,Irréversible,2002,"25,000+",45591,8319,2031,3936,3.9,80.0,,126,74,52,126,6.10,59.0
3664,tt1155056,"I Love You, Man",2009,"250,000+",1551396,31948,11261,15217,3.7,74.0,,207,171,36,207,6.90,83.0
3665,tt0488906,Zinda,2006,"2,500+",2805,140,94,86,3.4,60.0,,4,1,3,4,,
3666,tt7458776,Kremmen: The Movie,1980,0,0,0,0,0,,,,0,0,0,0,,
3667,tt0119123,Fire Down Below,1997,"25,000+",30340,409,740,462,2.9,36.0,,28,4,24,28,3.50,14.0
3668,tt0386102,Veede,2003,Fewer than 50,26,0,2,0,,,,0,0,0,0,,
3669,tt0420609,Infamous,2006,"10,000+",20741,1402,637,832,3.6,69.0,,155,115,40,155,6.80,74.0
3670,tt0311429,The League of Extraordinary Gentlemen,2003,"250,000+",422845,11097,14145,13720,3,44.0,,184,32,152,184,4.00,17.0
3671,tt1391544,Dhoondte Reh Jaoge,2009,250+,363,11,28,16,2.6,28.0,,1,0,1,1,,
3672,tt0081353,Popeye,1980,"50,000+",56228,1253,1979,1374,2.9,39.0,,43,25,18,43,5.80,58.0
3673,tt0095877,Platoon Leader,1988,250+,421,26,49,21,3,35.0,,2,0,2,2,,
3674,tt0473709,The TV Set,2006,"5,000+",6656,813,589,767,3.3,58.0,,76,49,27,76,6.30,64.0
3675,tt0089173,Friday the 13th: A New Beginning,1985,"50,000+",62351,1102,3103,1510,2.5,26.0,,22,4,18,22,3.70,18.0
3676,tt0954272,Crooked Business,2008,0,0,0,0,0,,,,4,3,1,4,,
3677,tt0177522,Arnold's Wrecking Co.,1973,0,0,0,0,0,,,,0,0,0,0,,
3678,tt0071521,Freebie and the Bean,1974,"1,000+",1455,114,57,72,3.7,67.0,,26,6,20,26,5.60,23.0
3679,tt0246433,Apnapan,1977,0,0,0,0,0,,,,0,0,0,0,,
3680,tt0100152,Mindwarp,1991,"1,000+",1439,47,109,78,2.8,30.0,,3,2,1,3,,
3681,tt0449228,Dosti: Friends Forever,2005,"1,000+",1491,83,37,55,3.7,69.0,,0,0,0,0,,
3682,tt0472175,Saving Shiloh,2006,"1,000+",1416,103,40,70,3.9,72.0,,22,9,13,22,5.20,41.0
3683,tt0844330,Persuasion,2007,"5,000+",5304,1174,286,549,4,80.0,,1,1,0,1,,
3684,tt1782440,Firebreather,2010,250+,270,62,40,27,3.5,61.0,,2,1,1,2,,
3685,tt0175788,Jigri Dost,1969,0,0,0,0,0,,,,0,0,0,0,,
3686,tt0421206,Gridiron Gang,2006,"250,000+",286927,18568,4293,8446,4,81.0,,101,43,58,101,5.70,43.0
3687,tt0313792,Anything Else,2003,"10,000+",22089,1198,1499,609,3.1,44.0,,136,55,81,136,5.30,40.0
3688,tt0473393,Shapeshifter,2005,100+,105,3,12,7,1.9,20.0,,0,0,0,0,,
3689,tt0077587,The Further Adventures of the Wilderness Family,1978,500+,540,11,12,9,3.5,48.0,,0,0,0,0,,
3690,tt2396621,Pattalam,2009,0,0,0,0,0,,,,0,0,0,0,,
3691,tt1318025,Hierro,2009,500+,777,99,245,82,2.8,29.0,,4,2,2,4,,
3692,tt0460812,Griffin & Phoenix,2006,"5,000+",6301,982,273,528,3.9,78.0,,2,0,2,2,,
3693,tt0119906,Playing God,1997,"5,000+",9703,137,273,116,2.9,33.0,,32,5,27,32,4.10,16.0
3694,tt1540840,Dante's Inferno: Abandon All Hope,2010,0,0,0,0,0,,,,0,0,0,0,,
3695,tt0192145,Humdrum,1999,Fewer than 50,1,0,1,0,,,,0,0,0,0,,
3696,tt0100436,Pump Up the Volume,1990,"25,000+",35553,2732,504,1251,4.1,85.0,,39,31,8,39,6.70,79.0
3697,tt1846577,Hasaki Ya Suda,2011,Fewer than 50,1,0,1,0,,,,0,0,0,0,,
3698,tt1386588,The Other Guys,2010,"100,000+",161088,27472,18427,10425,3.4,60.0,,211,166,45,211,6.70,79.0
3699,tt0995031,Bhool Bhulaiyaa,2007,"2,500+",4987,1072,424,536,3.8,72.0,,6,2,4,6,4.50,33.0
3700,tt1634136,Violet & Daisy,2011,"2,500+",3049,243,464,104,2.8,34.0,,50,11,39,50,4.80,22.0
3701,tt0057465,The Sadist,1963,"1,000+",1214,117,58,81,3.5,67.0,,5,5,0,5,7.10,100.0
3702,tt0103855,The Bodyguard,1992,"250,000+",260840,9448,5407,4066,3.7,64.0,,50,19,31,50,5.20,38.0
3703,tt0200954,Totally Blonde,2001,"1,000+",2435,62,85,71,3,42.0,,0,0,0,0,,
3704,tt0795434,Namastey London,2007,"5,000+",7639,954,230,406,4.1,81.0,,3,3,0,3,,
3705,tt0137338,200 Cigarettes,1999,"25,000+",32192,1263,885,612,3.5,59.0,,64,19,45,64,4.40,30.0
3706,tt2057445,No Other Woman,2011,250+,324,83,30,28,3.8,74.0,,0,0,0,0,,
3707,tt0109439,City Slickers II: The Legend of Curly's Gold,1994,"50,000+",61857,644,1429,609,2.8,31.0,,26,4,22,26,4.00,15.0
3708,tt0086056,"Oro, Plata, Mata",1982,100+,100,27,2,14,4.4,93.0,,0,0,0,0,,
3709,tt0963346,Swing State,2008,Fewer than 50,44,2,0,0,,,,0,0,0,0,,
3710,tt0362548,Dhool,2003,50+,83,9,5,3,3.6,64.0,,0,0,0,0,,
3711,tt0283111,National Lampoon's Van Wilder,2002,"100,000+",203848,11504,4228,5480,3.8,73.0,,98,18,80,98,3.70,18.0
3712,tt0155088,Rajput,1982,Fewer than 50,25,1,1,1,,,,0,0,0,0,,
3713,tt0405821,Casshern,2004,"10,000+",19819,2101,925,1656,3.7,69.0,,11,8,3,11,6.40,73.0
3714,tt0340122,Gangotri,2003,0,0,0,0,0,,,,0,0,0,0,,
3715,tt0448205,Bitter & Twisted,2008,50+,57,4,9,4,2.7,31.0,,10,6,4,10,5.80,60.0
3716,tt0095488,The Lair of the White Worm,1988,"5,000+",6270,321,359,268,3.2,47.0,,29,20,9,29,5.90,69.0
3717,tt1343092,The Great Gatsby,2013,"100,000+",210468,46507,22734,8350,3.7,67.0,,305,147,158,305,5.90,48.0
3718,tt0061780,The Honey Pot,1967,100+,247,44,28,15,3.6,61.0,,7,4,3,7,5.70,57.0
3719,tt0363129,This Time Around,2003,100+,220,35,22,13,3.6,61.0,,0,0,0,0,,
3720,tt0456407,The Fakir of Venice,2009,0,0,0,0,0,,,,1,0,1,1,,
3721,tt0058547,Sangam,1964,500+,685,30,8,12,3.9,79.0,,0,0,0,0,,
3722,tt0082362,The Fan,1981,"1,000+",1141,34,65,37,3,34.0,,18,6,12,18,4.70,33.0
3723,tt0896816,Grizzly Rage,2007,250+,413,25,105,74,1.7,19.0,,1,0,1,1,,
3724,tt0076637,Rolling Thunder,1977,"1,000+",2129,478,136,220,3.8,78.0,,14,12,2,14,6.90,86.0
3725,tt0086014,Nightmares,1983,"1,000+",1775,53,114,59,2.9,32.0,,7,2,5,7,5.50,29.0
3726,tt0105391,Shining Through,1992,"5,000+",5542,437,168,204,3.8,72.0,,17,7,10,17,4.80,41.0
3727,tt0063573,The Secret War of Harry Frigg,1968,100+,113,16,19,12,3.3,46.0,,5,2,3,5,5.40,40.0
3728,tt0054885,Flower Drum Song,1961,"1,000+",1903,203,78,122,3.8,72.0,,55,43,12,55,6.20,78.0
3729,tt0395748,Sauda,1995,0,0,0,0,0,,,,0,0,0,0,,
3730,tt0246089,Mosagadu,1980,0,0,0,0,0,,,,0,0,0,0,,
3731,tt0093407,Less Than Zero,1987,"10,000+",12534,1565,913,834,3.5,63.0,,28,14,14,28,5.20,50.0
3732,tt1371155,Made in Dagenham,2010,"10,000+",19325,1728,583,710,3.7,75.0,,131,105,26,131,6.80,80.0
3733,tt0301976,The United States of Leland,2003,"25,000+",30392,3141,740,1337,4,81.0,,93,32,61,93,4.90,34.0
3734,tt0237038,Bharatham,1991,0,0,0,0,0,,,,0,0,0,0,,
3735,tt0084522,Porky's,1981,"50,000+",59813,2654,2025,1608,3.4,57.0,,39,13,26,39,4.80,33.0
3736,tt0110099,I.Q.,1994,"25,000+",30174,857,956,538,3.2,47.0,,28,12,16,28,5.30,43.0
3737,tt0284328,Mujhe Kucch Kehna Hai,2001,250+,456,8,27,7,2.3,23.0,,0,0,0,0,,
3738,tt0092240,The Wraith,1986,"5,000+",9302,713,450,493,3.6,61.0,,14,5,9,14,4.00,36.0
3739,tt0466856,ATL,2006,"100,000+",117146,12946,2039,5023,4.3,86.0,,85,53,32,85,5.90,62.0
3740,tt1270267,Land Gold Women,2011,Fewer than 50,6,5,0,3,3.9,100.0,,0,0,0,0,,
3741,tt0369339,Collateral,2004,"250,000+",364941,31326,5839,13656,4,84.0,,238,205,33,238,7.50,86.0
3742,tt0068528,The Effect of Gamma Rays on Man-in-the-Moon Marigolds,1972,500+,525,80,18,25,3.9,82.0,,13,10,3,13,7.30,77.0
3743,tt0292187,Pingami,1994,0,0,0,0,0,,,,0,0,0,0,,
3744,tt1904875,Dharti,2011,50+,86,8,1,2,4.6,89.0,,1,0,1,1,,
3745,tt0120917,The Emperor's New Groove,2000,"250,000+",451013,18408,3620,13378,4.1,84.0,,134,115,19,134,7.10,86.0
3746,tt0153882,Witness to the Mob,1998,500+,505,53,10,15,4.1,84.0,,5,3,2,5,5.90,60.0
3747,tt0417243,Vital,2004,"2,500+",2685,263,106,130,3.7,71.0,,8,7,1,8,6.90,88.0
3748,tt1599351,Scooby-Doo! Abracadabra-Doo,2009,250+,434,101,40,33,3.8,72.0,,2,2,0,2,,
3749,tt0214178,Sooryavansham,1999,100+,119,9,10,0,3.1,47.0,,0,0,0,0,,
3750,tt0074923,"Mother, Jugs & Speed",1976,"2,500+",3192,139,120,111,3.4,53.0,,17,9,8,17,5.40,53.0
3751,tt0292042,Kaliyil Alpam Karyam,1984,0,0,0,0,0,,,,0,0,0,0,,
3752,tt0138393,The Decline of Western Civilization Part III,1998,500+,638,71,19,15,4,80.0,,11,11,0,11,7.60,100.0
3753,tt0203119,Sexy Beast,2000,"25,000+",38732,5207,950,2194,4,85.0,,140,121,19,140,7.30,86.0
3754,tt0327028,Majunu,2001,Fewer than 50,25,0,3,0,,,,0,0,0,0,,
3755,tt1337140,Buried Secrets,2009,50+,54,1,7,1,2.6,12.0,,0,0,0,0,,
3756,tt0088865,A Bunny's Tale,1985,50+,82,9,7,3,3.5,56.0,,0,0,0,0,,
3757,tt0389326,Riding Giants,2004,"5,000+",6715,1062,69,429,4.3,94.0,,96,89,7,96,7.50,93.0
3758,tt1979320,Rush,2013,"50,000+",79711,29639,3883,3919,4.1,88.0,,238,210,28,238,7.50,88.0
3759,tt0230915,Ultraman: The Adventure Begins,1987,Fewer than 50,3,0,3,0,,,,0,0,0,0,,
3760,tt0277027,I Am Sam,2001,"250,000+",301144,28280,4438,12319,4.1,86.0,,146,52,94,146,4.80,36.0
3761,tt1777034,United,2011,250+,412,212,89,45,3.7,70.0,,0,0,0,0,,
3762,tt0103003,Suburban Commando,1991,"10,000+",20624,361,735,580,2.7,33.0,,13,2,11,13,3.70,15.0
3763,tt1336999,Jucy,2010,100+,188,19,11,5,3.5,63.0,,6,6,0,6,6.00,100.0
3764,tt0171698,Rites of Passage,1999,500+,740,40,17,19,3.7,70.0,,0,0,0,0,,
3765,tt1531663,Everything Must Go,2010,"10,000+",21367,4860,4408,1654,3.2,52.0,,135,98,37,135,6.60,73.0
3766,tt0818098,Dreamkiller,2010,100+,229,14,4,2,3.9,78.0,,2,0,2,2,,
3767,tt1294969,18-Year-Old Virgin,2009,"1,000+",2434,79,416,185,1.8,16.0,,0,0,0,0,,
3768,tt0377749,Dead Birds,2004,"5,000+",8529,316,471,392,3,40.0,,10,6,4,10,5.40,60.0
3769,tt0759612,Longford,2006,"1,000+",1200,243,39,111,3.9,86.0,,7,7,0,7,8.20,100.0
3770,tt0486656,Save the Last Dance 2,2006,"50,000+",83561,2328,2425,2673,3.1,49.0,,2,1,1,2,,
3771,tt1124374,Gnomes & Trolls: The Secret Chamber,2009,250+,307,97,38,10,3.7,72.0,,0,0,0,0,,
3772,tt0106578,Class of '61,1993,100+,162,4,9,0,2.8,31.0,,0,0,0,0,,
3773,tt0270908,Dancing at the Harvest Moon,2002,Fewer than 50,2,0,1,0,,,,1,1,0,1,,
3774,tt0083929,Fast Times at Ridgemont High,1982,"100,000+",171064,13217,3385,5091,3.9,80.0,,60,47,13,60,6.70,78.0
3775,tt0093640,No Way Out,1987,"10,000+",20868,1596,608,506,3.7,72.0,,48,44,4,48,7.40,92.0
3776,tt0056891,Bye Bye Birdie,1963,"10,000+",10199,671,344,376,3.7,66.0,,29,25,4,29,6.70,86.0
3777,tt0078449,The Users,1978,0,0,0,0,0,,,,0,0,0,0,,
3778,tt0107606,Mother's Boys,1993,"2,500+",2724,57,143,60,2.8,29.0,,7,3,4,7,4.70,43.0
3779,tt3407604,Will You Marry Me,2012,Fewer than 50,2,0,2,1,,,,0,0,0,0,,
3780,tt1142988,The Ugly Truth,2009,"250,000+",1399411,22783,15132,15170,3.5,60.0,,176,24,152,176,3.80,14.0
3781,tt0084707,Sophie's Choice,1982,"10,000+",21616,3541,637,1230,4.1,85.0,,42,32,10,42,7.00,76.0
3782,tt1606180,That's What I Am,2011,"1,000+",1788,563,267,171,3.6,68.0,,20,12,8,20,5.50,60.0
3783,tt0413015,Mrs. Henderson Presents,2005,"50,000+",50210,1620,638,1034,3.7,72.0,,144,98,46,144,6.70,68.0
3784,tt0455988,The Elder Son,2006,100+,182,9,17,12,3,35.0,,1,0,1,1,,
3785,tt0427969,Hollywoodland,2006,"50,000+",77778,3199,3521,2795,3.2,48.0,,185,126,59,185,6.40,68.0
3786,tt0357691,Gaon Hamara Shaher Tumhara,1972,0,0,0,0,0,,,,0,0,0,0,,
3787,tt0277585,Undermind,2003,250+,389,7,6,7,3.2,54.0,,3,3,0,3,,
3788,tt0400234,Black Friday,2004,Fewer than 50,1,0,1,0,,,,0,0,0,0,,
3789,tt1137979,Rama Rama Kya Hai Dramaaa,2008,100+,109,3,6,4,3.3,33.0,,1,0,1,1,,
3790,tt0177971,The Perfect Storm,2000,"250,000+",279374,20590,11841,6101,3.7,63.0,,137,63,74,137,5.60,46.0
3791,tt0054476,Wild River,1960,500+,536,145,28,46,4,84.0,,13,12,1,13,8.40,92.0
3792,tt0246982,Thirumal Perumai,1968,0,0,0,0,0,,,,0,0,0,0,,
3793,tt0058953,Beach Blanket Bingo,1965,"5,000+",7301,139,126,147,3.4,52.0,,11,8,3,11,5.80,73.0
3794,tt0072114,The Savage Is Loose,1974,Fewer than 50,34,2,3,2,2.8,40.0,,1,0,1,1,,
3795,tt0240684,The Little Mermaid II: Return to the Sea,2000,"50,000+",83976,1894,2317,2199,3.1,45.0,,6,1,5,6,3.80,17.0
3796,tt0096952,Bloodfist,1989,250+,469,13,25,15,2.7,34.0,,0,0,0,0,,
3797,tt0086346,Spacehunter: Adventures in the Forbidden Zone,1983,"2,500+",3147,105,190,138,2.9,36.0,,15,4,11,15,3.30,27.0
3798,tt0293385,Malli,1998,Fewer than 50,24,1,1,1,,,,0,0,0,0,,
3799,tt0107497,Malice,1993,"10,000+",11461,558,658,285,3.2,46.0,,30,17,13,30,6.40,57.0
3800,tt0079828,Rudolph and Frosty's Christmas in July,1979,"2,500+",2582,57,85,50,3,40.0,,7,1,6,7,2.00,14.0
3801,tt0810900,High School Musical 2,2007,"250,000+",303588,20609,7980,13313,3.9,72.0,,24,20,4,24,5.80,83.0
3802,tt0379185,Blinded,2004,0,0,0,0,0,,,,2,1,1,2,,
3803,tt0312609,Den of Lions,2003,500+,620,8,344,2,0.7,2.0,,5,0,5,5,3.50,0.0
3804,tt0471646,Darwaza Bandh Rakho,2006,50+,89,0,4,0,,,,0,0,0,0,,
3805,tt0385726,Glory Road,2006,"250,000+",338724,12452,2861,5830,4,81.0,,152,84,68,152,6.00,55.0
3806,tt0420565,CrossBones,2005,50+,79,1,4,1,1.9,20.0,,0,0,0,0,,
3807,tt1521023,Loudspeaker,2009,Fewer than 50,17,1,0,0,,,,0,0,0,0,,
3808,tt0065610,Darker Than Amber,1970,50+,72,7,7,7,3.2,50.0,,4,3,1,4,,
3809,tt0103125,True Colors,1991,"2,500+",4956,151,187,81,3.2,45.0,,18,8,10,18,5.00,44.0
3810,tt1261047,Gulaal,2009,250+,381,149,37,55,3.9,80.0,,2,2,0,2,,
3811,tt0118002,Two If by Sea,1996,"5,000+",8489,82,282,111,2.6,23.0,,30,4,26,30,3.90,13.0
3812,tt1846700,Prema Kavali,2011,0,0,0,0,0,,,,0,0,0,0,,
3813,tt1650537,Inkubus,2011,100+,246,23,95,49,2.4,19.0,,0,0,0,0,,
3814,tt0460780,In the Name of the King: A Dungeon Siege Tale,2007,"100,000+",103792,1593,5488,3565,2.2,23.0,,51,2,49,51,2.70,4.0
3815,tt0320338,Raja Kaiye Vacha,1990,0,0,0,0,0,,,,0,0,0,0,,
3816,tt0154154,Anthuleni Katha,1976,0,0,0,0,0,,,,0,0,0,0,,
3817,tt1053810,The Big Year,2011,"10,000+",21633,2781,4047,1154,3,41.0,,102,43,59,102,5.10,42.0
3818,tt0893346,Kiss the Bride,2007,100+,118,8,18,5,2.6,31.0,,0,0,0,0,,
3819,tt0120611,Blade,1998,"250,000+",500335,37808,10922,14797,3.9,78.0,,109,63,46,109,5.90,58.0
3820,tt0167360,Race to Space,2001,100+,205,22,34,10,3.1,39.0,,7,5,2,7,5.70,71.0
3821,tt0067146,Going Home,1971,Fewer than 50,39,3,9,7,2.9,25.0,,3,0,3,3,,
3822,tt1946389,Seema Tapakai,2011,Fewer than 50,12,1,4,0,2.9,20.0,,0,0,0,0,,
3823,tt1094198,The Prince & Me 3: A Royal Honeymoon,2008,"1,000+",1868,66,165,88,2.5,28.0,,0,0,0,0,,
3824,tt0326148,Showboy,2002,500+,739,10,20,18,2.5,33.0,,15,11,4,15,6.10,73.0
3825,tt0097211,Disorganized Crime,1989,"1,000+",1929,81,59,48,3.5,58.0,,7,3,4,7,5.30,43.0
3826,tt0053583,All the Young Men,1960,100+,171,12,12,10,3.3,48.0,,0,0,0,0,,
3827,tt0299458,All the Real Girls,2003,"5,000+",9124,1533,444,738,3.9,78.0,,114,81,33,114,6.90,71.0
3828,tt16985616,Anjada Gandu,1988,0,0,0,0,0,,,,0,0,0,0,,
3829,tt0425094,Heavens Fall,2006,500+,602,69,41,51,3.6,63.0,,2,1,1,2,,
3830,tt0061893,The Last Challenge,1967,100+,149,5,14,11,2.9,26.0,,1,0,1,1,,
3831,tt0421073,Street Kings,2008,"100,000+",203644,9758,7031,7662,3.4,58.0,,153,57,96,153,5.10,37.0
3832,tt0337738,Under One Roof,2002,500+,818,5,19,12,2.2,21.0,,1,0,1,1,,
3833,tt0271237,The Triangle,2001,"2,500+",2734,65,88,48,3,43.0,,2,0,2,2,,
3834,tt1027718,Wall Street: Money Never Sleeps,2010,"100,000+",110807,14869,19240,4868,3.1,44.0,,238,131,107,238,6.00,55.0
3835,tt0092641,Best Seller,1987,"1,000+",2341,110,90,59,3.4,55.0,,16,11,5,16,6.00,69.0
3836,tt12048360,Murattu Kaalai,2012,0,0,0,0,0,,,,0,0,0,0,,
3837,tt0299179,The Three Muscatels,1991,50+,66,1,2,1,,,,0,0,0,0,,
3838,tt1059316,Serpent and the Sun: Tales of an Aztec Apprentice,2009,Fewer than 50,37,2,1,0,,,,0,0,0,0,,
3839,tt0120148,Sliding Doors,1998,"50,000+",62498,6381,1941,2791,3.9,77.0,,55,36,19,55,6.40,65.0
3840,tt0328538,Thirteen,2003,"100,000+",214672,13561,4079,8325,3.9,77.0,,154,125,29,154,7.30,81.0
3841,tt0102411,The Marrying Man,1991,"2,500+",2936,85,106,43,3.1,45.0,,21,2,19,21,3.10,10.0
3842,tt0409011,Love Wrecked,2005,"10,000+",20006,885,948,782,3.2,48.0,,7,1,6,7,4.40,14.0
3843,tt0082158,Chariots of Fire,1981,"25,000+",37275,4107,1038,1671,4,80.0,,115,96,19,115,7.70,83.0
3844,tt0103116,Trancers II,1991,"1,000+",1215,28,83,36,2.8,25.0,,2,1,1,2,,
3845,tt0101540,Cape Fear,1991,"50,000+",69061,8533,2524,2721,3.7,77.0,,57,43,14,57,6.80,75.0
3846,tt0329355,Marion Bridge,2002,"1,000+",1128,87,51,46,3.6,63.0,,17,13,4,17,6.30,76.0
3847,tt0401398,Kronk's New Groove,2005,"25,000+",45718,789,987,788,3.1,45.0,,6,0,6,6,4.50,0.0
3848,tt0061850,Journey to the Center of Time,1967,100+,111,2,14,7,1.8,12.0,,0,0,0,0,,
3849,tt0099395,Def by Temptation,1990,"1,000+",1980,42,62,44,2.9,40.0,,16,12,4,16,4.50,75.0
3850,tt0101540,Cape Fear,1991,"50,000+",69061,8533,2524,2721,3.7,77.0,,57,43,14,57,6.80,75.0
3851,tt0454504,Maine Gandhi Ko Nahin Mara,2005,500+,545,52,11,22,3.8,83.0,,0,0,0,0,,
3852,tt0410214,The Chiefs,2004,50+,80,9,1,2,4.3,99.0,,0,0,0,0,,
3853,tt0400571,Kaun Hai Jo Sapno Mein Aaya,2004,0,0,0,0,0,,,,0,0,0,0,,
3854,tt0466901,Naa Alludu,2005,Fewer than 50,1,0,1,0,,,,0,0,0,0,,
3855,tt0102721,Proof,1991,"5,000+",5357,374,94,157,3.9,80.0,,17,16,1,17,8.00,94.0
3856,tt0452660,One Last Thing...,2005,"10,000+",21326,340,217,304,3.5,61.0,,10,1,9,10,4.30,10.0
3857,tt0072979,Female Trouble,1974,"5,000+",7403,1169,211,537,4.2,85.0,,29,26,3,29,7.10,90.0
3858,tt0385639,Death Bed: The Bed That Eats,1977,500+,691,64,150,109,2.5,30.0,,1,1,0,1,,
3859,tt0207639,The Old Man and the Sea,1999,100+,185,56,6,13,4,90.0,,0,0,0,0,,
3860,tt1015976,Columbus Day,2008,"1,000+",2144,1581,126,106,4.5,93.0,,2,1,1,2,,
3861,tt0338477,Talaash: The Hunt Begins...,2003,250+,386,6,16,4,2.2,27.0,,0,0,0,0,,
3862,tt0088036,Samson and Delilah,1984,Fewer than 50,41,1,3,0,,,,0,0,0,0,,
3863,tt0227445,The Score,2001,"50,000+",60208,4574,2300,1736,3.5,67.0,,127,93,34,127,6.50,73.0
3864,tt0493404,Brotherhood of Blood,2007,250+,342,8,85,65,1.7,9.0,,0,0,0,0,,
3865,tt1886644,Piranhaconda,2012,100+,170,23,97,34,2,19.0,,0,0,0,0,,
3866,tt0138097,Shakespeare in Love,1998,"100,000+",227207,17611,4522,6929,3.9,80.0,,147,135,12,147,8.30,92.0
3867,tt0094799,"Bright Lights, Big City",1988,"5,000+",7033,189,305,178,3,38.0,,20,12,8,20,5.50,60.0
3868,tt0061085,That Riviera Touch,1966,50+,75,7,15,8,3,32.0,,0,0,0,0,,
3869,tt0892429,The Seven of Daran: The Battle of Pareo Rock,2008,50+,80,5,7,4,2.6,42.0,,0,0,0,0,,
3870,tt1286765,Necromentia,2009,250+,401,44,133,76,2.4,25.0,,0,0,0,0,,
3871,tt0432283,Fantastic Mr. Fox,2009,"100,000+",153422,26427,4643,7720,4.1,85.0,,247,229,18,247,7.90,93.0
3872,tt0118880,Con Air,1997,"250,000+",417726,23165,7721,12753,3.8,75.0,,71,41,30,71,5.70,58.0
3873,tt0099595,The Forbidden Dance,1990,"5,000+",5097,187,56,121,4,77.0,,13,3,10,13,3.10,23.0
3874,tt0096454,Without a Clue,1988,"5,000+",5271,439,171,211,3.8,72.0,,13,8,5,13,5.60,62.0
3875,tt1379228,Naan Kadavul,2009,100+,151,32,6,9,4.1,84.0,,2,2,0,2,,
3876,tt0092965,Empire of the Sun,1987,"50,000+",60451,10536,1216,3563,4.2,90.0,,63,49,14,63,6.90,78.0
3877,tt0115759,Broken Arrow,1996,"100,000+",193584,2691,3383,2884,3.1,44.0,,35,19,16,35,5.70,54.0
3878,tt0466403,Unnatural & Accidental,2006,"1,000+",1068,16,12,16,3.3,57.0,,3,0,3,3,,
3879,tt0086050,One Dark Night,1982,"1,000+",1858,55,77,66,3.1,42.0,,2,0,2,2,,
3880,tt0077698,Hot Lead and Cold Feet,1978,"1,000+",2026,65,36,48,3.7,64.0,,1,1,0,1,,
3881,tt0127723,Can't Hardly Wait,1998,"50,000+",82860,3770,2196,2353,3.6,63.0,,62,25,37,62,5.00,40.0
3882,tt0914369,Freeheld,2007,100+,233,30,6,8,4,83.0,,1,1,0,1,,
3883,tt0168516,Biwi Ho To Aisi,1988,0,0,0,0,0,,,,0,0,0,0,,
3884,tt1568328,Enemies of the People,2009,500+,542,82,15,17,4.1,85.0,,33,33,0,33,8.10,100.0
3885,tt0118983,Dil To Pagal Hai,1997,"5,000+",9312,884,195,266,4.1,82.0,,0,0,0,0,,
3886,tt0120576,Dance with Me,1998,"25,000+",36344,852,422,622,3.8,67.0,,43,22,21,43,5.50,51.0
3887,tt0120324,A Simple Plan,1998,"25,000+",39480,3761,886,1231,3.8,81.0,,73,66,7,73,8.20,90.0
3888,tt0352489,Kash... Aap Hamare Hote,2003,Fewer than 50,10,1,2,1,,,,0,0,0,0,,
3889,tt0314353,Tears of the Sun,2003,"100,000+",119888,11071,4908,4067,3.7,69.0,,155,52,103,155,4.90,34.0
3890,tt0247931,Antham,1992,0,0,0,0,0,,,,0,0,0,0,,
3891,tt0098105,Police Academy 6: City Under Siege,1989,"25,000+",42952,416,1060,440,2.6,28.0,,9,0,9,9,2.60,0.0
3892,tt0055824,Cape Fear,1962,"10,000+",17799,1851,293,656,4,86.0,,24,23,1,24,7.90,96.0
3893,tt0058889,Akash Kusum,1965,Fewer than 50,1,1,0,0,,,,0,0,0,0,,
3894,tt0389796,The Best Thief in the World,2004,250+,445,2,11,9,2.3,15.0,,5,2,3,5,5.40,40.0
3895,tt0866439,Made of Honor,2008,"250,000+",399463,12798,10425,9939,3.4,55.0,,125,20,105,125,4.10,16.0
3896,tt0133189,SLC Punk!,1998,"25,000+",49457,7254,881,2867,4.3,89.0,,34,21,13,34,5.60,62.0
3897,tt0059390,The Liquidator,1965,50+,81,14,10,9,3.2,58.0,,0,0,0,0,,
3898,tt0083843,"Don't Cry, It's Only Thunder",1982,Fewer than 50,31,6,1,0,4.3,86.0,,0,0,0,0,,
3899,tt0464160,Chup Chup Ke,2006,"2,500+",3210,215,92,98,3.8,70.0,,0,0,0,0,,
3900,tt1183946,The Stoneman Murders,2009,50+,97,18,13,8,3.4,58.0,,2,2,0,2,,
3901,tt0097437,Geethanjali,1989,100+,109,28,4,5,4.3,88.0,,0,0,0,0,,
3902,tt0367461,9 Nelalu,2000,0,0,0,0,0,,,,0,0,0,0,,
3903,tt0329162,Devil's Pond,2003,"2,500+",3230,126,190,107,3,40.0,,0,0,0,0,,
3904,tt1096986,Reach for Me,2008,100+,131,29,7,20,4.1,81.0,,2,1,1,2,,
3905,tt0116250,Evita,1996,"50,000+",54498,2995,1385,1799,3.7,68.0,,39,25,14,39,6.60,64.0
3906,tt0093745,The Place at the Coast,1987,0,0,0,0,0,,,,0,0,0,0,,
3907,tt0114690,Tokyo Fist,1995,500+,607,127,35,31,3.8,78.0,,3,3,0,3,,
3908,tt1543883,Standing Army,2010,Fewer than 50,10,4,1,2,3.9,80.0,,0,0,0,0,,
3909,tt0060689,Mera Saaya,1966,50+,55,5,2,3,3.6,71.0,,0,0,0,0,,
3910,tt1736560,Cheriya Kallanum Valiya Policum,2010,0,0,0,0,0,,,,0,0,0,0,,
3911,tt0083064,Sharky's Machine,1981,"2,500+",3497,175,106,98,3.6,62.0,,23,19,4,23,6.40,83.0
3912,tt0962746,Aata,2007,100+,205,8,10,7,3.3,44.0,,0,0,0,0,,
3913,tt0101481,Bloodfist III: Forced to Fight,1991,250+,364,11,16,11,3.2,41.0,,0,0,0,0,,
3914,tt0820111,Meatball Machine,2005,500+,738,95,103,122,3.2,48.0,,3,1,2,3,,
3915,tt0108528,We're Talkin' Serious Money,1992,Fewer than 50,38,0,2,1,,,,0,0,0,0,,
3916,tt0103840,Bloodfist IV: Die Trying,1992,250+,367,11,10,11,3.5,52.0,,0,0,0,0,,
3917,tt0113018,Falling from the Sky: Flight 174,1995,Fewer than 50,18,4,2,1,3.4,67.0,,0,0,0,0,,
3918,tt1722638,Tom and Jerry Meet Sherlock Holmes,2010,100+,242,53,39,20,3.7,58.0,,3,3,0,3,,
3919,tt0142342,Big Daddy,1999,"250,000+",1052461,37365,12940,25653,3.8,74.0,,94,37,57,94,5.00,39.0
3920,tt1507563,Dark Tide,2012,"1,000+",1431,113,590,161,2.1,16.0,,20,0,20,20,2.80,0.0
3921,tt0109920,A Good Man in Africa,1994,500+,679,25,69,18,2.7,27.0,,10,1,9,10,4.20,10.0
3922,tt0233691,Faeries,1999,100+,112,12,6,3,3.7,67.0,,0,0,0,0,,
3923,tt0067377,Made for Each Other,1971,Fewer than 50,1,0,1,1,,,,1,1,0,1,,
3924,tt0289635,Young Adam,2003,"5,000+",8403,614,626,419,3.2,49.0,,124,77,47,124,6.30,62.0
3925,tt0382142,Full-Court Miracle,2003,500+,853,48,63,25,3.2,43.0,,3,1,2,3,,
3926,tt0104815,El mariachi,1992,"50,000+",54838,5683,1808,2054,3.8,76.0,,76,69,7,76,7.00,91.0
3927,tt0061922,The Love-Ins,1967,Fewer than 50,39,0,4,2,,,,0,0,0,0,,
3928,tt1095404,Follow the Prophet,2009,50+,90,10,11,6,3.2,48.0,,1,0,1,1,,
3929,tt1087524,Once Fallen,2010,250+,276,23,79,33,2.3,23.0,,0,0,0,0,,
3930,tt0479289,The Go-Getter,2007,"2,500+",4063,557,364,326,3.5,61.0,,25,11,14,25,5.60,44.0
3931,tt0076416,The Mouse and His Child,1977,50+,89,18,11,12,3.7,62.0,,1,1,0,1,,
3932,tt0490527,The Thirst,2006,500+,875,17,119,80,1.9,12.0,,1,0,1,1,,
3933,tt0204946,Bring It On,2000,"250,000+",767786,27719,14022,25531,3.7,66.0,,124,80,44,124,6.00,65.0
3934,tt0101898,Flirting,1991,"5,000+",5765,371,114,134,3.8,76.0,,25,24,1,25,7.30,96.0
3935,tt0298580,Twice Upon a Christmas,2001,"1,000+",1043,42,33,33,3.5,57.0,,0,0,0,0,,
3936,tt0102202,Kickboxer 2: The Road Back,1991,"5,000+",7687,76,171,79,2.9,31.0,,5,1,4,5,4.50,20.0
3937,tt0072128,Scream of the Wolf,1974,500+,734,4,15,13,2.6,21.0,,0,0,0,0,,
3938,tt0066849,The Blood on Satan's Claw,1971,500+,704,146,109,96,3.4,57.0,,11,8,3,11,6.70,73.0
3939,tt0114469,Slam Dunk Ernest,1995,"5,000+",6011,107,236,126,2.7,31.0,,4,1,3,4,,
3940,tt1687850,Apoorvaragam,2010,0,0,0,0,0,,,,0,0,0,0,,
3941,tt0478802,The Foursome,2006,250+,491,12,60,31,2.3,17.0,,1,0,1,1,,
3942,tt1977817,How to Steal 2 Million,2011,Fewer than 50,6,3,0,0,,,,2,1,1,2,,
3943,tt0112572,The Brady Bunch Movie,1995,"25,000+",48584,1017,1156,1101,3.1,47.0,,43,27,16,43,5.90,63.0
3944,tt0806027,Blood: The Last Vampire,2009,"50,000+",94577,1533,3137,2158,2.8,33.0,,53,13,40,53,3.90,25.0
3945,tt0080813,The Great Rock 'n' Roll Swindle,1980,"1,000+",1956,157,63,80,3.8,72.0,,6,6,0,6,6.90,100.0
3946,tt0090660,Armed and Dangerous,1986,"5,000+",9358,280,443,188,3,39.0,,10,1,9,10,3.10,10.0
3947,tt0485513,"Main, Meri Patni... Aur Woh!",2005,500+,534,63,17,21,3.8,79.0,,0,0,0,0,,
3948,tt0088707,American Flyers,1985,"5,000+",6958,18,2,10,4.5,90.0,,20,14,6,20,5.80,70.0
3949,tt1398940,Barbie Presents: Thumbelina,2009,500+,518,54,39,22,3.4,58.0,,0,0,0,0,,
3950,tt0327850,The Rundown,2003,"100,000+",186054,8285,4214,5120,3.6,66.0,,152,106,46,152,6.40,70.0
3951,tt0104545,Jamón Jamón,1992,"5,000+",6059,731,409,281,3.5,64.0,,16,11,5,16,6.40,69.0
3952,tt0094138,Three O'Clock High,1987,"5,000+",6077,608,224,267,3.7,73.0,,14,8,6,14,5.70,57.0
3953,tt0079100,The Electric Horseman,1979,"2,500+",3897,191,144,82,3.4,57.0,,22,14,8,22,5.80,64.0
3954,tt0073233,Keetje Tippel,1975,250+,390,44,23,18,3.5,66.0,,4,3,1,4,,
3955,tt0253667,Seetharamaiah Gari Manavaralu,1991,0,0,0,0,0,,,,0,0,0,0,,
3956,tt1100051,Bereavement,2010,"2,500+",2983,158,382,144,2.6,29.0,,18,8,10,18,5.30,44.0
3957,tt0067386,Malpertuis,1971,250+,464,35,19,18,3.5,65.0,,1,0,1,1,,
3958,tt0168786,Antwone Fisher,2002,"25,000+",47284,3500,588,1211,4.1,86.0,,148,115,33,148,6.90,78.0
3959,tt0088326,Unfaithfully Yours,1984,"1,000+",1363,44,53,24,3.3,45.0,,12,4,8,12,4.30,33.0
3960,tt0355836,Nora's Hair Salon,2004,"1,000+",1144,74,31,43,3.9,70.0,,0,0,0,0,,
3961,tt1296898,Waiting for Forever,2010,"10,000+",13327,850,1155,311,3,42.0,,19,1,18,19,2.70,5.0
3962,tt0067388,Man in the Wilderness,1971,250+,336,68,27,35,3.7,72.0,,2,2,0,2,,
3963,tt0080500,Carny,1980,500+,713,50,48,23,3.3,51.0,,7,4,3,7,6.60,57.0
3964,tt0360486,Constantine,2005,"250,000+",469313,35038,13596,18484,3.7,72.0,,227,105,122,227,5.50,46.0
3965,tt0064875,Rascal,1969,"1,000+",1080,11,14,7,3.3,44.0,,1,1,0,1,,
3966,tt2231868,Ulakam Chuttum Valiban,2011,0,0,0,0,0,,,,0,0,0,0,,
3967,tt0115751,Breaking the Waves,1996,"25,000+",31366,5780,557,1424,4.3,91.0,,64,54,10,64,8.10,84.0
3968,tt1404573,Daddy Cool: Join the Fun,2009,Fewer than 50,1,1,0,0,,,,0,0,0,0,,
3969,tt0246090,Mugguru Monagallu,1994,0,0,0,0,0,,,,0,0,0,0,,
3970,tt0445990,Invincible,2006,"50,000+",87727,8343,3071,3835,3.7,73.0,,138,100,38,138,6.50,72.0
3971,tt0054083,Michman Panin,1960,0,0,0,0,0,,,,0,0,0,0,,
3972,tt0054823,Doctor Blood's Coffin,1961,250+,255,2,21,14,2.3,9.0,,1,0,1,1,,
3973,tt0078109,The President's Mistress,1978,Fewer than 50,9,2,3,3,3.2,40.0,,0,0,0,0,,
3974,tt0145531,Stigmata,1999,"50,000+",93621,3729,2225,2024,3.5,63.0,,93,20,73,93,4.20,22.0
3975,tt1481576,The Genesis Code,2010,100+,194,66,25,31,3.7,73.0,,1,0,1,1,,
3976,tt0163787,Perfect Game,2000,100+,133,3,3,2,2.8,50.0,,0,0,0,0,,
3977,tt0275410,Horrorvision,2001,100+,107,1,12,8,1.5,8.0,,2,0,2,2,,
3978,tt0119243,Habitat,1997,250+,329,10,25,15,2.5,29.0,,4,0,4,4,,
3979,tt0416675,Dark Matter,2007,"10,000+",11985,182,274,197,3,40.0,,41,17,24,41,5.00,41.0
3980,tt0063572,The Secret Life of an American Wife,1968,Fewer than 50,17,2,4,1,2.9,33.0,,4,1,3,4,,
3981,tt1224368,Ladies of the House,2008,50+,85,4,5,4,3.5,44.0,,0,0,0,0,,
3982,tt0116999,Marvin's Room,1996,"10,000+",21748,1525,888,475,3.5,63.0,,50,42,8,50,6.70,84.0
3983,tt0271586,Kalikkalam,1990,0,0,0,0,0,,,,0,0,0,0,,
3984,tt0113112,Freaky Friday,1995,250+,400,20,38,17,3.1,34.0,,0,0,0,0,,
3985,tt10163264,Parambarai,1996,0,0,0,0,0,,,,0,0,0,0,,
3986,tt1612123,Vaana,2008,0,0,0,0,0,,,,0,0,0,0,,
3987,tt0457489,Star Wars: Revelations,2005,"5,000+",5612,183,136,122,3.4,57.0,,0,0,0,0,,
3988,tt0075066,The Pink Panther Strikes Again,1976,"25,000+",37954,2395,472,829,4,84.0,,24,18,6,24,7.30,75.0
3989,tt0343660,50 First Dates,2004,"250,000+",32700188,89198,48272,1249478,3.4,65.0,,175,79,96,175,5.40,45.0
3990,tt0101921,Fried Green Tomatoes,1991,"100,000+",120435,102,17,23,4.2,86.0,,45,34,11,45,6.70,76.0
3991,tt0076913,Which Way Is Up?,1977,"1,000+",2235,165,35,89,4.2,82.0,,10,2,8,10,4.00,20.0
3992,tt0241760,The New Guy,2002,"50,000+",66289,2610,2226,1760,3.3,54.0,,99,7,92,99,3.30,7.0
3993,tt0113732,The Maddening,1995,100+,111,8,14,3,2.8,36.0,,1,0,1,1,,
3994,tt0090917,Deadly Friend,1986,"2,500+",3452,205,330,238,3,38.0,,35,7,28,35,3.70,20.0
3995,tt0057889,Black Like Me,1964,100+,229,24,6,10,4,80.0,,1,0,1,1,,
3996,tt0092093,Tiempo de silencio,1986,Fewer than 50,10,0,4,0,,,,0,0,0,0,,
3997,tt0107861,The Positively True Adventures of the Alleged Texas Cheerleader-Murdering Mom,1993,250+,260,22,24,11,3.2,48.0,,11,10,1,11,7.20,91.0
3998,tt0778631,Brave Story,2006,500+,847,151,71,79,3.5,68.0,,0,0,0,0,,
3999,tt0102119,Indrajeet,1991,100+,198,2,5,0,3.2,29.0,,0,0,0,0,,
4000,tt0355315,Charlotte's Web 2: Wilbur's Great Adventure,2002,"10,000+",11428,83,92,88,3.1,47.0,,1,0,1,1,,
4001,tt1071812,Mao's Last Dancer,2009,"5,000+",6190,1253,386,518,3.8,76.0,,78,44,34,78,6.20,56.0
4002,tt0158470,Un argentino en New York,1998,0,0,0,0,0,,,,0,0,0,0,,
4003,tt3005850,Sooper Se Ooper,2013,0,0,0,0,0,,,,0,0,0,0,,
4004,tt0213985,Partition,2007,"5,000+",6568,538,203,406,3.8,73.0,,21,8,13,21,5.20,38.0
4005,tt0097722,Lean on Me,1989,"25,000+",41494,5283,952,1301,4.2,85.0,,19,13,6,19,5.80,68.0
4006,tt0110006,Heavyweights,1995,"25,000+",45511,3712,1099,1871,4,77.0,,8,3,5,8,5.00,38.0
4007,tt0096999,Bye Bye Blues,1989,Fewer than 50,16,4,1,0,4.1,80.0,,2,1,1,2,,
4008,tt1430124,The Fattest Man in Britain,2009,Fewer than 50,1,1,0,1,,,,1,1,0,1,,
4009,tt0067893,Two-Lane Blacktop,1971,"5,000+",6023,1004,229,488,4,82.0,,40,37,3,40,7.70,93.0
4010,tt1783732,John Dies at the End,2012,"10,000+",12281,3156,2724,938,3.3,54.0,,89,53,36,89,5.60,60.0
4011,tt0101797,Edge of Honor,1991,100+,143,10,6,5,3.6,62.0,,0,0,0,0,,
4012,tt1136608,District 9,2009,"250,000+",1179095,82577,17541,39457,4,82.0,,314,282,32,314,7.80,90.0
4013,tt1656170,Bringing Up Bobby,2011,Fewer than 50,2,0,2,1,,,,0,0,0,0,,
4014,tt0395119,Alatriste,2006,"10,000+",19142,632,711,293,3.1,47.0,,6,1,5,6,4.10,17.0
4015,tt0301893,State Property,2002,"5,000+",6518,404,146,144,3.9,73.0,,12,0,12,12,2.70,0.0
4016,tt0300051,Jersey Girl,2004,"100,000+",139113,3812,4137,3766,3.2,48.0,,176,75,101,176,5.30,43.0
4017,tt0390597,Vellithira,2003,0,0,0,0,0,,,,0,0,0,0,,
4018,tt0059853,Up from the Beach,1965,0,0,0,0,0,,,,0,0,0,0,,
4019,tt0306840,Koi Mere Dil Se Poochhe,2002,Fewer than 50,19,0,5,1,2.3,0.0,,0,0,0,0,,
4020,tt0114171,The Power Within,1995,100+,102,7,3,3,3.4,70.0,,0,0,0,0,,
4021,tt1230211,Perkins' 14,2009,"1,000+",1099,60,165,136,2.7,27.0,,0,0,0,0,,
4022,tt1809399,Utt Pataang,2011,0,0,0,0,0,,,,0,0,0,0,,
4023,tt1190536,Black Dynamite,2009,"10,000+",15701,5265,897,2129,4,85.0,,64,53,11,64,7.20,83.0
4024,tt0099073,Avalon,1990,"2,500+",3259,318,91,114,4,78.0,,28,24,4,28,7.30,86.0
4025,tt0255713,Zubeidaa,2001,500+,677,46,26,15,3.7,64.0,,0,0,0,0,,
4026,tt1454468,Gravity,2013,"250,000+",303997,97572,25188,16356,4,79.0,,363,347,16,363,8.90,96.0
4027,tt0319337,Ee Parakkum Thalika,2001,0,0,0,0,0,,,,0,0,0,0,,
4028,tt0403946,Cloud 9,2006,250+,457,74,54,54,3.4,58.0,,44,39,5,44,6.90,89.0
4029,tt0977667,Taking Liberties,2007,"1,000+",1058,147,21,105,4.2,87.0,,6,5,1,6,6.90,83.0
4030,tt0177485,Aadmi Sadak Ka,1977,0,0,0,0,0,,,,0,0,0,0,,
4031,tt0432291,The Fog,2005,"100,000+",228678,990,4302,4384,2.1,19.0,,69,3,66,69,2.90,4.0
4032,tt0363685,Homeland Security,2004,50+,99,3,14,3,2.4,18.0,,1,0,1,1,,
4033,tt0072792,The Clown Murders,1976,100+,242,6,24,15,2.2,20.0,,1,0,1,1,,
4034,tt1640227,Challenging Impossibility,2011,0,0,0,0,0,,,,0,0,0,0,,
4035,tt0057933,The Chalk Garden,1964,500+,560,57,17,22,4,77.0,,7,5,2,7,6.30,71.0
4036,tt0977855,Fair Game,2010,"25,000+",28722,4641,2500,1790,3.5,65.0,,177,139,38,177,6.90,79.0
4037,tt0078227,Semi-Tough,1977,"1,000+",1315,46,93,31,2.8,33.0,,12,10,2,12,6.40,83.0
4038,tt0112288,The Addiction,1995,"2,500+",3507,386,182,160,3.6,68.0,,31,23,8,31,6.40,74.0
4039,tt1851841,Aaghaat,2010,0,0,0,0,0,,,,0,0,0,0,,
4040,tt0083851,The Draughtsman's Contract,1982,"5,000+",5128,731,126,232,4.1,85.0,,33,32,1,33,8.30,97.0
4041,tt0104987,Netherworld,1992,250+,418,4,28,17,2.3,12.0,,1,0,1,1,,
4042,tt0084234,The Last American Virgin,1982,"5,000+",9882,561,300,347,3.6,65.0,,13,10,3,13,6.00,77.0
4043,tt0136523,Seasons of the Heart,1993,Fewer than 50,1,1,0,0,,,,0,0,0,0,,
4044,tt0061715,The Gnome-Mobile,1967,"2,500+",3381,116,84,120,3.5,58.0,,2,2,0,2,,
4045,tt0119467,Kiss or Kill,1997,250+,407,38,12,15,3.7,76.0,,30,25,5,30,7.00,83.0
4046,tt1189006,Toonpur Ka Superrhero,2010,100+,151,5,17,6,2.2,23.0,,1,0,1,1,,
4047,tt0100156,Mirror Mirror,1990,100+,242,17,37,13,2.9,31.0,,5,4,1,5,6.30,80.0
4048,tt0067589,Plaza Suite,1971,500+,894,66,53,40,3.5,55.0,,20,14,6,20,6.30,70.0
4049,tt0365485,The Matador,2005,100+,205,20,11,7,3.6,65.0,,15,11,4,15,6.60,73.0
4050,tt1999828,Always Brando,2011,0,0,0,0,0,,,,1,1,0,1,,
4051,tt0067197,The Hellstrom Chronicle,1971,100+,207,32,5,16,4.2,86.0,,8,6,2,8,6.90,75.0
4052,tt1172060,It's Alive,2009,500+,949,21,319,168,1.8,6.0,,2,0,2,2,,
4053,tt0072156,Shriek of the Mutilated,1974,250+,347,10,29,23,2.6,26.0,,0,0,0,0,,
4054,tt1959405,I Am Twenty,1967,Fewer than 50,14,6,2,1,3.7,75.0,,0,0,0,0,,
4055,tt0267129,Yamakasi - Les samouraïs des temps modernes,2001,"2,500+",4972,353,207,140,3.5,63.0,,0,0,0,0,,
4056,tt0296574,Company,2002,"2,500+",4582,423,34,134,4.3,93.0,,3,3,0,3,,
4057,tt0109068,Airheads,1994,"100,000+",126276,2936,2930,2012,3.3,50.0,,38,11,27,38,4.30,29.0
4058,tt0444874,Main Aisa Hi Hoon,2005,250+,295,14,18,3,3.1,44.0,,0,0,0,0,,
4059,tt0104323,Geet,1992,0,0,0,0,0,,,,0,0,0,0,,
4060,tt0427312,Grizzly Man,2005,"50,000+",53867,6961,1246,3220,4,85.0,,146,135,11,146,8.10,92.0
4061,tt0091572,Murder in Three Acts,1986,100+,110,11,20,6,2.9,35.0,,0,0,0,0,,
4062,tt0119829,On the Edge of Innocence,1997,250+,277,11,10,7,3.6,52.0,,0,0,0,0,,
4063,tt0116032,Darkdrive,1997,50+,61,0,3,2,,,,0,0,0,0,,
4064,tt0130172,P.U.N.K.S.,1999,"1,000+",1711,57,56,30,3.1,50.0,,1,0,1,1,,
4065,tt0075359,Two-Minute Warning,1976,100+,126,32,42,28,3.1,43.0,,14,4,10,14,4.40,29.0
4066,tt0096156,Spike of Bensonhurst,1988,100+,165,13,9,3,3.4,59.0,,6,3,3,6,5.40,50.0
4067,tt6765460,Thalaimagan,2006,50+,65,0,2,0,,,,0,0,0,0,,
4068,tt1683526,Detachment,2011,"5,000+",6978,2725,953,671,3.8,74.0,,70,41,29,70,5.90,59.0
4069,tt0460777,Driftwood,2006,0,0,0,0,0,,,,0,0,0,0,,
4070,tt0962728,Hobgoblins 2,2009,100+,121,6,15,10,2.1,25.0,,0,0,0,0,,
4071,tt0129631,Women in Revolt,1971,500+,796,37,27,19,3.3,58.0,,2,2,0,2,,
4072,tt0210294,Snow Queen,2002,"2,500+",4039,220,87,136,3.8,72.0,,0,0,0,0,,
4073,tt0079945,Star Trek: The Motion Picture,1979,"50,000+",66221,3750,5122,3057,3.1,42.0,,56,29,27,56,6.00,52.0
4074,tt1499201,Anjaana Anjaani,2010,0,0,0,0,0,,,,0,0,0,0,,
4075,tt0116404,Get on the Bus,1996,"5,000+",5157,374,150,163,3.7,71.0,,45,40,5,45,7.60,89.0
4076,tt0085156,American Nightmare,1983,"1,000+",1499,5,21,11,2.3,19.0,,2,0,2,2,,
4077,tt0109190,Baby's Day Out,1994,"100,000+",186346,1762,1638,2401,3.3,52.0,,16,3,13,16,4.20,19.0
4078,tt0288263,Tom & Thomas,2002,500+,515,33,28,16,3.5,54.0,,0,0,0,0,,
4079,tt1839492,Ruby Sparks,2012,"25,000+",36496,7417,2469,1441,3.7,75.0,,183,145,38,183,7.20,79.0
4080,tt0113080,Flirt,1995,500+,722,113,44,23,3.7,72.0,,11,8,3,11,6.70,73.0
4081,tt0365043,The Challenge,2003,500+,928,11,20,21,2.9,35.0,,0,0,0,0,,
4082,tt0304328,Levity,2003,"2,500+",4998,188,215,123,3.1,47.0,,91,31,60,91,5.30,34.0
4083,tt0447710,Torched,2004,500+,950,78,26,52,3.9,75.0,,1,0,1,1,,
4084,tt0203503,Five Aces,1999,100+,116,1,9,2,2.4,10.0,,2,1,1,2,,
4085,tt0244196,Second Skin,2000,500+,838,9,23,9,3,28.0,,6,1,5,6,4.50,17.0
4086,tt1047519,Red Swastik,2007,100+,152,2,5,2,2.6,29.0,,0,0,0,0,,
4087,tt0283139,White Oleander,2002,"50,000+",50804,4790,1105,2044,4,81.0,,134,92,42,134,6.50,69.0
4088,tt0387117,Childstar,2004,"1,000+",1785,50,69,43,3,42.0,,9,7,2,9,6.00,78.0
4089,tt0103874,Bram Stoker's Dracula,1992,"250,000+",259844,19997,5228,10182,4,79.0,,67,52,15,67,6.90,78.0
4090,tt0810817,The Da Vinci Treasure,2006,250+,275,6,13,3,2.3,32.0,,0,0,0,0,,
4091,tt1398919,90 Ghanta,2008,0,0,0,0,0,,,,0,0,0,0,,
4092,tt0077235,Big Wednesday,1978,"5,000+",5908,679,98,269,4.3,87.0,,12,8,4,12,6.50,67.0
4093,tt0086995,The Boy Who Had Everything,1985,0,0,0,0,0,,,,0,0,0,0,,
4094,tt0085893,Man of Flowers,1983,"1,000+",1746,31,4,15,4.1,89.0,,5,5,0,5,7.50,100.0
4095,tt0318992,Anbulla Rajanikant,1984,0,0,0,0,0,,,,0,0,0,0,,
4096,tt0087835,"Oh, God! You Devil",1984,"5,000+",6443,59,94,64,3.1,39.0,,11,4,7,11,5.50,36.0
4097,tt0990376,Sarah Landon and the Paranormal Hour,2007,500+,821,36,100,76,2.3,26.0,,12,0,12,12,2.90,0.0
4098,tt0103600,555,1988,Fewer than 50,7,1,3,1,,,,0,0,0,0,,
4099,tt0155325,Vagdanam,1961,0,0,0,0,0,,,,0,0,0,0,,
4100,tt0089436,Kommando Leopard,1985,50+,68,3,10,1,2.5,23.0,,0,0,0,0,,
4101,tt0093702,Paramedics,1988,500+,794,14,12,11,3,54.0,,0,0,0,0,,
4102,tt0318819,WXIII: Patlabor the Movie 3,2001,"1,000+",1789,52,36,33,3.5,59.0,,12,6,6,12,5.50,50.0
4103,tt0483756,Nobel Son,2007,"2,500+",3253,334,424,344,3,44.0,,65,17,48,65,4.10,26.0
4104,tt0108311,The Temp,1993,"1,000+",1538,22,102,41,2.5,18.0,,22,7,15,22,4.20,32.0
4105,tt0065374,The Adventurers,1970,"1,000+",1092,10,7,5,3.5,59.0,,3,0,3,3,,
4106,tt0069249,A Separate Peace,1972,0,0,0,0,0,,,,0,0,0,0,,
4107,tt0063591,The Shakiest Gun in the West,1968,"2,500+",3509,143,61,83,3.8,70.0,,1,1,0,1,,
4108,tt0110442,Major League II,1994,"25,000+",47145,1104,1373,758,3.1,45.0,,21,1,20,21,3.30,5.0
4109,tt0107079,Sugar Hill,1993,"5,000+",6723,297,135,131,3.7,69.0,,10,2,8,10,4.90,20.0
4110,tt0112697,Clueless,1995,"250,000+",556445,26250,8457,16683,3.9,76.0,,120,97,23,120,6.90,81.0
4111,tt1191111,Enter the Void,2009,"10,000+",14497,3715,1479,1379,3.7,71.0,,96,70,26,96,6.90,73.0
4112,tt1509767,The Three Musketeers,2011,0,0,0,0,0,,,,0,0,0,0,,
4113,tt0092288,The Zero Boys,1986,"1,000+",1163,22,29,17,3.2,43.0,,3,3,0,3,,
4114,tt0280672,Final Stab,2001,"1,000+",2088,15,70,40,2.1,18.0,,0,0,0,0,,
4115,tt0118836,Chairman of the Board,1997,"2,500+",3612,52,206,102,1.9,20.0,,9,1,8,9,2.60,11.0
4116,tt1801123,Travelling Salesman,2012,Fewer than 50,42,17,11,8,3.4,61.0,,0,0,0,0,,
4117,tt1200065,Kantri,2008,Fewer than 50,11,1,5,0,2.8,17.0,,0,0,0,0,,
4118,tt0363887,Phool Bane Angaray,1991,0,0,0,0,0,,,,0,0,0,0,,
4119,tt0087909,Phenomena,1985,"5,000+",9806,1211,585,587,3.6,67.0,,23,17,6,23,6.30,74.0
4120,tt0365658,The Prophecy: Uprising,2005,"1,000+",2275,41,93,44,2.9,31.0,,0,0,0,0,,
4121,tt0972542,Aachi & Ssipak,2006,500+,795,174,35,113,4,83.0,,0,0,0,0,,
4122,tt0075345,Tracks,1976,Fewer than 50,5,1,3,3,,,,8,4,4,8,4.30,50.0
4123,tt0381940,Cargo,2009,100+,127,16,31,12,3,34.0,,6,4,2,6,6.20,67.0
4124,tt0381940,Cargo,2009,100+,127,16,31,12,3,34.0,,6,4,2,6,6.20,67.0
4125,tt0095253,The Great Outdoors,1988,"25,000+",48269,3055,1273,1411,3.8,71.0,,35,14,21,35,4.80,40.0
4126,tt0056675,War Hunt,1962,"1,000+",1358,13,18,11,3.2,43.0,,1,1,0,1,,
4127,tt0095484,Lady in White,1988,"5,000+",5782,483,220,290,3.7,69.0,,17,12,5,17,6.40,71.0
4128,tt0080863,Hero at Large,1980,"1,000+",1349,92,44,38,3.8,68.0,,3,1,2,3,,
4129,tt0350774,Dead & Breakfast,2004,"10,000+",10714,536,371,583,3.4,59.0,,17,9,8,17,5.90,53.0
4130,tt0120207,Steel,1997,"5,000+",7137,155,654,320,2,19.0,,25,2,23,25,3.00,8.0
4131,tt1130969,Sinners and Saints,2010,250+,404,126,130,81,3.2,49.0,,0,0,0,0,,
4132,tt0866437,The Jane Austen Book Club,2007,"25,000+",27022,5223,2570,3614,3.6,67.0,,115,76,39,115,6.10,66.0
4133,tt1635656,Pixels,2010,Fewer than 50,5,4,1,1,3.6,80.0,,0,0,0,0,,
4134,tt0062374,Titicut Follies,1967,"1,000+",1367,251,31,91,4.3,89.0,,12,12,0,12,7.90,100.0
4135,tt0940585,Brick Lane,2007,"25,000+",44335,788,533,654,3.4,60.0,,103,70,33,103,6.20,68.0
4136,tt0292242,Solino,2002,"2,500+",3342,426,58,61,4.1,88.0,,0,0,0,0,,
4137,tt0942385,Tropic Thunder,2008,"250,000+",297404,47424,19766,28344,3.6,71.0,,253,207,46,253,7.10,82.0
4138,tt0090350,Year of the Dragon,1985,"5,000+",8506,1276,1154,273,3.3,52.0,,20,11,9,20,6.30,55.0
4139,tt0094884,Clean and Sober,1988,"5,000+",5759,265,165,140,3.5,62.0,,15,8,7,15,5.40,53.0
4140,tt0186435,Palimos ng pag-ibig,1986,0,0,0,0,0,,,,0,0,0,0,,
4141,tt0072665,At Long Last Love,1975,250+,304,18,27,17,2.9,40.0,,18,4,14,18,4.90,22.0
4142,tt0289408,The Powerpuff Girls Movie,2002,"5,000+",7085,621,412,380,3.5,60.0,,102,65,37,102,6.10,64.0
4143,tt0067094,The Fiend,1972,Fewer than 50,48,3,8,7,2.9,27.0,,0,0,0,0,,
4144,tt0439641,Jahan Tum Le Chalo,1999,0,0,0,0,0,,,,0,0,0,0,,
4145,tt1056434,Une chanson dans la tête,2008,0,0,0,0,0,,,,1,1,0,1,,
4146,tt0282658,Killer Tattoo,2001,50+,62,5,3,5,3.6,62.0,,0,0,0,0,,
4147,tt0116361,Freeway,1996,"10,000+",22547,2068,656,1132,3.9,76.0,,42,32,10,42,6.90,76.0
4148,tt0081283,Ordinary People,1980,"10,000+",23315,3745,494,1363,4.2,88.0,,104,93,11,104,8.50,89.0
4149,tt1569931,Changing the Game,2012,100+,135,40,11,19,4.3,78.0,,6,5,1,6,6.70,83.0
4150,tt0366658,Kaise Kahoon Ke... Pyaar Hai,2003,0,0,0,0,0,,,,0,0,0,0,,
4151,tt0876294,The Zombie Diaries,2006,"2,500+",4418,167,622,446,2.3,21.0,,3,1,2,3,,
4152,tt0078748,Alien,1979,"250,000+",461828,72403,4834,22244,4.4,94.0,,195,181,14,195,9.10,93.0
4153,tt0101326,American Ninja 4: The Annihilation,1990,"5,000+",8427,59,142,87,2.5,29.0,,2,0,2,2,,
4154,tt0058453,Paris - When It Sizzles,1964,"5,000+",7886,747,389,366,3.6,66.0,,10,5,5,10,5.70,50.0
4155,tt0122718,Small Soldiers,1998,"100,000+",123595,2628,3216,2546,3.2,45.0,,47,23,24,47,6.10,49.0
4156,tt3358534,Thiruvilaiyaadal Aarambam,2006,0,0,0,0,0,,,,0,0,0,0,,
4157,tt0410591,Shart: The Challenge,2004,Fewer than 50,43,2,1,0,,,,0,0,0,0,,
4158,tt1725798,Be-Careful,2011,0,0,0,0,0,,,,1,0,1,1,,
4159,tt0158622,The Flintstones in Viva Rock Vegas,2000,"25,000+",44135,303,1184,571,2.2,20.0,,72,18,54,72,4.10,25.0
4160,tt14287804,Anatharu,2007,0,0,0,0,0,,,,0,0,0,0,,
4161,tt0104691,The Last of the Mohicans,1992,"100,000+",207727,19500,2721,7333,4.2,88.0,,52,48,4,52,8.00,92.0
4162,tt0403508,The Sisterhood of the Traveling Pants,2005,"250,000+",272010,12443,3613,9413,3.9,78.0,,152,125,27,152,6.70,82.0
4163,tt0078788,Apocalypse Now,1979,"250,000+",286833,63408,4043,16517,4.5,94.0,,95,93,2,95,8.90,98.0
4164,tt1525898,The Space Between,2010,100+,176,38,31,15,3.4,55.0,,3,2,1,3,,
4165,tt0129023,Dark Harbor,1998,"2,500+",2676,179,114,134,3.5,61.0,,4,1,3,4,,
4166,tt0290747,Man-Thing,2005,"5,000+",6530,83,515,269,2,14.0,,7,1,6,7,3.70,14.0
4167,tt0100602,A Shock to the System,1990,"1,000+",1872,118,74,45,3.6,61.0,,33,23,10,33,6.70,70.0
4168,tt0082934,The Postman Always Rings Twice,1981,"5,000+",9909,706,504,266,3.4,58.0,,14,11,3,14,6.60,79.0
4169,tt0079583,Mr. Mike's Mondo Video,1979,100+,123,7,14,8,2.3,33.0,,3,2,1,3,,
4170,tt0450340,Unknown,2006,"10,000+",16863,1459,1267,1230,3.3,54.0,,48,18,30,48,5.20,38.0
4171,tt2281161,Corazon: Ang unang aswang,2012,Fewer than 50,36,6,11,9,2.6,35.0,,0,0,0,0,,
4172,tt0066798,"L'aventure, c'est l'aventure",1972,"1,000+",1742,234,15,60,4.4,94.0,,1,0,1,1,,
4173,tt1572167,Rethink Afghanistan,2009,0,0,0,0,0,,,,0,0,0,0,,
4174,tt0172341,Dollar for the Dead,1998,100+,142,3,11,6,2.6,21.0,,4,1,3,4,,
4175,tt0775543,Night Catches Us,2010,"1,000+",1350,181,94,85,3.5,66.0,,58,46,12,58,6.70,79.0
4176,tt1259998,Next Avengers: Heroes of Tomorrow,2008,"2,500+",2974,393,344,263,3.4,53.0,,4,1,3,4,,
4177,tt0466965,Sacred Evil,2006,0,0,0,0,0,,,,0,0,0,0,,
4178,tt0448621,Maraton,2005,"1,000+",2206,302,40,122,4.2,88.0,,1,0,1,1,,
4179,tt0192335,"Mr. Death: The Rise and Fall of Fred A. Leuchter, Jr.",1999,"2,500+",4031,518,80,182,4,87.0,,42,42,0,42,8.50,100.0
4180,tt0338133,Dandelion,2004,"2,500+",2865,290,95,125,3.9,75.0,,13,8,5,13,6.00,62.0
4181,tt0095925,Pumpkinhead,1988,"10,000+",19331,953,1010,767,3.2,48.0,,23,15,8,23,5.70,65.0
4182,tt0246429,"Ángel, la diva y yo",1999,0,0,0,0,0,,,,0,0,0,0,,
4183,tt1210166,Moneyball,2011,"50,000+",92503,43753,6880,7886,4,86.0,,275,259,16,275,8.00,94.0
4184,tt1024255,Wild Child,2008,"10,000+",17584,2551,1597,1307,3.6,61.0,,27,11,16,27,4.80,41.0
4185,tt1031275,Shred,2008,100+,210,6,29,17,2.2,17.0,,0,0,0,0,,
4186,tt0078333,The Stud,1978,50+,50,4,10,3,2.3,29.0,,4,0,4,4,,
4187,tt0118887,Cop Land,1997,"50,000+",51479,3670,1810,1359,3.5,67.0,,68,51,17,68,6.50,75.0
4188,tt0081748,Where the Buffalo Roam,1980,"10,000+",20005,2140,786,1075,3.8,73.0,,26,5,21,26,4.60,19.0
4189,tt0783608,The Walker,2007,"10,000+",10143,202,527,371,2.7,28.0,,63,34,29,63,5.40,54.0
4190,tt0069024,Nothing But the Night,1973,100+,127,12,28,18,2.8,30.0,,1,0,1,1,,
4191,tt0055200,Mr. Sardonicus,1961,"1,000+",1051,70,71,61,3.3,50.0,,10,4,6,10,4.90,40.0
4192,tt0162222,Cast Away,2000,"250,000+",744601,44802,8729,24968,4,84.0,,157,139,18,157,7.40,89.0
4193,tt0086011,A Night in Heaven,1983,500+,916,18,42,28,2.6,30.0,,3,0,3,3,,
4194,tt0411883,Slutty Summer,2004,500+,893,28,50,33,2.8,36.0,,9,1,8,9,3.50,11.0
4195,tt2088967,Valley of Saints,2012,100+,207,17,2,4,4.1,89.0,,9,9,0,9,8.70,100.0
4196,tt0084314,Mazes and Monsters,1982,"2,500+",4328,63,270,163,2.2,19.0,,4,1,3,4,,
4197,tt0432637,Krrish,2006,"5,000+",9352,808,317,452,3.8,72.0,,8,7,1,8,7.00,88.0
4198,tt2244697,Adhinayakudu,2012,Fewer than 50,21,2,2,1,,,,0,0,0,0,,
4199,tt0074207,The Bingo Long Traveling All-Stars & Motor Kings,1976,250+,321,53,25,20,3.7,68.0,,20,18,2,20,6.70,90.0
4200,tt0058920,The Art of Love,1965,100+,197,13,9,10,3.8,59.0,,6,0,6,6,4.60,0.0
4201,tt0436451,Jo Bole So Nihaal,2005,50+,81,0,7,2,1.9,0.0,,0,0,0,0,,
4202,tt0155329,Varumayin Niram Sigappu,1980,0,0,0,0,0,,,,0,0,0,0,,
4203,tt0111323,Surviving the Game,1994,"5,000+",8031,427,467,308,3.2,48.0,,19,6,13,19,4.60,32.0
4204,tt0112442,Bad Boys,1995,"250,000+",661191,28729,8237,12340,3.9,78.0,,67,29,38,67,5.30,43.0
4205,tt0065537,Change of Habit,1969,"5,000+",6087,123,69,137,3.7,64.0,,10,1,9,10,3.90,10.0
4206,tt0111756,Wyatt Earp,1994,"50,000+",50268,2605,1635,1178,3.5,61.0,,84,26,58,84,5.40,31.0
4207,tt0360201,Wimbledon,2004,"50,000+",95502,4195,3161,2809,3.4,57.0,,146,89,57,146,5.90,61.0
4208,tt0111048,S.F.W.,1994,"5,000+",5742,205,212,138,3.2,49.0,,17,2,15,17,4.00,12.0
4209,tt0358349,Agent Cody Banks 2: Destination London,2004,"100,000+",219757,673,1501,1336,2.6,31.0,,94,12,82,94,3.60,13.0
4210,tt0100046,The Long Walk Home,1990,"5,000+",5428,286,53,110,4,84.0,,17,15,2,17,6.70,88.0
4211,tt0129908,Ernest in the Army,1998,"5,000+",9488,89,192,106,2.8,32.0,,6,1,5,6,3.60,17.0
4212,tt1111881,Calcutta News,2008,0,0,0,0,0,,,,0,0,0,0,,
4213,tt0364376,The Gingerdead Man,2005,"2,500+",4033,182,468,351,2.4,28.0,,4,3,1,4,,
4214,tt0064393,The Green Slime,1968,"1,000+",1003,67,99,82,2.9,40.0,,13,3,10,13,4.50,23.0
4215,tt0055100,Lover Come Back,1961,"5,000+",5748,428,127,180,3.9,77.0,,12,11,1,12,6.50,92.0
4216,tt0490134,Ghostboat,2006,50+,52,4,3,3,3.5,57.0,,1,1,0,1,,
4217,tt0808339,Largo Winch,2008,"2,500+",4005,502,522,306,3.2,49.0,,18,9,9,18,5.20,50.0
4218,tt0200472,Beautiful Joe,2000,250+,415,21,35,7,3,38.0,,5,3,2,5,5.60,60.0
4219,tt0085346,Class,1983,"5,000+",7075,339,343,194,3.3,50.0,,14,4,10,14,4.90,29.0
4220,tt0264323,2001 Maniacs,2005,"5,000+",9626,666,731,747,3.1,48.0,,3,2,1,3,,
4221,tt0074238,Breaking Point,1976,100+,134,5,6,6,3.2,45.0,,1,0,1,1,,
4222,tt0348078,Souten,1983,100+,157,4,4,2,3.4,50.0,,0,0,0,0,,
4223,tt0114095,Party Girl,1995,"5,000+",6161,560,182,273,3.8,75.0,,37,30,7,37,6.30,81.0
4224,tt0449471,Catacombs,2007,"2,500+",4178,273,974,700,2.3,22.0,,3,0,3,3,,
4225,tt1059786,Eagle Eye,2008,"250,000+",307494,39778,24562,15094,3.6,62.0,,182,48,134,182,4.70,26.0
4226,tt0226581,Urge to Kill,1960,Fewer than 50,1,1,0,0,,,,0,0,0,0,,
4227,tt0090860,Cocaine Wars,1985,50+,64,1,5,2,2.5,17.0,,0,0,0,0,,
4228,tt0387301,"I Want a Dog for Christmas, Charlie Brown",2003,"5,000+",8316,169,46,76,3.9,79.0,,3,2,1,3,,
4229,tt0209958,The Cell,2000,"100,000+",181026,4913,3696,5193,3.4,57.0,,166,75,91,166,5.60,45.0
4230,tt0060645,Madame X,1966,500+,688,133,33,62,4.1,80.0,,6,3,3,6,6.50,50.0
4231,tt0104346,Gladiator,1992,"5,000+",9824,568,259,308,3.7,69.0,,13,4,9,13,4.40,31.0
4232,tt0092794,Crazy Love,1987,"1,000+",1088,48,14,31,3.9,77.0,,2,2,0,2,,
4233,tt1232207,Capitalism: A Love Story,2009,"50,000+",70741,5924,2113,2753,3.7,74.0,,189,141,48,189,6.70,75.0
4234,tt0116607,If These Walls Could Talk,1996,"5,000+",6145,399,142,166,3.8,74.0,,8,7,1,8,6.00,88.0
4235,tt0109445,Clerks,1994,"250,000+",285713,44282,5444,14899,4.2,89.0,,60,54,6,60,7.50,90.0
4236,tt0115710,Blood and Wine,1996,"2,500+",3217,149,272,80,3,35.0,,31,19,12,31,6.10,61.0
4237,tt0493439,On the Doll,2007,500+,525,75,95,76,3,44.0,,2,1,1,2,,
4238,tt0053751,Date Bait,1960,Fewer than 50,13,0,3,1,,,,0,0,0,0,,
4239,tt0117238,Omega Doom,1996,"1,000+",1215,25,68,47,2.3,27.0,,0,0,0,0,,
4240,tt0097438,Gleaming the Cube,1989,"5,000+",8855,685,315,407,3.8,69.0,,7,2,5,7,4.20,29.0
4241,tt1544572,The Search for Santa Paws,2010,500+,774,248,154,112,3.6,62.0,,4,2,2,4,,
4242,tt0099797,The Hot Spot,1990,"2,500+",3961,226,235,119,3.3,49.0,,28,20,8,28,6.10,71.0
4243,tt0120762,Mulan,1998,Fewer than 50,20,18,2,4,4.3,90.0,,0,0,0,0,,
4244,tt0087995,Repo Man,1984,"25,000+",31898,3681,1032,1508,3.9,78.0,,52,51,1,52,8.00,98.0
4245,tt1679235,Mean Girls 2,2011,"5,000+",5789,640,1494,412,2.5,30.0,,2,1,1,2,,
4246,tt0098660,Wired,1989,250+,384,7,39,28,1.5,15.0,,27,1,26,27,3.50,4.0
4247,tt0153545,Vijeta,1982,Fewer than 50,9,3,1,0,,,,0,0,0,0,,
4248,tt0158845,Pati Patni Aur Woh,1978,50+,67,4,3,1,3.9,57.0,,0,0,0,0,,
4249,tt0380201,Back in the Day,2005,500+,763,45,33,27,3.5,58.0,,0,0,0,0,,
4250,tt0093830,Rebel High,1987,0,0,0,0,0,,,,0,0,0,0,,
4251,tt1610528,Airline Disaster,2010,100+,196,15,57,30,1.9,21.0,,1,0,1,1,,
4252,tt0085410,Deadly Lessons,1983,0,0,0,0,0,,,,0,0,0,0,,
4253,tt1000771,Recount,2008,"2,500+",4357,1297,302,747,3.8,81.0,,33,26,7,33,6.70,79.0
4254,tt0075314,Taxi Driver,1976,Fewer than 50,7,6,1,0,4.1,86.0,,0,0,0,0,,
4255,tt1748158,Paul Goodman Changed My Life,2011,250+,259,14,10,5,3.2,58.0,,20,19,1,20,7.00,95.0
4256,tt1781768,Ang tanging ina mo: Last na 'to!,2010,50+,53,9,7,6,3.5,56.0,,0,0,0,0,,
4257,tt0945556,Finding Kraftland,2007,Fewer than 50,2,2,0,0,,,,1,0,1,1,,
4258,tt0117665,Sleepers,1996,"50,000+",93229,10402,1884,3012,4,85.0,,56,41,15,56,6.60,73.0
4259,tt0115847,Caught,1996,500+,716,46,20,15,3.6,70.0,,13,10,3,13,6.50,77.0
4260,tt0096332,The Unbearable Lightness of Being,1988,"10,000+",19506,3215,599,955,4.1,84.0,,29,25,4,29,8.20,86.0
4261,tt0134951,School's Out!,1992,"2,500+",3673,161,25,109,4.3,86.0,,0,0,0,0,,
4262,tt0109758,Exit to Eden,1994,"5,000+",9512,129,376,255,2.4,26.0,,19,1,18,19,3.20,5.0
4263,tt0053884,Guns of the Timberland,1960,Fewer than 50,4,0,3,2,,,,1,1,0,1,,
4264,tt0173081,Pyaar To Hona Hi Tha,1998,"1,000+",1120,81,42,23,3.6,66.0,,0,0,0,0,,
4265,tt0443543,The Illusionist,2006,"250,000+",417436,55265,11172,26505,4,83.0,,196,144,52,196,6.90,73.0
4266,tt0116601,I'm Not Rappaport,1996,"1,000+",1103,58,38,33,3.6,60.0,,16,6,10,16,6.00,38.0
4267,tt0097017,The Carpenter,1988,50+,50,1,10,2,2.1,9.0,,1,0,1,1,,
4268,tt0456320,Bow Barracks Forever,2004,100+,193,9,5,9,3.2,64.0,,2,0,2,2,,
4269,tt0105211,Radio Flyer,1992,"10,000+",15632,1289,493,480,3.8,72.0,,40,14,26,40,4.70,35.0
4270,tt0140379,A Midsummer Night's Dream,1999,Fewer than 50,19,6,3,3,3.3,67.0,,0,0,0,0,,
4271,tt0120797,Pushing Tin,1999,"25,000+",33908,1000,1376,653,3.1,42.0,,67,32,35,67,5.50,48.0
4272,tt0070509,The Paper Chase,1973,"2,500+",4528,493,193,218,3.7,72.0,,31,25,6,31,7.20,81.0
4273,tt1699520,Turnout,2011,50+,50,7,14,5,3,33.0,,10,3,7,10,4.30,30.0
4274,tt1270847,Skiptracers,2009,Fewer than 50,18,1,0,1,,,,2,0,2,2,,
4275,tt0404030,Everything Is Illuminated,2005,"50,000+",59948,11029,1429,4770,4.2,89.0,,118,78,40,118,6.50,66.0
4276,tt0314097,The Gathering Storm,2002,500+,748,218,51,77,3.9,81.0,,6,5,1,6,6.60,83.0
4277,tt1583421,G.I. Joe: Retaliation,2013,"100,000+",199276,24892,26915,5839,3.2,48.0,,182,52,130,182,4.50,29.0
4278,tt0082252,The Decline of Western Civilization,1981,"2,500+",2689,384,75,125,4.1,84.0,,41,41,0,41,8.20,100.0
4279,tt0158698,Karm,1977,0,0,0,0,0,,,,0,0,0,0,,
4280,tt0435761,Toy Story 3,2010,"250,000+",608603,158570,18549,26248,4.4,90.0,,313,308,5,313,8.90,98.0
4281,tt0080066,Up from the Depths,1979,50+,77,2,20,9,1.7,9.0,,2,0,2,2,,
4282,tt0064403,Hannibal Brooks,1969,500+,577,53,10,27,4.1,84.0,,0,0,0,0,,
4283,tt0302531,Endangered Species,2002,Fewer than 50,15,0,2,1,,,,0,0,0,0,,
4284,tt1504508,Yelling to the Sky,2011,250+,409,58,69,20,3.2,46.0,,11,4,7,11,5.50,36.0
4285,tt0772181,Krabat,2008,500+,656,123,140,76,3.2,47.0,,0,0,0,0,,
4286,tt1579540,Ek Niranjan,2009,Fewer than 50,12,2,1,0,,,,0,0,0,0,,
4287,tt0086618,Yellowbeard,1983,"5,000+",6952,419,240,281,3.6,64.0,,9,2,7,9,5.00,22.0
4288,tt1222698,Beneath the Blue,2010,100+,123,31,19,9,3.5,62.0,,1,1,0,1,,
4289,tt1259227,SoulBoy,2010,250+,443,39,43,28,3.2,48.0,,8,6,2,8,5.70,75.0
4290,tt0095182,The Frog Prince,1986,"1,000+",1176,81,25,45,4,76.0,,1,0,1,1,,
4291,tt0870222,Surviving My Mother,2007,Fewer than 50,8,3,0,0,,,,1,1,0,1,,
4292,tt0369918,Shallow Ground,2004,"2,500+",4556,122,247,185,2.8,33.0,,7,4,3,7,5.80,57.0
4293,tt0094125,Terror Squad,1987,Fewer than 50,12,1,3,1,,,,1,0,1,1,,
4294,tt0112365,Angels and Insects,1995,"2,500+",2599,136,66,64,3.6,67.0,,22,15,7,22,6.60,68.0
4295,tt0198364,Chalo America,1999,0,0,0,0,0,,,,0,0,0,0,,
4296,tt0111205,Sister My Sister,1994,"1,000+",1365,128,71,72,3.6,65.0,,8,5,3,8,5.90,63.0
4297,tt0897347,The Echo,2008,"1,000+",1207,144,307,165,2.9,32.0,,1,0,1,1,,
4298,tt1788391,Kill List,2011,"5,000+",9833,2442,1764,998,3.3,58.0,,96,75,21,96,7.30,78.0
4299,tt0108360,Tomcat: Dangerous Desires,1993,50+,74,3,6,3,2.6,33.0,,0,0,0,0,,
4300,tt0407536,The Aryan Couple,2004,500+,975,65,48,64,3.4,57.0,,26,3,23,26,3.60,12.0
4301,tt0064026,Angel in My Pocket,1969,250+,403,20,3,8,4.2,87.0,,0,0,0,0,,
4302,tt0155072,Pyar Hua Chori Chori,1992,0,0,0,0,0,,,,0,0,0,0,,
4303,tt0088170,Star Trek III: The Search for Spock,1984,"50,000+",56999,107,64,23,3.5,63.0,,51,40,11,51,6.40,78.0
4304,tt0268437,The Man Who Sued God,2001,"5,000+",7389,359,253,272,3.4,59.0,,7,5,2,7,5.80,71.0
4305,tt0093996,Slumber Party Massacre II,1987,"2,500+",3070,116,207,160,2.7,36.0,,4,0,4,4,,
4306,tt2955542,Chattakkari,2012,0,0,0,0,0,,,,0,0,0,0,,
4307,tt0114726,Trimurti,1995,0,0,0,0,0,,,,0,0,0,0,,
4308,tt0098067,Parenthood,1989,"25,000+",49449,3156,1005,1274,3.8,76.0,,60,55,5,60,7.50,92.0
4309,tt0059518,None But the Brave,1965,500+,608,30,22,24,3.6,58.0,,2,0,2,2,,
4310,tt0300902,Absolon,2003,"1,000+",1532,30,105,47,2.2,22.0,,0,0,0,0,,
4311,tt0357585,Decoys,2004,"5,000+",6602,89,270,156,2.5,25.0,,2,1,1,2,,
4312,tt0094140,Three for the Road,1987,100+,143,13,18,5,3.2,42.0,,0,0,0,0,,
4313,tt0196635,International Khiladi,1999,250+,294,4,9,1,3,31.0,,0,0,0,0,,
4314,tt0094955,The Dawning,1988,250+,386,3,3,3,3.2,50.0,,1,0,1,1,,
4315,tt0054653,Back Street,1961,100+,237,33,14,20,3.9,70.0,,2,1,1,2,,
4316,tt0082511,Hell Night,1981,"2,500+",4975,194,240,182,3.2,45.0,,14,8,6,14,5.00,57.0
4317,tt0113851,Moonlight and Valentino,1995,"5,000+",5380,163,158,127,3.3,51.0,,13,2,11,13,4.60,15.0
4318,tt0381966,Creep,2004,"25,000+",31807,970,1519,1361,2.9,39.0,,15,6,9,15,4.30,40.0
4319,tt1727506,How to Stop Being a Loser,2011,50+,65,9,26,8,2.5,26.0,,7,0,7,7,3.30,0.0
4320,tt1666177,Seetha Kalyanam,2009,0,0,0,0,0,,,,0,0,0,0,,
4321,tt0085615,Gorky Park,1983,"2,500+",4672,329,230,148,3.4,59.0,,27,21,6,27,6.60,78.0
4322,tt1503178,Theeradha Vilaiyattu Pillai,2010,Fewer than 50,8,0,1,0,,,,0,0,0,0,,
4323,tt0228157,"Cor, Blimey!",2000,50+,87,13,7,8,3.6,63.0,,2,2,0,2,,
4324,tt1735898,Snow White and the Huntsman,2012,"250,000+",410426,38835,36458,12192,3.3,52.0,,240,117,123,240,5.60,49.0
4325,tt4316178,Kanagavel Kaaka,2010,0,0,0,0,0,,,,0,0,0,0,,
4326,tt0082479,Antropophagus,1980,50+,72,14,40,15,2.6,26.0,,0,0,0,0,,
4327,tt1252483,Evolution: The Musical!,2008,Fewer than 50,4,0,1,0,,,,0,0,0,0,,
4328,tt0428303,Cavite,2005,"10,000+",20969,65,54,81,3.3,54.0,,40,29,11,40,6.40,73.0
4329,tt0078736,Agatha,1979,250+,296,53,36,25,3.4,60.0,,14,10,4,14,6.50,71.0
4330,tt0319061,Big Fish,2003,"250,000+",498735,75131,8944,26362,4.2,89.0,,219,165,54,219,7.10,75.0
4331,tt0341455,Makdee,2002,50+,99,12,6,3,3.4,67.0,,1,1,0,1,,
4332,tt1632570,Nammal Thammil,2009,0,0,0,0,0,,,,0,0,0,0,,
4333,tt0129794,Un borghese piccolo piccolo,1977,0,0,0,0,0,,,,0,0,0,0,,
4334,tt0064397,The Gypsy Moths,1969,500+,637,24,32,17,3.2,43.0,,3,3,0,3,,
4335,tt0455584,The Kovak Box,2006,"1,000+",1842,103,180,131,2.9,37.0,,1,1,0,1,,
4336,tt1403981,Remember Me,2010,"250,000+",411788,13625,6248,6172,3.7,69.0,,139,36,103,139,4.50,26.0
4337,tt0345543,The Land Before Time IX: Journey to Big Water,2002,"25,000+",43777,192,222,273,3.3,46.0,,0,0,0,0,,
4338,tt0091867,A Room with a View,1985,"25,000+",25533,4293,743,1352,4.2,85.0,,34,34,0,34,8.40,100.0
4339,tt6827584,Priyamudan,1998,0,0,0,0,0,,,,0,0,0,0,,
4340,tt0085913,Masoom,1983,100+,223,46,3,9,4.4,94.0,,1,1,0,1,,
4341,tt2071445,Deranged,2012,100+,191,48,38,10,3.3,56.0,,5,3,2,5,4.90,60.0
4342,tt0454578,Yaraan Naal Baharaan,2005,0,0,0,0,0,,,,0,0,0,0,,
4343,tt0174268,The Third Miracle,1999,"1,000+",1397,66,48,32,3.5,58.0,,34,23,11,34,6.10,68.0
4344,tt0430202,Sandwich,2006,500+,814,12,19,11,2.8,39.0,,0,0,0,0,,
4345,tt0091991,Soul Man,1986,"5,000+",6975,178,333,184,2.8,35.0,,24,4,20,24,3.50,17.0
4346,tt0100645,Snake Eater,1989,100+,218,12,30,28,2.5,29.0,,0,0,0,0,,
4347,tt0056874,Blind Corner,1964,Fewer than 50,1,1,0,0,,,,0,0,0,0,,
4348,tt0060672,Mars Needs Women,1968,100+,187,4,30,19,1.8,12.0,,9,0,9,9,2.80,0.0
4349,tt0309404,Bungalow,2002,100+,184,6,9,6,,,,3,1,2,3,,
4350,tt0092699,Broadcast News,1987,"10,000+",11092,1975,529,623,3.9,79.0,,57,56,1,57,8.40,98.0
4351,tt0073096,Hearts of the West,1975,100+,153,18,24,12,3.1,43.0,,10,9,1,10,6.30,90.0
4352,tt0082822,Nobody's Perfekt,1981,Fewer than 50,13,0,2,1,,,,1,0,1,1,,
4353,tt0124718,He Got Game,1998,"25,000+",44545,4812,978,1376,4.1,83.0,,66,53,13,66,6.90,80.0
4354,tt0271347,Aayiram Naavulla Ananthan,1996,0,0,0,0,0,,,,0,0,0,0,,
4355,tt0102741,Queens Logic,1991,"1,000+",1222,25,47,17,3,35.0,,10,3,7,10,4.90,30.0
4356,tt0391165,Fun2shh... Dudes in the 10th Century,2003,0,0,0,0,0,,,,0,0,0,0,,
4357,tt0237072,Cannibal Rollerbabes,1997,Fewer than 50,5,1,0,0,,,,1,0,1,1,,
4358,tt1541943,To Catch a Dollar: Muhammad Yunus Banks on America,2010,50+,54,8,0,4,4.5,100.0,,1,0,1,1,,
4359,tt2373632,Kalloori Vaasal,1996,0,0,0,0,0,,,,0,0,0,0,,
4360,tt0053672,The Boy and the Pirates,1960,100+,116,1,10,6,2.6,9.0,,2,1,1,2,,
4361,tt0069372,The Thing with Two Heads,1972,250+,366,30,89,59,2.5,25.0,,8,0,8,8,3.00,0.0
4362,tt0093493,Mannequin,1987,"25,000+",44803,1702,1378,1500,3.4,55.0,,40,8,32,40,3.90,20.0
4363,tt0887883,Burn After Reading,2008,"100,000+",188200,31782,17409,20362,3.4,65.0,,248,193,55,248,6.90,78.0
4364,tt0073698,Sheila Levine Is Dead and Living in New York,1975,Fewer than 50,12,4,3,1,3.6,57.0,,14,6,8,14,7.50,43.0
4365,tt1680305,Afghan Luke,2011,50+,68,10,34,11,2.6,23.0,,2,0,2,2,,
4366,tt0120402,Ulee's Gold,1997,"2,500+",2934,282,93,101,3.7,75.0,,51,48,3,51,8.10,94.0
4367,tt0115631,Soul of the Game,1996,100+,123,25,14,10,3.6,64.0,,6,4,2,6,6.90,67.0
4368,tt1117394,Transcendent Man,2009,500+,771,276,58,106,3.9,83.0,,1,1,0,1,,
4369,tt0984243,Vaanmathi,1996,0,0,0,0,0,,,,0,0,0,0,,
4370,tt0960066,The Black Waters of Echo's Pond,2009,"1,000+",1052,22,102,51,2.3,18.0,,18,4,14,18,3.80,22.0
4371,tt0107818,Philadelphia,1993,"100,000+",183601,14280,1827,4679,4.1,89.0,,63,51,12,63,6.90,81.0
4372,tt0156856,Paar Magale Paar,1963,0,0,0,0,0,,,,0,0,0,0,,
4373,tt0865554,The Informers,2008,"10,000+",18522,351,1561,784,2.2,18.0,,105,13,92,105,3.80,12.0
4374,tt0229952,Aaye Din Bahar Ke,1966,0,0,0,0,0,,,,0,0,0,0,,
4375,tt1174732,An Education,2009,"50,000+",55054,13897,3477,4725,3.8,80.0,,198,185,13,198,7.90,93.0
4376,tt0079638,Norma Rae,1979,"5,000+",7213,656,173,221,3.8,79.0,,32,29,3,32,7.60,91.0
4377,tt0068230,Asylum,1972,250+,321,65,67,27,3.3,49.0,,12,8,4,12,6.70,67.0
4378,tt0176948,Love and Action in Chicago,1999,"1,000+",1248,13,11,3,3.3,54.0,,3,0,3,3,,
4379,tt1531677,Hauling,2010,0,0,0,0,0,,,,0,0,0,0,,
4380,tt1648179,Here Comes the Boom,2012,"50,000+",60780,15303,8163,2465,3.7,65.0,,98,41,57,98,5.00,42.0
4381,tt0070903,The Way We Were,1973,"10,000+",21533,2847,661,1198,4,81.0,,36,23,13,36,6.30,64.0
4382,tt0896036,BloodRayne II: Deliverance,2007,"2,500+",4538,106,663,397,1.7,14.0,,4,0,4,4,,
4383,tt1701218,Mysteria,2011,Fewer than 50,13,2,7,3,1.9,22.0,,0,0,0,0,,
4384,tt0284478,Charlotte Sometimes,2002,500+,630,54,20,28,3.7,73.0,,43,35,8,43,6.80,81.0
4385,tt0183808,Spanish Judges,2000,"1,000+",1150,13,15,15,3.2,46.0,,3,0,3,3,,
4386,tt0061380,The Ballad of Josie,1967,100+,244,15,12,10,3.6,56.0,,0,0,0,0,,
4387,tt0101518,Bullseye!,1990,100+,179,7,31,12,2.3,18.0,,1,0,1,1,,
4388,tt0213565,The Color of Friendship,2000,"2,500+",4148,298,89,146,4,77.0,,6,6,0,6,7.80,100.0
4389,tt0478988,The Call of Cthulhu,2005,"2,500+",4560,753,135,402,4,85.0,,6,6,0,6,7.10,100.0
4390,tt0206036,If These Walls Could Talk 2,2000,"10,000+",10448,1006,199,353,4.1,83.0,,4,2,2,4,,
4391,tt0066434,THX 1138,1971,"25,000+",28273,3992,1450,1808,3.7,73.0,,66,57,9,66,6.80,86.0
4392,tt0100728,Syngenor,1990,100+,230,5,21,13,2.4,19.0,,1,0,1,1,,
4393,tt0296845,Little Secrets,2001,"5,000+",7937,282,200,191,3.5,58.0,,48,29,19,48,5.50,60.0
4394,tt0487116,Obsession: Radical Islam's War Against the West,2005,Fewer than 50,4,3,0,0,,,,0,0,0,0,,
4395,tt0099763,Henry: Portrait of a Serial Killer,1986,"10,000+",11707,2041,826,938,3.7,71.0,,65,58,7,65,7.90,89.0
4396,tt0099401,Demon Wind,1990,100+,199,16,57,24,2.6,22.0,,3,2,1,3,,
4397,tt8669098,Thithikudhe,2003,0,0,0,0,0,,,,0,0,0,0,,
4398,tt0097239,Driving Miss Daisy,1989,"50,000+",53840,4934,1156,1640,3.9,81.0,,105,89,16,105,7.70,85.0
4399,tt0118702,Best Men,1997,"2,500+",4373,88,132,82,3.1,40.0,,8,1,7,8,4.70,13.0
4400,tt0058615,The Starfighters,1964,250+,266,4,67,39,1.1,6.0,,0,0,0,0,,
4401,tt0089820,Poison Ivy,1985,100+,232,23,31,5,3,43.0,,0,0,0,0,,
4402,tt1045898,Veyyil,2006,0,0,0,0,0,,,,0,0,0,0,,
4403,tt0099615,The Freshman,1990,"10,000+",11889,858,542,319,3.5,61.0,,52,49,3,52,7.50,94.0
4404,tt0400186,Chanthupottu,2005,0,0,0,0,0,,,,0,0,0,0,,
4405,tt0091284,Janbaaz,1986,250+,302,10,5,1,3.8,67.0,,0,0,0,0,,
4406,tt0077636,The Greek Tycoon,1978,Fewer than 50,43,4,11,2,2.3,27.0,,5,0,5,5,4.20,0.0
4407,tt1276961,Holy Land Hardball,2009,0,0,0,0,0,,,,0,0,0,0,,
4408,tt0060472,Grand Prix,1966,"2,500+",4249,678,92,310,4.2,88.0,,12,11,1,12,7.80,92.0
4409,tt1372686,Coriolanus,2011,"10,000+",13656,2706,1947,959,3.3,58.0,,156,143,13,156,7.40,92.0
4410,tt0094824,Caddyshack II,1988,"25,000+",27463,239,1131,490,2.1,17.0,,24,1,23,24,2.80,4.0
4411,tt0074475,Embryo,1976,500+,506,10,51,31,2.4,16.0,,3,0,3,3,,
4412,tt0082495,Halloween II,1981,"50,000+",77571,5998,3489,2996,3.6,63.0,,48,16,32,48,4.80,33.0
4413,tt0072081,The Return of the Pink Panther,1975,"25,000+",41530,2080,462,729,4,82.0,,20,17,3,20,6.70,85.0
4414,tt0893412,From Prada to Nada,2011,"10,000+",14326,1068,1562,377,3,41.0,,20,4,16,20,4.10,20.0
4415,tt0336325,Dracula II: Ascension,2003,"5,000+",7456,126,292,141,2.5,30.0,,7,0,7,7,3.30,0.0
4416,tt0276935,Electric Dragon 80.000 V,2001,"1,000+",2057,246,57,137,4,81.0,,2,2,0,2,,
4417,tt0055623,Wild in the Country,1961,"1,000+",1883,51,38,37,3.6,57.0,,8,4,4,8,5.80,50.0
4418,tt0089981,Secret Admirer,1985,"2,500+",4262,278,153,157,3.7,65.0,,12,4,8,12,5.20,33.0
4419,tt0089239,Guilty Conscience,1985,100+,118,7,9,6,3.3,44.0,,0,0,0,0,,
4420,tt0758753,If I Had Known I Was a Genius,2007,500+,561,3,28,13,2,10.0,,4,1,3,4,,
4421,tt1407085,Passione,2010,250+,326,39,23,7,3.6,63.0,,38,34,4,38,7.20,89.0
4422,tt2401225,Uu Kodathara Ulikki Padathara,2012,100+,164,117,4,0,4.8,97.0,,0,0,0,0,,
4423,tt0074119,All the President's Men,1976,"50,000+",50501,8046,703,2255,4.3,92.0,,71,67,4,71,9.10,94.0
4424,tt1727300,Hunky Dory,2011,500+,734,78,82,39,3.3,49.0,,46,25,21,46,5.40,54.0
4425,tt0151121,Jeans,1998,250+,384,30,21,13,3.3,59.0,,0,0,0,0,,
4426,tt0096523,L'étudiante,1988,0,0,0,0,0,,,,0,0,0,0,,
4427,tt0281536,Aayiram Janmangal,1976,0,0,0,0,0,,,,0,0,0,0,,
4428,tt1784499,Kurtlar Vadisi: Filistin,2011,100+,108,30,20,10,3.5,59.0,,1,1,0,1,,
4429,tt0057134,Heavens Above!,1963,250+,468,43,18,23,3.7,70.0,,3,1,2,3,,
4430,tt0098625,We're No Angels,1989,"5,000+",8709,440,637,185,3.1,41.0,,20,9,11,20,5.00,45.0
4431,tt0115482,After Jimmy,1996,50+,56,1,6,0,2.9,14.0,,0,0,0,0,,
4432,tt0212346,Miss Congeniality,2000,"250,000+",975766,19886,9008,19658,3.7,69.0,,116,48,68,116,5.10,41.0
4433,tt0095654,Moon Over Parador,1988,"2,500+",2681,100,114,69,3.2,47.0,,12,5,7,12,4.80,42.0
4434,tt0453548,Snow Angels,2007,"5,000+",6702,1491,733,1092,3.6,67.0,,113,76,37,113,6.70,67.0
4435,tt0385568,Bullet Boy,2004,"2,500+",3170,200,75,119,3.8,73.0,,3,3,0,3,,
4436,tt0422093,Diary of a Mad Black Woman,2005,"50,000+",89201,10760,1690,5074,4.3,86.0,,114,18,96,114,4.00,16.0
4437,tt0088213,Swing Shift,1984,"2,500+",3387,93,130,58,3.1,42.0,,15,13,2,15,7.10,87.0
4438,tt0099587,Flight of the Intruder,1991,"5,000+",5989,189,183,92,3.3,51.0,,12,3,9,12,4.80,25.0
4439,tt0460810,The Great Buck Howard,2008,"25,000+",32220,977,1015,719,3.2,49.0,,95,67,28,95,6.40,71.0
4440,tt0452702,Vacancy,2007,"250,000+",303118,10143,13737,13318,3,42.0,,124,68,56,124,5.50,55.0
4441,tt1037156,Stone of Destiny,2008,"1,000+",1793,313,225,241,3.4,58.0,,17,9,8,17,5.00,53.0
4442,tt0195234,Saving Grace,2000,"10,000+",11537,1739,346,727,4.1,83.0,,89,56,33,89,6.00,63.0
4443,tt0068370,Children Shouldn't Play with Dead Things,1972,"5,000+",6504,140,216,211,2.9,39.0,,16,8,8,16,5.50,50.0
4444,tt0308417,Is Raat Ki Subah Nahin,1996,100+,129,11,3,5,3.6,79.0,,0,0,0,0,,
4445,tt1483773,Kovil,2003,Fewer than 50,17,4,4,0,3.2,50.0,,0,0,0,0,,
4446,tt0104237,Damage,1992,"5,000+",6547,866,327,312,3.7,73.0,,26,21,5,26,6.90,81.0
4447,tt0065989,Little Fauss and Big Halsy,1970,250+,361,34,39,18,3.1,47.0,,6,2,4,6,4.50,33.0
4448,tt0903013,Riding Solo to the Top of the World,2006,Fewer than 50,1,1,0,0,,,,0,0,0,0,,
4449,tt1874633,Musical Chairs,2011,250+,397,22,6,12,3.9,78.0,,19,7,12,19,5.50,37.0
4450,tt0370032,Ultraviolet,2006,"250,000+",280162,4186,9736,8712,2.5,30.0,,83,7,76,83,3.00,8.0
4451,tt0167250,Late Last Night,1999,250+,354,19,17,17,3.3,53.0,,3,1,2,3,,
4452,tt1661031,Brindaavanam,2010,Fewer than 50,1,1,0,0,,,,0,0,0,0,,
4453,tt1615065,Savages,2012,"100,000+",136809,20382,17117,3567,3.4,54.0,,195,98,97,195,5.80,50.0
4454,tt1353157,The Blue Mansion,2009,100+,130,10,8,12,3.4,56.0,,0,0,0,0,,
4455,tt0087736,Mohan Joshi Hazir Ho!,1984,Fewer than 50,25,1,1,0,,,,0,0,0,0,,
4456,tt0079308,Hot Stuff,1979,500+,504,34,12,12,3.8,74.0,,1,1,0,1,,
4457,tt0381911,Beautiful Girl,2003,250+,262,12,15,10,3,44.0,,0,0,0,0,,
4458,tt0784972,The Brothers Solomon,2007,"50,000+",56518,1256,2755,1922,2.7,31.0,,73,12,61,73,3.70,16.0
4459,tt3251832,Bratz: Genie Magic,2006,"2,500+",3858,71,24,66,3.9,75.0,,1,0,1,1,,
4460,tt1121977,Mother and Child,2009,"5,000+",6969,1224,397,443,3.7,76.0,,131,103,28,131,6.70,79.0
4461,tt1252298,The Human Experience,2008,500+,875,240,62,80,4,79.0,,1,0,1,1,,
4462,tt0062341,Tarzan and the Great River,1967,Fewer than 50,19,3,10,4,2.6,23.0,,1,0,1,1,,
4463,tt0064133,Carry on Camping,1969,"5,000+",7879,379,109,235,4,78.0,,5,2,3,5,5.50,40.0
4464,tt1592525,Lockout,2012,"100,000+",164539,9537,11367,2683,3.2,46.0,,143,54,89,143,5.00,38.0
4465,tt0057187,Irma la Douce,1963,"5,000+",5891,773,212,272,3.8,78.0,,21,16,5,21,7.00,76.0
4466,tt0331175,Any Way the Wind Blows,2003,100+,175,144,31,37,3.9,82.0,,1,1,0,1,,
4467,tt0479528,Rogue,2007,"5,000+",8174,1728,1489,1413,3.3,54.0,,18,16,2,18,7.30,89.0
4468,tt0057239,The L-Shaped Room,1962,250+,333,57,12,15,4,83.0,,9,6,3,9,6.80,67.0
4469,tt0449189,Banaras,2006,0,0,0,0,0,,,,0,0,0,0,,
4470,tt0090376,The Zoo Gang,1985,Fewer than 50,19,4,1,0,3.8,80.0,,0,0,0,0,,
4471,tt0098645,Who's Harry Crumb?,1989,"10,000+",18656,528,621,350,3.2,46.0,,11,3,8,11,4.00,27.0
4472,tt0098987,The Adventures of Ford Fairlane,1990,"5,000+",8581,1043,502,550,3.7,67.0,,32,8,24,32,4.30,25.0
4473,tt0090961,Dot and the Whale,1986,250+,296,11,9,8,3.4,55.0,,0,0,0,0,,
4474,tt0462250,Automatons,2006,100+,239,8,8,8,3,50.0,,8,5,3,8,5.70,63.0
4475,tt0480239,Atlas Shrugged: Part I,2011,"10,000+",17017,3402,1530,1676,3.6,69.0,,51,6,45,51,3.80,12.0
4476,tt0271468,Donga Kollu,1988,0,0,0,0,0,,,,0,0,0,0,,
4477,tt0333890,Mazha,2000,0,0,0,0,0,,,,0,0,0,0,,
4478,tt1161418,Gentlemen Broncos,2009,"10,000+",20771,1019,1291,865,3,44.0,,79,16,63,79,4.00,20.0
4479,tt0082592,Just Before Dawn,1981,"1,000+",2351,140,131,121,3.2,52.0,,5,3,2,5,6.70,60.0
4480,tt0286683,Hero Hindustani,1998,50+,85,0,1,0,,,,0,0,0,0,,
4481,tt0079227,Good Guys Wear Black,1978,"5,000+",6762,69,122,96,3.1,36.0,,6,1,5,6,4.50,17.0
4482,tt0086200,Risky Business,1983,"50,000+",71402,6015,2278,2020,3.7,73.0,,50,46,4,50,7.30,92.0
4483,tt0857300,Anand,2004,50+,62,9,0,0,4.1,100.0,,0,0,0,0,,
4484,tt2082232,China Heavyweight,2012,"1,000+",1622,21,14,6,3.4,60.0,,22,18,4,22,7.20,82.0
4485,tt0461970,Invisible Waves,2006,"1,000+",1136,128,83,66,3.4,61.0,,2,1,1,2,,
4486,tt0379487,The Seat Filler,2004,"1,000+",1341,117,51,67,3.9,70.0,,2,0,2,2,,
4487,tt0350493,999-9999,2003,0,0,0,0,0,,,,0,0,0,0,,
4488,tt0056417,The Road to Hong Kong,1962,"1,000+",2043,45,67,46,3.1,40.0,,5,3,2,5,5.20,60.0
4489,tt1470022,Elfie Hopkins,2012,100+,120,12,62,22,2.2,16.0,,16,0,16,16,3.20,0.0
4490,tt0493424,Attack Force,2006,"2,500+",2842,63,252,140,2,20.0,,1,0,1,1,,
4491,tt0116488,Hard Core Logo,1996,"5,000+",6774,564,69,304,4.2,89.0,,13,9,4,13,6.40,69.0
4492,tt0109627,Dinosaur Island,1994,250+,257,14,39,18,2.4,26.0,,2,0,2,2,,
4493,tt0098966,3 Men and a Little Lady,1990,"50,000+",80778,722,966,999,3.1,43.0,,20,8,12,20,4.40,40.0
4494,tt0090570,84 Charing Cross Road,1987,"5,000+",5168,524,122,211,4,81.0,,14,12,2,14,7.60,86.0
4495,tt0074963,"Next Stop, Greenwich Village",1976,500+,512,56,33,31,3.6,63.0,,22,19,3,22,7.40,86.0
4496,tt1948150,Singham,2011,0,0,0,0,0,,,,0,0,0,0,,
4497,tt1202044,Six Reasons Why,2008,100+,213,18,20,20,3.2,47.0,,0,0,0,0,,
4498,tt0108167,Smoking/No Smoking,1993,Fewer than 50,31,22,0,0,4.5,100.0,,0,0,0,0,,
4499,tt0108258,Surf Ninjas,1993,"10,000+",15017,1278,597,776,3.7,68.0,,18,2,16,18,3.70,11.0
4500,tt0175908,Mere Hamdam Mere Dost,1968,0,0,0,0,0,,,,0,0,0,0,,
4501,tt0193102,Dil Ka Kya Kasoor,1992,250+,339,7,7,6,3.2,54.0,,0,0,0,0,,
4502,tt1404830,The Bannen Way,2010,100+,214,28,62,24,2.6,31.0,,0,0,0,0,,
4503,tt0098160,The Rachel Papers,1989,"1,000+",1329,51,45,39,3.4,53.0,,11,5,6,11,4.90,45.0
4504,tt0065445,Le bal du comte d'Orgel,1970,0,0,0,0,0,,,,0,0,0,0,,
4505,tt1999910,Kireedam,2007,Fewer than 50,1,0,1,0,,,,0,0,0,0,,
4506,tt0991167,Ping Pong Playa,2007,"5,000+",7230,352,324,282,3.3,52.0,,32,21,11,32,6.00,66.0
4507,tt13612478,Indira Vizha,2009,0,0,0,0,0,,,,0,0,0,0,,
4508,tt0841993,Apartment 1303,2007,500+,994,53,233,129,2.4,19.0,,1,0,1,1,,
4509,tt0202470,Rock Star,2001,"50,000+",61422,3096,2167,1731,3.5,59.0,,129,68,61,129,5.40,53.0
4510,tt0255459,Paramanandayya Shishyula Katha,1966,0,0,0,0,0,,,,0,0,0,0,,
4511,tt1545986,Dinoshark,2010,250+,250,32,117,58,2.2,21.0,,1,0,1,1,,
4512,tt1241329,The River Why,2010,250+,343,82,158,46,2.7,34.0,,1,0,1,1,,
4513,tt0072284,Three the Hard Way,1974,100+,165,29,29,27,3.3,50.0,,6,2,4,6,4.00,33.0
4514,tt0066826,The Touch,1971,250+,282,15,23,12,3.1,39.0,,23,15,8,23,6.20,65.0
4515,tt0063584,Sergeant Ryker,1968,Fewer than 50,8,0,2,1,,,,0,0,0,0,,
4516,tt0069001,Night Call Nurses,1972,250+,409,1,5,2,2.2,17.0,,0,0,0,0,,
4517,tt0356614,Foolproof,2003,"5,000+",7299,442,264,210,3.5,63.0,,3,1,2,3,,
4518,tt0097530,How I Got Into College,1989,"1,000+",1697,65,87,57,3,42.0,,7,3,4,7,4.60,43.0
4519,tt0482461,Barry Munday,2010,"1,000+",2424,176,311,130,2.9,36.0,,15,7,8,15,5.30,47.0
4520,tt0120662,Eye of the Beholder,1999,"10,000+",10500,337,730,352,2.6,32.0,,88,8,80,88,3.40,9.0
4521,tt2179506,Melinda's World,2003,250+,403,2,2,1,,,,0,0,0,0,,
4522,tt0115909,Clara Hakedosha,1996,250+,267,37,7,9,4.1,84.0,,3,1,2,3,,
4523,tt0115006,Xtro 3: Watch the Skies,1995,500+,812,5,30,17,1.9,14.0,,0,0,0,0,,
4524,tt0219327,Strictly Sinatra,2001,500+,575,10,24,12,2.9,29.0,,8,5,3,8,5.70,63.0
4525,tt0101502,The Borrower,1991,100+,141,8,41,16,2.7,17.0,,10,3,7,10,4.50,30.0
4526,tt0131409,Geri's Game,1997,"1,000+",1181,373,62,84,4.1,86.0,,2,2,0,2,,
4527,tt0099160,Blue Steel,1990,"5,000+",8782,222,399,171,2.9,36.0,,28,21,7,28,6.00,75.0
4528,tt0457940,Home Delivery: Aapko... Ghar Tak,2005,500+,808,15,29,14,2.5,34.0,,0,0,0,0,,
4529,tt0055796,Billy Budd,1962,Fewer than 50,13,11,2,8,4,85.0,,12,11,1,12,7.40,92.0
4530,tt0057634,The V.I.P.s,1963,500+,777,62,78,35,3.2,44.0,,6,0,6,6,3.40,0.0
4531,tt1727516,Livide,2011,"1,000+",1446,254,289,143,3.2,47.0,,9,8,1,9,7.60,89.0
4532,tt0105108,Past Midnight,1991,100+,147,15,29,8,3.1,34.0,,0,0,0,0,,
4533,tt0144608,Sinbad: Beyond the Veil of Mists,2000,"2,500+",3161,18,27,16,2.8,40.0,,3,1,2,3,,
4534,tt0091706,Out of Bounds,1986,250+,460,27,35,26,3,44.0,,3,1,2,3,,
4535,tt0212889,Common Ground,2000,500+,689,31,11,19,3.8,74.0,,3,3,0,3,,
4536,tt0262911,World Traveler,2001,"1,000+",1596,20,34,19,2.8,36.0,,67,23,44,67,4.90,34.0
4537,tt0496408,That Beautiful Somewhere,2006,500+,621,31,56,48,2.8,35.0,,4,1,3,4,,
4538,tt0067440,Mongo's Back in Town,1971,0,0,0,0,0,,,,0,0,0,0,,
4539,tt0084048,Hank Williams: The Show He Never Gave,1980,Fewer than 50,18,6,2,4,3.7,75.0,,0,0,0,0,,
4540,tt0054230,The Rat Race,1960,250+,321,21,15,10,3.3,58.0,,0,0,0,0,,
4541,tt0078111,Pretty Baby,1978,"5,000+",5150,345,249,179,3.4,58.0,,28,20,8,28,6.90,71.0
4542,tt0268401,Kahin Pyaar Na Ho Jaaye,2000,500+,773,35,39,20,3.2,47.0,,0,0,0,0,,
4543,tt0117478,The Right to Remain Silent,1996,50+,62,0,4,1,,,,0,0,0,0,,
4544,tt0055254,One Hundred and One Dalmatians,1961,"250,000+",709599,11879,3755,10069,3.9,76.0,,54,53,1,54,8.20,98.0
4545,tt0433346,Bone Sickness,2004,250+,422,23,35,33,2.6,40.0,,1,0,1,1,,
4546,tt0291832,Crackerjack,2002,100+,247,197,50,106,3.9,80.0,,8,8,0,8,6.60,100.0
4547,tt0433350,Boy Culture,2006,"2,500+",4386,536,235,246,3.7,70.0,,30,21,9,30,6.00,70.0
4548,tt0116731,The Juror,1996,"10,000+",15230,343,761,208,2.8,31.0,,23,5,18,23,4.50,22.0
4549,tt1351224,Pyaar Impossible!,2010,500+,654,113,131,71,3,46.0,,5,2,3,5,3.70,40.0
4550,tt0066012,The Love War,1970,0,0,0,0,0,,,,0,0,0,0,,
4551,tt0065981,The Lickerish Quartet,1970,100+,159,26,21,14,3.3,55.0,,9,6,3,9,6.50,67.0
4552,tt1946379,Raghuvinte Swantham Rasiya,2011,0,0,0,0,0,,,,0,0,0,0,,
4553,tt0316525,Sagina Mahato,1971,0,0,0,0,0,,,,0,0,0,0,,
4554,tt0267440,Do You Wanna Know a Secret?,2001,"1,000+",1158,9,42,24,2,18.0,,1,0,1,1,,
4555,tt0087003,Broadway Danny Rose,1984,"5,000+",9549,1880,351,452,4,84.0,,29,29,0,29,8.10,100.0
4556,tt0053244,The Savage Innocents,1960,500+,556,32,13,12,3.5,71.0,,13,9,4,13,7.20,69.0
4557,tt0483131,Rajamanikyam,2005,0,0,0,0,0,,,,0,0,0,0,,
4558,tt1255951,De Dana Dan,2009,"1,000+",1401,101,173,108,2.8,37.0,,2,0,2,2,,
4559,tt0338022,Fakers,2004,"10,000+",11614,8,15,14,3.1,35.0,,8,3,5,8,5.20,38.0
4560,tt1655607,Singam,2010,100+,227,42,22,12,3.7,66.0,,0,0,0,0,,
4561,tt0099819,I Love You to Death,1990,"5,000+",9233,655,392,304,3.6,63.0,,26,15,11,26,5.80,58.0
4562,tt1072755,Minutemen,2008,"5,000+",5074,651,315,296,3.8,67.0,,3,2,1,3,,
4563,tt1586752,Machine Gun Preacher,2011,0,0,0,0,0,,,,0,0,0,0,,
4564,tt0066958,Crucible of Terror,1971,100+,102,3,11,8,2.1,21.0,,1,0,1,1,,
4565,tt0056923,Charade,1963,"25,000+",43028,7094,615,2511,4.3,92.0,,54,51,3,54,8.50,94.0
4566,tt0237680,Sacred Flesh,2000,500+,835,6,17,9,2.1,26.0,,0,0,0,0,,
4567,tt0083232,True Confessions,1981,"2,500+",2785,227,201,93,3.3,53.0,,16,11,5,16,8.10,69.0
4568,tt0108327,The Thing Called Love,1993,"5,000+",9199,11,7,4,3.7,61.0,,21,12,9,21,5.70,57.0
4569,tt1582477,Bhavani IPS,2010,0,0,0,0,0,,,,0,0,0,0,,
4570,tt1083845,Ballet Shoes,2007,"5,000+",5084,1014,514,392,3.7,66.0,,6,6,0,6,7.70,100.0
4571,tt1001491,Avenging Angel,2007,250+,283,16,12,15,3.4,57.0,,0,0,0,0,,
4572,tt0478044,Takeshis',2005,"2,500+",2806,243,161,133,3.4,60.0,,5,2,3,5,4.90,40.0
4573,tt0118603,American Perfekt,1997,500+,720,41,28,19,3.4,59.0,,4,1,3,4,,
4574,tt0108174,So I Married an Axe Murderer,1993,"100,000+",203326,5115,2423,2854,3.7,68.0,,38,20,18,38,5.60,53.0
4575,tt0342882,The PianoTuner of EarthQuakes,2004,"1,000+",1256,143,102,101,3.4,58.0,,39,17,22,39,5.60,44.0
4576,tt1766094,So Undercover,2012,"5,000+",8713,877,906,199,3.2,49.0,,17,1,16,17,4.00,6.0
4577,tt1015999,Legally Blondes,2009,"2,500+",3486,234,391,162,2.8,38.0,,2,0,2,2,,
4578,tt0343818,"I, Robot",2004,"250,000+",999229,42864,18477,29934,3.6,70.0,,225,127,98,225,6.00,56.0
4579,tt0080442,The Black Marble,1980,500+,681,9,8,7,3.2,53.0,,6,2,4,6,6.10,33.0
4580,tt0102860,Scissors,1991,500+,939,39,87,33,2.8,31.0,,1,0,1,1,,
4581,tt0093773,Predator,1987,"250,000+",390316,41539,6103,17028,4.1,87.0,,60,48,12,60,7.00,80.0
4582,tt0110363,Little Big League,1994,"10,000+",20562,644,557,355,3.4,54.0,,19,7,12,19,5.50,37.0
4583,tt0338706,Alexandra's Project,2003,"2,500+",4749,213,175,149,3.2,55.0,,19,10,9,19,5.60,53.0
4584,tt0094048,Straight to Hell,1987,"2,500+",2977,163,118,114,3.5,58.0,,10,3,7,10,4.10,30.0
4585,tt0358135,Shall We Dance?,2004,"100,000+",205568,4898,3770,4052,3.4,57.0,,156,73,83,156,5.50,47.0
4586,tt0156658,Junoon,1992,Fewer than 50,1,1,0,0,,,,0,0,0,0,,
4587,tt1656171,Dam999,2011,Fewer than 50,30,4,10,4,2.1,29.0,,1,0,1,1,,
4588,tt0119879,Perdita Durango,1997,"2,500+",4851,264,157,131,3.6,63.0,,14,6,8,14,6.10,43.0
4589,tt1291584,Warrior,2011,"50,000+",59813,30100,2728,5931,4.3,92.0,,196,165,31,196,7.40,84.0
4590,tt0822856,Socket,2007,250+,333,10,41,26,2.4,20.0,,1,0,1,1,,
4591,tt0316356,Open Range,2003,"50,000+",51802,5016,980,2050,4,84.0,,183,145,38,183,6.80,79.0
4592,tt0399104,Going to the Mat,2004,"1,000+",1265,123,52,62,3.8,70.0,,4,4,0,4,,
4593,tt0061501,The Comedians in Africa,1967,0,0,0,0,0,,,,0,0,0,0,,
4594,tt0302058,Zamana,1985,0,0,0,0,0,,,,0,0,0,0,,
4595,tt1484522,8: The Mormon Proposition,2010,500+,998,213,82,101,3.7,72.0,,37,24,13,37,6.10,65.0
4596,tt0083081,Silsila,1981,500+,787,117,21,29,4.2,85.0,,0,0,0,0,,
4597,tt2042607,Nam Naadu,2007,0,0,0,0,0,,,,0,0,0,0,,
4598,tt0337876,Birth,2004,"25,000+",28301,1465,1930,1323,3,43.0,,146,57,89,146,5.20,39.0
4599,tt0279111,Gods and Generals,2003,"5,000+",9446,1407,795,869,3.5,64.0,,121,10,111,121,3.60,8.0
4600,tt1359554,High Noon,2009,100+,101,22,3,6,3.9,88.0,,0,0,0,0,,
4601,tt0468461,Caved In,2006,50+,60,3,3,0,2.7,40.0,,0,0,0,0,,
4602,tt0082220,Cutter's Way,1981,"1,000+",1758,228,96,106,3.7,70.0,,24,22,2,24,8.00,92.0
4603,tt0108560,Who's the Man?,1993,"2,500+",3082,107,87,63,3.3,55.0,,9,5,4,9,5.30,56.0
4604,tt0120524,Wishmaster,1997,"25,000+",28272,660,1046,617,3,39.0,,32,8,24,32,3.70,25.0
4605,tt0074205,The Big Bus,1976,"1,000+",1846,101,77,82,3.4,57.0,,14,9,5,14,6.30,64.0
4606,tt0162661,Sleepy Hollow,1999,"250,000+",607519,47886,11962,21140,3.9,80.0,,129,90,39,129,6.40,70.0
4607,tt0170157,Wayward Son,1999,0,0,0,0,0,,,,0,0,0,0,,
4608,tt0165798,Ghost Dog: The Way of the Samurai,1999,"25,000+",47123,6625,1096,2127,4,86.0,,104,87,17,104,7.00,84.0
4609,tt0251075,Evolution,2001,"250,000+",259182,4949,5459,5685,3.2,48.0,,140,61,79,140,4.90,44.0
4610,tt0337879,Blackball,2003,"5,000+",7338,198,276,213,2.9,42.0,,22,9,13,22,4.80,41.0
4611,tt0088161,Splash,1984,"100,000+",120219,66,42,15,3.5,61.0,,44,40,4,44,6.90,91.0
4612,tt0240912,Sound and Fury,2000,"1,000+",1089,153,21,38,4.1,88.0,,29,28,1,29,8.20,97.0
4613,tt0200087,Sarfarosh,1999,"2,500+",3623,355,54,83,4.1,87.0,,0,0,0,0,,
4614,tt4324054,Ayyanar,2010,0,0,0,0,0,,,,0,0,0,0,,
4615,tt0057435,The Punch and Judy Man,1963,100+,144,4,6,3,3.1,40.0,,1,1,0,1,,
4616,tt0365514,Moon Child,2003,"1,000+",1563,285,78,147,4,78.0,,2,0,2,2,,
4617,tt0246729,Khiladiyon Ka Khiladi,1996,250+,268,14,7,7,4,67.0,,0,0,0,0,,
4618,tt2776382,Makkal En Pakkam,1987,0,0,0,0,0,,,,0,0,0,0,,
4619,tt0094744,Big Top Pee-wee,1988,"25,000+",30030,376,865,523,2.7,30.0,,21,8,13,21,4.90,38.0
4620,tt0425458,Six Shooter,2004,Fewer than 50,2,2,0,0,,,,0,0,0,0,,
4621,tt0119670,The Mighty,1998,"5,000+",8483,950,258,428,3.9,79.0,,40,30,10,40,6.80,75.0
4622,tt0064909,"Run Wild, Run Free",1969,Fewer than 50,7,6,1,3,4.1,86.0,,2,1,1,2,,
4623,tt0872224,Street Thief,2006,500+,868,239,65,123,3.9,79.0,,1,1,0,1,,
4624,tt0093562,A Month in the Country,1987,500+,625,54,21,15,3.9,72.0,,7,6,1,7,6.60,86.0
4625,tt0396032,Getting Played,2005,"2,500+",4411,136,186,118,3.1,42.0,,0,0,0,0,,
4626,tt0098065,Parent Trap: Hawaiian Honeymoon,1989,500+,565,34,25,15,3.6,58.0,,0,0,0,0,,
4627,tt0109350,A Burning Passion: The Margaret Mitchell Story,1994,50+,82,2,0,0,,,,0,0,0,0,,
4628,tt0847221,Streetballers,2009,Fewer than 50,7,2,2,2,,,,4,3,1,4,,
4629,tt0291502,Swept Away,2002,"5,000+",8961,308,788,410,2.3,28.0,,78,4,74,78,3.20,5.0
4630,tt1568929,The Mooring,2012,100+,119,20,63,23,2.4,24.0,,0,0,0,0,,
4631,tt0831275,Bigga Than Ben,2008,500+,506,79,53,38,3.4,60.0,,10,6,4,10,5.10,60.0
4632,tt0113957,The Net,1995,"100,000+",102587,2131,2739,1846,3.1,44.0,,55,24,31,55,5.40,44.0
4633,tt0113131,Full Body Massage,1995,500+,535,29,34,24,3,46.0,,1,0,1,1,,
4634,tt0080388,Atlantic City,1980,"5,000+",5264,654,190,204,3.8,77.0,,38,38,0,38,8.60,100.0
4635,tt1594918,Eyyvah Eyvah,2010,100+,229,74,26,8,3.7,74.0,,0,0,0,0,,
4636,tt0061796,Hurry Sundown,1967,100+,147,8,19,13,2.9,30.0,,9,2,7,9,3.80,22.0
4637,tt0084654,Die Sehnsucht der Veronika Voss,1982,"1,000+",1829,320,44,72,4.1,88.0,,0,0,0,0,,
4638,tt1673411,Kushti,2010,0,0,0,0,0,,,,0,0,0,0,,
4639,tt0102724,Psycho IV: The Beginning,1990,"2,500+",4306,216,447,227,2.8,33.0,,4,0,4,4,,
4640,tt0211426,Ice Angel,2000,100+,103,12,6,2,3.7,67.0,,0,0,0,0,,
4641,tt1020543,Infestation,2009,"1,000+",1836,208,413,296,2.9,34.0,,3,3,0,3,,
4642,tt0109305,Blue Chips,1994,"5,000+",7878,677,641,298,3.3,51.0,,29,11,18,29,5.10,38.0
4643,tt0769512,Dragones: destino de fuego,2006,100+,153,3,3,0,2.8,50.0,,1,0,1,1,,
4644,tt1129407,Booky & the Secret Santa,2007,100+,101,4,3,5,3.5,57.0,,0,0,0,0,,
4645,tt0416712,Elaan,2005,250+,368,14,28,9,2.7,33.0,,1,0,1,1,,
4646,tt0280486,Bad Company,2002,"50,000+",56739,956,1790,770,2.8,35.0,,135,14,121,135,3.90,10.0
4647,tt0100049,Longtime Companion,1989,"2,500+",2904,336,71,114,4.1,83.0,,23,21,2,23,7.70,91.0
4648,tt1615147,Margin Call,2011,"10,000+",20269,8007,2804,2030,3.7,74.0,,174,152,22,174,7.20,87.0
4649,tt1954206,The Dirty Picture,2011,500+,926,238,173,110,3.3,58.0,,5,5,0,5,6.30,100.0
4650,tt0090315,When the Wind Blows,1986,"1,000+",2242,454,63,172,4.1,88.0,,8,7,1,8,7.10,88.0
4651,tt1922777,Sinister,2012,"50,000+",80379,19867,12327,5409,3.5,62.0,,158,100,58,158,6.20,63.0
4652,tt0191173,The Halloween Tree,1993,"1,000+",1019,217,40,95,4.3,84.0,,1,1,0,1,,
4653,tt2044821,Money Money More Money,2011,0,0,0,0,0,,,,0,0,0,0,,
4654,tt0077609,Ghar,1978,0,0,0,0,0,,,,0,0,0,0,,
4655,tt0169102,Lagaan: Once Upon a Time in India,2001,"10,000+",19797,2922,236,1051,4.4,93.0,,64,61,3,64,7.90,95.0
4656,tt0093225,Housekeeping,1987,500+,695,117,22,44,4.2,84.0,,14,13,1,14,7.10,93.0
4657,tt7943032,Ek Daav Bhutacha,1982,0,0,0,0,0,,,,0,0,0,0,,
4658,tt0091990,Sorority House Massacre,1986,"5,000+",6362,58,207,92,2.5,22.0,,5,0,5,5,3.40,0.0
4659,tt0113117,French Kiss,1995,"50,000+",54996,4462,1527,1982,3.9,74.0,,27,13,14,27,5.60,48.0
4660,tt0114388,Sense and Sensibility,1995,"100,000+",131025,18837,2127,6608,4.2,90.0,,68,66,2,68,8.10,97.0
4661,tt1707210,Ekam: Son of Soil,2010,0,0,0,0,0,,,,0,0,0,0,,
4662,tt0225961,Hum Dono,1961,50+,60,7,1,1,4.1,88.0,,0,0,0,0,,
4663,tt0366996,The Saddest Music in the World,2003,"5,000+",6799,830,222,436,3.9,79.0,,103,82,21,103,7.20,80.0
4664,tt0057622,Under the Yum Yum Tree,1963,250+,435,48,38,26,3.4,56.0,,6,1,5,6,4.50,17.0
4665,tt0113913,Naajayaz,1995,50+,53,2,2,1,,,,0,0,0,0,,
4666,tt0055809,Boys' Night Out,1962,250+,263,24,29,18,3.2,45.0,,4,2,2,4,,
4667,tt0472219,The Batman vs. Dracula,2005,"10,000+",13675,900,473,335,3.8,66.0,,1,1,0,1,,
4668,tt0117011,Maximum Risk,1996,"10,000+",11556,331,628,226,2.9,34.0,,37,12,25,37,4.40,32.0
4669,tt0088931,The Coca-Cola Kid,1985,"1,000+",1379,66,96,50,3,40.0,,17,8,9,17,5.20,47.0
4670,tt3627030,Kacheri Arambam,2010,0,0,0,0,0,,,,0,0,0,0,,
4671,tt0062994,Funny Girl,1968,"10,000+",19956,2117,382,861,4.2,85.0,,48,45,3,48,7.60,94.0
4672,tt0944185,Andhrudu,2005,0,0,0,0,0,,,,0,0,0,0,,
4673,tt0093389,The Last Emperor,1987,"25,000+",40075,4999,686,1380,4.1,88.0,,124,107,17,124,8.10,86.0
4674,tt0057887,Bikini Beach,1964,250+,395,28,41,18,3.1,41.0,,4,2,2,4,,
4675,tt0101757,Don't Tell Mom the Babysitter's Dead,1991,"100,000+",131137,1988,1518,2066,3.5,57.0,,34,12,22,34,4.20,35.0
4676,tt1535616,The Divide,2011,"5,000+",6272,1025,1695,605,2.8,38.0,,58,15,43,58,4.40,26.0
4677,tt0097165,Dead Poets Society,1989,"250,000+",307794,45930,3883,13544,4.3,92.0,,63,53,10,63,7.20,84.0
4678,tt0108577,Witchboard 2: The Devil's Doorway,1993,500+,506,21,62,21,2.7,25.0,,0,0,0,0,,
4679,tt0079268,Hanover Street,1979,"2,500+",3323,105,155,78,3.1,40.0,,9,6,3,9,5.30,67.0
4680,tt0098999,Agneepath,1990,500+,722,209,17,61,4.3,92.0,,0,0,0,0,,
4681,tt0068664,Group Marriage,1972,Fewer than 50,8,2,1,2,,,,0,0,0,0,,
4682,tt0218043,Beyond the Mat,1999,"5,000+",8549,999,202,463,3.9,83.0,,67,55,12,67,6.70,82.0
4683,tt1583363,Seema Simham,2002,0,0,0,0,0,,,,0,0,0,0,,
4684,tt1147687,The Devil's Tomb,2009,"1,000+",2091,52,467,263,1.8,10.0,,1,0,1,1,,
4685,tt0805570,The Midnight Meat Train,2008,"100,000+",143700,3439,3497,2790,3.2,50.0,,34,24,10,34,5.90,71.0
4686,tt1352802,Tengers,2007,Fewer than 50,12,0,1,1,,,,0,0,0,0,,
4687,tt0260222,Naseeb Apna Apna,1986,0,0,0,0,0,,,,0,0,0,0,,
4688,tt0362942,Post Impact,2004,"1,000+",1485,12,73,37,2,14.0,,0,0,0,0,,
4689,tt6450116,Mayandi Kudumbathar,2009,0,0,0,0,0,,,,0,0,0,0,,
4690,tt0212936,Erskineville Kings,1999,250+,496,25,15,12,3.6,62.0,,0,0,0,0,,
4691,tt1773441,Gaalipata,2008,0,0,0,0,0,,,,0,0,0,0,,
4692,tt0092906,Dolls,1986,"5,000+",8279,481,452,383,3.3,51.0,,15,9,6,15,5.70,60.0
4693,tt0363240,Christmas on Mars,2008,500+,705,103,95,123,3.2,52.0,,6,3,3,6,5.50,50.0
4694,tt2155776,Yeh Jo Mohabbat Hai,2012,Fewer than 50,22,2,0,1,,,,0,0,0,0,,
4695,tt0316824,In Enemy Hands,2004,"1,000+",1816,68,81,41,3.2,46.0,,1,0,1,1,,
4696,tt1442498,Edges of Darkness,2008,250+,376,4,64,32,1.5,6.0,,0,0,0,0,,
4697,tt0066492,Trog,1970,500+,527,25,84,58,2.5,23.0,,8,1,7,8,3.80,13.0
4698,tt0326814,The Crooked E: The Unshredded Truth About Enron,2003,100+,158,13,25,9,2.8,34.0,,1,1,0,1,,
4699,tt0076140,Hi-Riders,1978,Fewer than 50,22,2,2,0,,,,0,0,0,0,,
4700,tt0089629,Moving Violations,1985,"2,500+",2858,132,126,101,3.3,51.0,,4,2,2,4,,
4701,tt0116661,It's in the Water,1997,"1,000+",1432,84,51,44,3.7,62.0,,3,1,2,3,,
4702,tt0085486,Emmanuelle IV,1984,100+,236,10,27,6,2.3,27.0,,0,0,0,0,,
4703,tt1196340,Inhale,2010,"5,000+",6699,201,234,114,3.2,46.0,,24,9,15,24,4.50,38.0
4704,tt0399901,Woman Thou Art Loosed,2004,"5,000+",6453,257,47,164,4.3,85.0,,60,31,29,60,5.50,52.0
4705,tt0052382,Weddings and Babies,1958,50+,76,4,4,4,3.5,50.0,,11,10,1,11,7.70,91.0
4706,tt0207513,Hindustan Ki Kasam,1999,50+,86,0,6,0,1.5,0.0,,0,0,0,0,,
4707,tt0472566,Star Wreck: In the Pirkinning,2005,"1,000+",2282,221,109,101,3.6,67.0,,1,1,0,1,,
4708,tt6757804,James Pandu,2000,0,0,0,0,0,,,,0,0,0,0,,
4709,tt0119683,Les Misérables,1998,"25,000+",38311,4149,847,1635,4,83.0,,44,33,11,44,6.90,75.0
4710,tt0105315,Sapne Saajan Ke,1992,0,0,0,0,0,,,,0,0,0,0,,
4711,tt0125537,Tatlong taong walang Diyos,1976,0,0,0,0,0,,,,0,0,0,0,,
4712,tt0065967,The Last Grenade,1970,Fewer than 50,15,0,1,0,,,,1,0,1,1,,
4713,tt0112564,Boston Kickout,1995,50+,85,3,2,2,2.9,60.0,,1,0,1,1,,
4714,tt0138563,Kurt & Courtney,1998,"5,000+",6471,311,398,255,3.1,44.0,,55,34,21,55,6.00,62.0
4715,tt0815181,Iraq for Sale: The War Profiteers,2006,"2,500+",2932,343,61,174,4.1,85.0,,19,19,0,19,7.60,100.0
4716,tt0249361,Annamayya,1997,Fewer than 50,32,32,0,0,4.8,100.0,,0,0,0,0,,
4717,tt0075765,Black Sunday,1977,"2,500+",3925,278,149,146,3.5,65.0,,31,23,8,31,7.30,74.0
4718,tt1322269,August: Osage County,2013,"25,000+",39254,9532,5120,2100,3.6,65.0,,208,138,70,208,6.40,66.0
4719,tt0086143,Private School,1983,"2,500+",4600,151,248,135,3,38.0,,3,0,3,3,,
4720,tt1455811,Khatta Meetha,2010,"1,000+",1796,61,113,62,2.7,35.0,,6,1,5,6,3.30,17.0
4721,tt0081237,The Ninth Configuration,1980,"2,500+",2619,397,130,220,3.9,75.0,,16,13,3,16,7.10,81.0
4722,tt0077269,The Boys from Brazil,1978,"5,000+",7734,1022,513,458,3.5,67.0,,32,22,10,32,6.30,69.0
4723,tt0117108,Multiplicity,1996,"25,000+",48324,1260,1331,1039,3.2,49.0,,47,21,26,47,5.50,45.0
4724,tt0309986,Paper Soldiers,2002,"2,500+",3409,337,52,110,4.3,87.0,,0,0,0,0,,
4725,tt0070791,Theatre of Blood,1973,"5,000+",6290,636,148,290,3.9,81.0,,39,34,5,39,7.60,87.0
4726,tt0082348,Excalibur,1981,"50,000+",50230,4193,1017,1837,4,80.0,,94,68,26,94,7.00,72.0
4727,tt1385478,As We Forgive,2009,Fewer than 50,37,8,2,4,3.9,80.0,,1,1,0,1,,
4728,tt0405508,Rang De Basanti,2006,0,0,0,0,0,,,,0,0,0,0,,
4729,tt1517666,Currency,2011,0,0,0,0,0,,,,0,0,0,0,,
4730,tt0091183,Head Office,1985,"1,000+",1790,20,52,22,2.6,28.0,,6,0,6,6,2.00,0.0
4731,tt0097987,No Holds Barred,1989,"5,000+",8613,265,504,348,2.8,34.0,,21,2,19,21,3.00,10.0
4732,tt0305999,The Rage in Placid Lake,2003,"5,000+",5499,530,136,269,3.9,80.0,,16,9,7,16,6.20,56.0
4733,tt0335345,The Passion of the Christ,2004,"250,000+",370011,29633,7259,23098,4.1,80.0,,281,139,142,281,6.00,49.0
4734,tt0195814,Hyderabad Blues,1998,100+,239,22,8,3,3.8,73.0,,0,0,0,0,,
4735,tt0348031,Silent Warnings,2003,500+,877,7,48,18,2,13.0,,0,0,0,0,,
4736,tt0098502,The Toxic Avenger Part III: The Last Temptation of Toxie,1989,"5,000+",5350,123,358,164,2.5,26.0,,1,0,1,1,,
4737,tt0265591,Pumpkin,2002,"10,000+",11943,1007,770,633,3.4,57.0,,74,27,47,74,5.10,36.0
4738,tt0061801,I'll Never Forget What's'isname,1967,250+,313,15,13,9,3.6,52.0,,1,1,0,1,,
4739,tt0447953,The F Word,2005,500+,853,84,22,42,3.9,79.0,,0,0,0,0,,
4740,tt1509809,Kannamoochi Yenada,2007,0,0,0,0,0,,,,0,0,0,0,,
4741,tt1265990,The Roommate,2011,"25,000+",43457,2369,6391,1959,2.5,27.0,,87,3,84,87,2.80,3.0
4742,tt0274166,Johnny English,2003,"250,000+",402097,5623,5465,8004,3.3,51.0,,122,40,82,122,4.90,33.0
4743,tt0325703,Lara Croft: Tomb Raider - The Cradle of Life,2003,"250,000+",421183,5888,7522,8090,3.1,44.0,,175,42,133,175,4.60,24.0
4744,tt1092082,Passchendaele,2008,"2,500+",4542,670,504,652,3.3,57.0,,15,6,9,15,5.00,40.0
4745,tt0077658,Hardware Wars,1978,"2,500+",3400,92,43,98,3.7,68.0,,6,5,1,6,6.00,83.0
4746,tt0112883,Don Juan DeMarco,1994,"50,000+",63897,4977,2292,2040,3.7,68.0,,39,28,11,39,6.20,72.0
4747,tt0245891,Extremedays,2001,"5,000+",6949,675,76,376,4.4,90.0,,7,3,4,7,5.10,43.0
4748,tt0118900,Gang Related,1997,"5,000+",8912,476,258,194,3.7,65.0,,20,10,10,20,5.40,50.0
4749,tt0093605,Near Dark,1987,"10,000+",24907,3008,1046,1609,3.7,74.0,,75,62,13,75,7.40,83.0
4750,tt0466365,A Bug and a Bag of Weed,2006,100+,150,10,7,8,3.1,59.0,,0,0,0,0,,
4751,tt0104534,"It's Christmastime Again, Charlie Brown",1992,"1,000+",2462,126,56,52,3.7,69.0,,1,1,0,1,,
4752,tt1283540,The Brotherhood V: Alumni,2009,50+,77,0,11,3,1.1,0.0,,0,0,0,0,,
4753,tt0107999,Ruby Cairo,1992,500+,557,15,40,11,2.6,27.0,,0,0,0,0,,
4754,tt1146283,Foreign Exchange,2008,500+,676,42,133,59,2.4,24.0,,0,0,0,0,,
4755,tt0119282,Hercules,1997,Fewer than 50,2,1,1,0,,,,0,0,0,0,,
4756,tt0107985,Rookie of the Year,1993,"50,000+",51321,1660,1516,1192,3.4,52.0,,22,9,13,22,5.00,41.0
4757,tt23757502,Samasthanam,2002,0,0,0,0,0,,,,0,0,0,0,,
4758,tt0484905,Valley of Angels,2008,250+,347,12,24,11,2.8,33.0,,0,0,0,0,,
4759,tt0077357,The Comeback,1978,250+,254,12,27,10,2.9,31.0,,3,0,3,3,,
4760,tt1194608,Ek Vivaah... Aisa Bhi,2008,100+,231,26,15,21,3.6,63.0,,0,0,0,0,,
4761,tt0098976,Aaj Ka Arjun,1990,Fewer than 50,48,1,1,0,,,,0,0,0,0,,
4762,tt0120742,Major League: Back to the Minors,1998,"5,000+",9992,224,676,240,2.5,25.0,,19,4,15,19,3.50,21.0
4763,tt0423310,The Syrian Bride,2004,"10,000+",16163,383,95,171,3.8,80.0,,41,35,6,41,7.10,85.0
4764,tt0400420,Exils,2004,"2,500+",3582,440,93,122,4,83.0,,9,7,2,9,6.40,78.0
4765,tt0309372,Blizzard,2003,"1,000+",1451,59,54,54,3.4,52.0,,6,4,2,6,5.50,67.0
4766,tt0066075,Metello,1970,Fewer than 50,20,2,1,0,,,,0,0,0,0,,
4767,tt0081384,The Promise of Love,1980,Fewer than 50,11,0,3,0,,,,0,0,0,0,,
4768,tt0102343,Love Potion No. 9,1992,"25,000+",34325,632,825,431,3.1,43.0,,12,3,9,12,3.80,25.0
4769,tt0377643,Chinthavishtayaya Shyamala,1998,0,0,0,0,0,,,,0,0,0,0,,
4770,tt0353725,Meesha Madhavan,2002,0,0,0,0,0,,,,0,0,0,0,,
4771,tt0456554,Grandma's Boy,2006,"100,000+",226443,27301,4806,11576,4.2,85.0,,61,9,52,61,3.60,15.0
4772,tt0390336,Overnight,2003,"2,500+",4380,558,226,454,3.6,71.0,,77,60,17,77,6.60,78.0
4773,tt0407031,Naked Fame,2004,500+,650,8,10,10,3,44.0,,8,4,4,8,4.80,50.0
4774,tt0087258,Final Justice,1984,250+,356,12,80,43,1.7,13.0,,1,0,1,1,,
4775,tt0491211,Heavy Petting,2007,250+,415,26,87,44,2.6,23.0,,0,0,0,0,,
4776,tt0062493,The Wild Rebels,1967,50+,79,1,26,10,1.3,4.0,,0,0,0,0,,
4777,tt0337917,Catch That Kid,2004,"10,000+",22860,794,887,559,3.1,47.0,,85,11,74,85,3.90,13.0
4778,tt1758689,Life Just Is,2012,Fewer than 50,14,0,4,1,,,,13,4,9,13,4.10,31.0
4779,tt1542599,B.O.B.'s Big Break,2009,100+,162,43,32,21,3.6,57.0,,0,0,0,0,,
4780,tt0095990,Return of the Living Dead: Part II,1988,"10,000+",22582,697,908,705,3.1,44.0,,21,1,20,21,3.70,5.0
4781,tt0839880,Lake Dead,2007,"2,500+",2612,100,452,304,2.2,18.0,,4,1,3,4,,
4782,tt0113303,Hideaway,1995,"5,000+",6580,157,255,160,2.9,38.0,,15,3,12,15,3.50,20.0
4783,tt0134630,Duets,2000,"10,000+",10609,468,488,344,3.2,49.0,,92,19,73,92,4.00,21.0
4784,tt0430308,Get Rich or Die Tryin',2005,"250,000+",298138,6640,2880,5429,3.8,70.0,,121,20,101,121,4.50,17.0
4785,tt0085382,Cujo,1983,"50,000+",53670,1581,1898,1683,3.2,46.0,,45,26,19,45,5.70,58.0
4786,tt0106743,Dollman vs. Demonic Toys,1993,"1,000+",1520,31,105,60,2.5,23.0,,3,0,3,3,,
4787,tt0109479,Cool and the Crazy,1994,"1,000+",1724,19,52,17,2.7,27.0,,3,1,2,3,,
4788,tt1322346,Miss Kicki,2009,100+,121,11,17,11,3,39.0,,0,0,0,0,,
4789,tt0053850,Gangster Story,1959,250+,323,10,17,11,2.9,37.0,,2,1,1,2,,
4790,tt0077413,Death on the Nile,1978,"5,000+",8628,902,242,343,3.8,79.0,,18,14,4,18,6.60,78.0
4791,tt0251144,International Gorillay,1990,Fewer than 50,2,0,1,0,,,,2,2,0,2,,
4792,tt0133152,Planet of the Apes,2001,"250,000+",367087,3908,10577,10328,2.6,27.0,,160,70,90,160,5.50,44.0
4793,tt0828465,The Year Without a Santa Claus,2006,"2,500+",4766,106,81,66,3.3,57.0,,1,0,1,1,,
4794,tt0090142,Teen Wolf,1985,"50,000+",72859,2389,2244,1850,3.4,52.0,,33,14,19,33,5.30,42.0
4795,tt1428459,We Are Family,2010,Fewer than 50,8,2,0,0,,,,0,0,0,0,,
4796,tt0119125,Firelight,1997,"2,500+",2893,317,70,114,4,82.0,,17,7,10,17,5.40,41.0
4797,tt3368378,Ek Cup Chya,2009,0,0,0,0,0,,,,0,0,0,0,,
4798,tt0388556,Zebraman,2004,"2,500+",3016,285,134,169,3.6,68.0,,14,8,6,14,6.00,57.0
4799,tt0071569,The Golden Voyage of Sinbad,1973,"5,000+",7692,400,225,222,3.6,64.0,,16,12,4,16,5.60,75.0
4800,tt1806959,Manmadhan Ambu,2010,Fewer than 50,12,3,2,1,3.2,60.0,,0,0,0,0,,
4801,tt0101998,Hangin' with the Homeboys,1991,"1,000+",1338,95,45,49,3.7,68.0,,41,38,3,41,7.00,93.0
4802,tt0790590,Botched,2007,"1,000+",2358,267,340,332,3,44.0,,8,2,6,8,4.20,25.0
4803,tt0077530,Eyes of Laura Mars,1978,"2,500+",4321,261,351,201,3.2,43.0,,36,21,15,36,5.60,58.0
4804,tt0348836,Gothika,2003,"250,000+",397888,5496,6703,7329,3.1,45.0,,167,24,143,167,4.10,14.0
4805,tt0083670,Boardinghouse,1982,0,0,0,0,0,,,,0,0,0,0,,
4806,tt0065480,Bloodthirsty Butchers,1970,Fewer than 50,14,2,4,2,3.2,33.0,,1,1,0,1,,
4807,tt1797469,Page Eight,2011,"1,000+",1484,506,291,160,3.5,63.0,,15,14,1,15,6.90,93.0
4808,tt1369669,Jai Veeru: Friends Forever,2009,0,0,0,0,0,,,,0,0,0,0,,
4809,tt1247662,The Good Guy,2009,"2,500+",2512,320,744,215,2.8,30.0,,25,9,16,25,5.10,36.0
4810,tt0078867,The Bitch,1979,50+,93,4,8,8,2.3,33.0,,2,1,1,2,,
4811,tt1249299,Dear Prudence,2009,0,0,0,0,0,,,,0,0,0,0,,
4812,tt0076391,Mimino,1977,50+,82,31,5,8,4.2,86.0,,0,0,0,0,,
4813,tt0764655,Moondru Mugham,1982,0,0,0,0,0,,,,0,0,0,0,,
4814,tt0111733,Without Consent,1994,100+,171,0,1,0,,,,0,0,0,0,,
4815,tt0115491,Aladdin and the King of Thieves,1996,"100,000+",125616,2378,2332,1979,3.3,50.0,,12,4,8,12,4.80,33.0
4816,tt0488836,Hanuman,2005,250+,342,32,9,13,3.9,78.0,,1,1,0,1,,
4817,tt1064801,Red Canyon,2008,100+,189,24,31,18,3,44.0,,1,1,0,1,,
4818,tt0107952,The Return of Jafar,1994,"50,000+",90415,1961,2956,1762,3,40.0,,12,4,8,12,4.30,33.0
4819,tt0097138,Cyborg,1989,"25,000+",28427,517,1145,568,2.6,31.0,,18,4,14,18,3.50,22.0
4820,tt0846713,Maneater,2007,50+,93,11,21,10,2.7,34.0,,0,0,0,0,,
4821,tt0118636,Apt Pupil,1998,"25,000+",38586,1490,1155,1059,3.4,56.0,,56,30,26,56,6.10,54.0
4822,tt0469318,Dark Country,2009,"1,000+",1061,112,297,184,2.4,27.0,,3,1,2,3,,
4823,tt0122106,Home of Angels,1995,0,0,0,0,0,,,,0,0,0,0,,
4824,tt1069226,Down to the Dirt,2008,50+,84,10,13,11,3.2,43.0,,6,3,3,6,5.40,50.0
4825,tt0437171,East Side Story,2006,500+,951,121,93,77,3.4,56.0,,3,2,1,3,,
4826,tt0068022,Something Big,1971,Fewer than 50,7,7,0,4,4.4,100.0,,6,0,6,6,4.00,0.0
4827,tt0082198,Conan the Barbarian,1982,"100,000+",131653,8394,2906,4277,3.9,74.0,,42,28,14,42,6.70,67.0
4828,tt0116839,Lawnmower Man 2: Beyond Cyberspace,1995,"5,000+",7225,29,221,110,1.6,12.0,,10,1,9,10,3.20,10.0
4829,tt0375920,The Libertine,2004,"50,000+",70945,3930,2803,3193,3.4,58.0,,122,41,81,122,4.80,34.0
4830,tt0330602,Mambo Italiano,2003,"5,000+",7853,555,285,309,3.6,66.0,,75,24,51,75,4.80,32.0
4831,tt0069280,Slaughterhouse-Five,1972,"5,000+",6244,681,325,372,3.6,68.0,,17,14,3,17,7.50,82.0
4832,tt2396690,Barbie: The Princess & the Popstar,2012,100+,123,40,21,11,3.7,65.0,,0,0,0,0,,
4833,tt0111747,World and Time Enough,1994,50+,74,2,2,1,,,,3,2,1,3,,
4834,tt1658820,Sket,2011,250+,382,27,83,30,2.6,24.0,,8,4,4,8,5.70,50.0
4835,tt1918965,Murder 2,2011,250+,466,114,108,70,3.2,51.0,,1,1,0,1,,
4836,tt0282778,Nadodikkattu,1987,0,0,0,0,0,,,,0,0,0,0,,
4837,tt1167490,Gym Teacher: The Movie,2008,250+,358,34,30,26,3.4,55.0,,2,2,0,2,,
4838,tt0150718,Gharaonda,1977,0,0,0,0,0,,,,0,0,0,0,,
4839,tt0084805,Tootsie,1982,"50,000+",58675,6273,1443,2154,3.9,81.0,,53,48,5,53,7.80,91.0
4840,tt0071960,The Outfit,1973,250+,385,76,29,34,3.6,72.0,,5,4,1,5,8.30,80.0
4841,tt0353984,Scarecrow Slayer,2003,500+,506,18,52,38,2.3,26.0,,0,0,0,0,,
4842,tt0122417,Butch Camp,1996,50+,61,3,4,2,2.5,43.0,,2,1,1,2,,
4843,tt0160797,Rules of Engagement,2000,"25,000+",49554,1628,1337,670,3.4,55.0,,100,37,63,100,5.00,37.0
4844,tt0160338,Guinevere,1999,"1,000+",1611,101,88,60,3.2,53.0,,35,30,5,35,6.90,86.0
4845,tt1753422,Alice in Murderland,2010,100+,112,7,43,13,1.6,14.0,,0,0,0,0,,
4846,tt0805188,Marilena de la P7,2006,50+,94,13,4,1,3.6,76.0,,0,0,0,0,,
4847,tt0430304,Little Man,2006,"250,000+",419550,6184,5054,8023,3.3,55.0,,91,11,80,91,3.40,12.0
4848,tt0091579,My Chauffeur,1986,"1,000+",1490,70,52,55,3.5,57.0,,1,0,1,1,,
4849,tt0120434,Vegas Vacation,1997,"50,000+",54728,2780,2645,1578,3.3,51.0,,33,5,28,33,3.80,15.0
4850,tt1348327,Villa Amalia,2009,250+,366,46,69,37,3,40.0,,8,6,2,8,5.90,75.0
4851,tt0791076,Freedom State,2006,50+,74,2,7,6,2.8,22.0,,1,1,0,1,,
4852,tt1401098,Badla Jatti Da,1991,0,0,0,0,0,,,,0,0,0,0,,
4853,tt0316353,One Perfect Day,2004,"1,000+",1053,169,31,89,4.2,85.0,,4,2,2,4,,
4854,tt1380784,Big Money Rustlas,2010,250+,326,75,61,43,3.3,55.0,,0,0,0,0,,
4855,tt0086227,Sacred Ground,1983,Fewer than 50,38,2,4,0,3.2,33.0,,0,0,0,0,,
4856,tt0867235,Akasha Gopuram,2008,0,0,0,0,0,,,,0,0,0,0,,
4857,tt0079382,Jurmana,1979,0,0,0,0,0,,,,0,0,0,0,,
4858,tt0076100,Grand Theft Auto,1977,"1,000+",2399,69,131,83,2.8,34.0,,15,4,11,15,4.90,27.0
4859,tt0086137,The Prey,1983,0,0,0,0,0,,,,0,0,0,0,,
4860,tt0074633,Hollywood Boulevard,1976,250+,389,31,36,22,3.1,46.0,,2,2,0,2,,
4861,tt2076220,Holy Motors,2012,"10,000+",12467,2932,1176,720,3.7,71.0,,195,179,16,195,8.20,92.0
4862,tt0120780,Out of Sight,1998,"50,000+",59958,5163,1791,1871,3.8,74.0,,106,100,6,106,7.90,94.0
4863,tt1247692,Shrink,2009,"25,000+",42790,992,999,617,3.2,50.0,,63,17,46,63,4.60,27.0
4864,tt0305173,Aamdani Atthanni Kharcha Rupaiya,2001,50+,74,7,11,2,2.9,39.0,,0,0,0,0,,
4865,tt0085354,Les compères,1983,Fewer than 50,4,3,1,0,,,,0,0,0,0,,
4866,tt0078841,Being There,1979,"25,000+",25220,5288,471,1745,4.3,92.0,,62,59,3,62,8.60,95.0
4867,tt0263491,Jis Desh Mein Ganga Rehta Hain,2000,50+,86,2,9,1,2.5,18.0,,0,0,0,0,,
4868,tt0282779,Nagarangalil Chennu Raparkam,1990,0,0,0,0,0,,,,0,0,0,0,,
4869,tt0275067,Wendigo,2001,"2,500+",3576,120,259,134,2.6,32.0,,53,32,21,53,6.30,60.0
4870,tt0878695,Murder Party,2007,"2,500+",3417,519,384,423,3.3,57.0,,6,6,0,6,7.60,100.0
4871,tt0130488,Tom,1973,Fewer than 50,2,1,1,1,,,,0,0,0,0,,
4872,tt0962774,O' Horten,2007,"10,000+",22113,317,185,171,3.5,63.0,,85,77,8,85,7.20,91.0
4873,tt0280642,Engeyo Ketta Kural,1982,0,0,0,0,0,,,,0,0,0,0,,
4874,tt0218967,The Family Man,2000,"100,000+",194845,6583,3187,3654,3.7,67.0,,130,69,61,130,5.50,53.0
4875,tt1092095,"Changing Climates, Changing Times",2008,0,0,0,0,0,,,,0,0,0,0,,
4876,tt0477002,Gogol Bordello Non-Stop,2006,100+,106,33,5,11,4.1,87.0,,8,7,1,8,6.40,88.0
4877,tt0072706,The Black Bird,1975,50+,54,5,5,5,3.2,50.0,,11,3,8,11,4.60,27.0
4878,tt0238112,Captain Corelli's Mandolin,2001,"25,000+",34435,1520,1528,886,3.2,50.0,,119,33,86,119,4.40,28.0
4879,tt0109206,Bandit Queen,1994,"2,500+",3403,250,51,88,4,83.0,,25,25,0,25,7.60,100.0
4880,tt0094037,Stewardess School,1986,100+,105,8,22,7,2.5,27.0,,1,1,0,1,,
4881,tt0099235,The Cellar,1988,50+,90,9,9,6,3.4,50.0,,2,1,1,2,,
4882,tt0348059,The Snow Queen's Revenge,1996,Fewer than 50,6,0,4,0,,,,0,0,0,0,,
4883,tt0398913,DOA: Dead or Alive,2006,"250,000+",472730,4317,7589,8878,2.8,36.0,,46,15,31,46,4.70,33.0
4884,tt0419641,Chromophobia,2005,500+,950,121,108,69,3.3,53.0,,13,4,9,13,4.00,31.0
4885,tt0434342,The Sky Is Falling,2002,0,0,0,0,0,,,,0,0,0,0,,
4886,tt0055342,The Pure Hell of St. Trinian's,1960,500+,551,12,18,12,3.2,40.0,,0,0,0,0,,
4887,tt0343135,Along Came Polly,2004,"250,000+",463529,8997,10304,9031,3.2,47.0,,161,44,117,161,4.80,27.0
4888,tt0142521,Lal Darja,1997,50+,72,2,0,0,,,,0,0,0,0,,
4889,tt0258760,Lammbock,2001,250+,378,114,29,19,3.9,80.0,,0,0,0,0,,
4890,tt0960890,Zombie Strippers!,2008,"5,000+",7673,803,1863,1491,2.6,30.0,,65,25,40,65,4.70,38.0
4891,tt0415932,Lemming,2005,"5,000+",7243,351,217,192,3.4,62.0,,47,34,13,47,6.70,72.0
4892,tt0055539,Town Without Pity,1961,250+,274,37,14,20,3.7,73.0,,5,3,2,5,6.00,60.0
4893,tt0068323,Buck and the Preacher,1972,"1,000+",2041,66,41,34,3.6,62.0,,44,37,7,44,7.90,84.0
4894,tt0244764,Rip Girls,2000,500+,781,120,54,42,3.8,69.0,,1,1,0,1,,
4895,tt0074901,Mikey and Nicky,1976,500+,836,156,42,54,3.8,79.0,,25,22,3,25,7.60,88.0
4896,tt0067658,Von Richthofen and Brown,1971,50+,76,9,17,13,3.1,35.0,,9,5,4,9,5.30,56.0
4897,tt0249677,Lady and the Tramp II: Scamp's Adventure,2001,"10,000+",20883,823,840,459,3.3,50.0,,11,5,6,11,5.80,45.0
4898,tt0448075,The Night Listener,2006,"50,000+",92857,1347,2460,1886,2.9,35.0,,136,54,82,136,5.50,40.0
4899,tt0427327,Hairspray,2007,"250,000+",763692,110421,20295,63430,4.2,84.0,,219,201,18,219,7.80,92.0
4900,tt0222024,Hum Tumhare Hain Sanam,2002,"2,500+",3419,127,136,76,3.1,48.0,,0,0,0,0,,
4901,tt0086352,Spring Break,1983,"1,000+",1812,65,91,61,3.1,42.0,,10,2,8,10,3.50,20.0
4902,tt0138797,King Cobra,1999,"1,000+",1619,25,66,39,2.6,28.0,,4,0,4,4,,
4903,tt0102598,Only the Lonely,1991,"5,000+",8432,369,368,218,3.3,50.0,,23,15,8,23,6.00,65.0
4904,tt3108594,A Better Tomorrow,2013,0,0,0,0,0,,,,0,0,0,0,,
4905,tt1347515,The Combination,2009,100+,234,47,19,38,3.6,71.0,,4,3,1,4,,
4906,tt0095316,Homeboy,1988,"1,000+",1008,65,67,31,3.3,49.0,,1,0,1,1,,
4907,tt2147365,Keith Lemon: The Film,2012,"1,000+",2222,160,700,232,1.9,19.0,,12,0,12,12,1.90,0.0
4908,tt0100994,Young Guns II,1990,"50,000+",52527,2309,1172,1088,3.7,66.0,,26,8,18,26,4.90,31.0
4909,tt0110684,Nobody's Fool,1994,"5,000+",8573,1016,230,330,4,82.0,,57,52,5,57,7.70,91.0
4910,tt0317303,Daddy Day Care,2003,"250,000+",472733,5472,5841,8100,3.2,48.0,,131,36,95,131,4.60,27.0
4911,tt0142201,Crazy in Alabama,1999,"5,000+",7446,366,207,184,3.6,64.0,,56,17,39,56,4.50,30.0
4912,tt0059474,Motorpsycho!,1965,Fewer than 50,49,12,7,4,3.5,63.0,,6,4,2,6,6.20,67.0
4913,tt0283503,Brooklyn Rules,2007,"10,000+",17356,650,630,407,3.2,51.0,,40,18,22,40,5.40,45.0
4914,tt0113972,Nick of Time,1995,"50,000+",57448,1799,2023,1346,3.2,47.0,,33,10,23,33,4.60,30.0
4915,tt0069385,To Find a Man,1972,0,0,0,0,0,,,,1,1,0,1,,
4916,tt0053650,Beyond the Curtain,1960,0,0,0,0,0,,,,0,0,0,0,,
4917,tt0158583,Deterrence,1999,"1,000+",1044,62,43,46,3.4,59.0,,39,18,21,39,5.30,46.0
4918,tt0110305,Lassie,1994,"25,000+",33843,295,232,292,3.5,56.0,,17,15,2,17,6.70,88.0
4919,tt1216516,Tinker Bell and the Lost Treasure,2009,"2,500+",2777,706,261,180,3.9,73.0,,5,5,0,5,6.90,100.0
4920,tt1310569,Before I Self Destruct,2009,500+,601,130,96,60,3.2,57.0,,0,0,0,0,,
4921,tt0093044,The Fourth Protocol,1987,"1,000+",2119,184,151,100,3.4,55.0,,21,14,7,21,5.70,67.0
4922,tt0086425,Terms of Endearment,1983,"25,000+",36434,4179,834,1530,4,83.0,,109,89,20,109,7.90,82.0
4923,tt0098283,See You in the Morning,1989,100+,217,5,11,3,2.7,31.0,,11,6,5,11,5.60,55.0
4924,tt1261843,Kobe Doin' Work,2009,250+,286,56,41,23,3.5,58.0,,2,1,1,2,,
4925,tt0476729,Aksar,2006,100+,205,6,10,1,2.7,40.0,,1,0,1,1,,
4926,tt0398971,Down and Derby,2005,500+,809,36,36,21,3,50.0,,27,6,21,27,4.00,22.0
4927,tt0456558,Nazar,2005,100+,123,1,7,1,1.9,12.0,,0,0,0,0,,
4928,tt0887912,The Hurt Locker,2008,"50,000+",96474,40150,7753,13867,4,84.0,,291,281,10,291,8.50,97.0
4929,tt0449573,California Dreamin' (Nesfarsit),2007,"1,000+",2134,367,79,157,3.9,82.0,,18,16,2,18,6.90,89.0
4930,tt5612402,Hudugaru,2011,Fewer than 50,7,2,0,0,,,,0,0,0,0,,
4931,tt0156985,Sadak,1991,Fewer than 50,46,4,14,3,1.8,22.0,,0,0,0,0,,
4932,tt0495022,Ankahee,2006,100+,109,4,5,2,2.8,44.0,,0,0,0,0,,
4933,tt2378378,Anantha Poongattre,1999,0,0,0,0,0,,,,0,0,0,0,,
4934,tt1518814,Mera Pind: My Home,2008,0,0,0,0,0,,,,0,0,0,0,,
4935,tt0237993,101 Reykjavík,2000,"5,000+",7353,742,227,226,3.8,77.0,,47,42,5,47,7.00,89.0
4936,tt0446273,Los Andes no creen en Dios,2007,Fewer than 50,7,1,2,1,,,,0,0,0,0,,
4937,tt0107623,The Music of Chance,1993,500+,845,137,20,47,4,87.0,,15,15,0,15,6.90,100.0
4938,tt0103409,Fantaghirò 2,1992,0,0,0,0,0,,,,0,0,0,0,,
4939,tt0101588,City of Hope,1991,"1,000+",1159,87,19,29,4.1,82.0,,18,17,1,18,7.60,94.0
4940,tt0085603,Going Berserk,1983,250+,411,40,90,45,2.8,31.0,,0,0,0,0,,
4941,tt0918628,Fishtales,2007,250+,489,25,69,32,2.7,27.0,,2,0,2,2,,
4942,tt1502402,Darkening Sky,2010,50+,54,5,22,11,2.2,19.0,,0,0,0,0,,
4943,tt0067588,Play Misty for Me,1971,"10,000+",12750,1469,580,644,3.6,72.0,,40,34,6,40,7.30,85.0
4944,tt0116508,Heaven's Prisoners,1996,"1,000+",1915,54,119,53,2.8,31.0,,19,3,16,19,4.30,16.0
4945,tt0067848,They Might Be Giants,1971,"1,000+",1244,134,46,64,3.8,74.0,,18,11,7,18,7.00,61.0
4946,tt0102636,Parinda,1989,250+,383,64,11,13,4.1,85.0,,0,0,0,0,,
4947,tt0339878,Waah! Tera Kya Kehna,2002,0,0,0,0,0,,,,0,0,0,0,,
4948,tt0489085,I-See-You.com,2006,"1,000+",1335,70,166,92,2.7,29.0,,0,0,0,0,,
4949,tt0471768,Knights of the South Bronx,2005,500+,595,89,33,46,3.8,73.0,,1,0,1,1,,
4950,tt0210670,Escápate conmigo,1988,Fewer than 50,1,1,0,0,,,,0,0,0,0,,
4951,tt0981227,Nick and Norah's Infinite Playlist,2008,"100,000+",189332,13459,7150,7986,3.5,65.0,,186,139,47,186,6.60,75.0
4952,tt3019716,Care of Footpath,2006,Fewer than 50,1,0,1,0,,,,0,0,0,0,,
4953,tt0088993,Day of the Dead,1985,"50,000+",64707,6853,2299,3323,3.8,75.0,,44,38,6,44,7.10,86.0
4954,tt0272338,Punch-Drunk Love,2002,"100,000+",140392,15459,4479,6620,3.8,77.0,,200,158,42,200,7.40,79.0
4955,tt1204340,Tyrannosaur,2011,"5,000+",7632,2408,440,644,3.9,85.0,,87,73,14,87,7.40,84.0
4956,tt0338097,Head in the Clouds,2004,"5,000+",8464,709,455,264,3.5,61.0,,91,15,76,91,4.30,16.0
4957,tt0828450,Shredderman Rules,2007,500+,818,53,62,47,3.2,46.0,,2,2,0,2,,
4958,tt0071276,Captain Kronos: Vampire Hunter,1974,"2,500+",3293,166,110,144,3.4,60.0,,4,3,1,4,,
4959,tt2179133,Loot,2012,0,0,0,0,0,,,,0,0,0,0,,
4960,tt0056138,Kid Galahad,1962,"5,000+",5137,77,61,70,3.6,56.0,,6,3,3,6,5.20,50.0
4961,tt0376076,Pithamagan,2003,250+,261,32,8,4,4,80.0,,1,1,0,1,,
4962,tt0158293,Tumhare Liye,1978,Fewer than 50,33,0,1,0,,,,0,0,0,0,,
4963,tt0068981,Mutiny on the Buses,1972,Fewer than 50,3,1,2,0,,,,0,0,0,0,,
4964,tt0094036,The Stepford Children,1987,0,0,0,0,0,,,,0,0,0,0,,
4965,tt0355809,Narradores de Javé,2003,Fewer than 50,9,7,0,1,4.2,100.0,,1,1,0,1,,
4966,tt0112573,Braveheart,1995,"250,000+",32708456,126902,22193,1198232,3.8,85.0,,127,96,31,127,7.20,76.0
4967,tt0275371,The Gilded Six Bits,2001,0,0,0,0,0,,,,0,0,0,0,,
4968,tt1792131,Spooky Buddies,2011,250+,448,112,105,46,3.4,52.0,,4,3,1,4,,
4969,tt0091601,Nagina,1986,Fewer than 50,1,1,0,0,,,,0,0,0,0,,
4970,tt0114031,Oh Darling Yeh Hai India,1995,500+,610,5,24,6,2.2,17.0,,0,0,0,0,,
4971,tt0385567,A Boyfriend for Christmas,2004,"2,500+",4574,222,95,120,3.9,70.0,,0,0,0,0,,
4972,tt0211443,Jason X,2001,"50,000+",71815,1340,4024,2789,2.3,25.0,,108,21,87,108,3.80,19.0
4973,tt0117876,Tenchi Muyô! In Love,1996,500+,731,157,26,56,4.1,86.0,,0,0,0,0,,
4974,tt0077800,Killer Fish,1979,50+,55,4,28,6,2.3,12.0,,0,0,0,0,,
4975,tt1436475,The Third Jihad,2008,50+,71,18,8,12,3.8,69.0,,0,0,0,0,,
4976,tt1065307,More of Me,2007,Fewer than 50,30,0,11,2,1.7,0.0,,0,0,0,0,,
4977,tt0108122,Short Cuts,1993,"10,000+",22777,3510,461,966,4.2,88.0,,60,57,3,60,7.80,95.0
4978,tt0476519,48 Shades,2006,"1,000+",1423,40,44,49,3.2,48.0,,0,0,0,0,,
4979,tt0839980,Semi-Pro,2008,"250,000+",290828,10553,16853,12482,3,38.0,,162,37,125,162,4.60,23.0
4980,tt0367594,Charlie and the Chocolate Factory,2005,"250,000+",32495606,70940,68946,1479913,3,51.0,,229,191,38,229,7.20,83.0
4981,tt0374273,The Tesseract,2003,"1,000+",1133,20,77,45,2.5,21.0,,4,2,2,4,,
4982,tt0097314,The Experts,1989,250+,461,27,64,16,2.8,30.0,,0,0,0,0,,
4983,tt0111730,Witch Hunt,1994,250+,453,23,30,15,3,43.0,,5,1,4,5,4.00,20.0
4984,tt0112585,The Brothers McMullen,1995,"5,000+",6184,421,281,167,3.5,60.0,,39,34,5,39,7.20,87.0
4985,tt0168501,The Best Man,1999,"2,500+",3018,2288,362,786,4.2,86.0,,71,51,20,71,6.50,72.0
4986,tt0096219,Talk Radio,1988,"5,000+",6807,965,234,386,3.8,80.0,,50,41,9,50,7.00,82.0
4987,tt1320304,30 Days of Night: Dark Days,2010,"2,500+",3622,197,1211,542,2.1,14.0,,6,1,5,6,5.50,17.0
4988,tt0074553,From Noon Till Three,1976,250+,399,48,33,25,3.6,59.0,,7,3,4,7,5.70,43.0
4989,tt0790823,When Stand Up Stood Out,2006,100+,209,17,14,13,3.4,55.0,,3,2,1,3,,
4990,tt0110306,The Last Good Time,1994,Fewer than 50,43,7,2,6,4.3,78.0,,10,9,1,10,6.70,90.0
4991,tt0252028,Surviving Christmas,2004,"25,000+",28568,665,1560,776,2.6,30.0,,116,9,107,116,3.40,8.0
4992,tt0800240,Deception,2008,0,0,0,0,0,,,,0,0,0,0,,
4993,tt0100924,Where the Heart Is,1990,"1,000+",1989,52,39,40,3.2,57.0,,11,1,10,11,3.80,9.0
4994,tt1290471,The Day the Earth Stopped,2008,500+,766,36,191,98,1.9,16.0,,0,0,0,0,,
4995,tt0368913,Osama,2003,"5,000+",7319,1166,173,462,4.1,87.0,,102,98,4,102,7.80,96.0
4996,tt0259711,Vanilla Sky,2001,"250,000+",298396,23317,9040,12016,3.7,72.0,,174,74,100,174,5.30,43.0
4997,tt1684927,Swamp Shark,2011,100+,175,15,99,32,2.1,13.0,,0,0,0,0,,
4998,tt0428662,Ika resuraa,2004,500+,990,102,42,79,3.7,71.0,,1,1,0,1,,
4999,tt0065481,Bloody Mama,1970,"1,000+",1255,65,91,57,3,42.0,,7,1,6,7,4.20,14.0
5000,tt0109099,American Yakuza,1993,"2,500+",3477,68,95,67,3.1,42.0,,2,2,0,2,,
5001,tt0099014,All the Vermeers in New York,1990,500+,708,19,13,8,3.2,59.0,,7,7,0,7,7.20,100.0
5002,tt0110725,On Deadly Ground,1994,"25,000+",32987,515,978,568,2.7,34.0,,34,4,30,34,3.40,12.0
5003,tt0145600,Brave New World,1998,500+,956,58,67,53,3.1,46.0,,1,0,1,1,,
5004,tt1130884,Shutter Island,2010,"250,000+",2375821,70008,21246,26200,3.8,77.0,,265,182,83,265,6.70,69.0
5005,tt1180329,Antoine et Colette,1962,250+,494,190,25,41,4,88.0,,2,2,0,2,,
5006,tt0365611,Paper Chasers,2003,50+,92,1,0,0,,,,1,1,0,1,,
5007,tt0059630,A Rage to Live,1965,Fewer than 50,39,5,4,4,3.2,56.0,,2,0,2,2,,
5008,tt0093512,Maurice,1987,"5,000+",7580,1121,171,328,4.2,87.0,,33,27,6,33,7.60,82.0
5009,tt1736555,Caged,2011,Fewer than 50,2,0,2,0,,,,0,0,0,0,,
5010,tt1391034,And Soon the Darkness,2010,"2,500+",3113,181,959,306,2.3,16.0,,6,1,5,6,4.90,17.0
5011,tt1276107,Without a Paddle: Nature's Calling,2009,"5,000+",9092,50,357,175,2,12.0,,2,0,2,2,,
5012,tt0084899,White Dog,1982,"1,000+",2336,474,171,226,3.7,73.0,,17,16,1,17,7.90,94.0
5013,tt1332100,The Big Gay Musical,2009,500+,792,195,95,83,3.7,67.0,,7,7,0,7,6.90,100.0
5014,tt0799941,Beyond the Call,2006,0,0,0,0,0,,,,11,6,5,11,5.80,55.0
5015,tt0884322,Casper's Scare School,2006,100+,186,25,21,13,3.5,54.0,,1,1,0,1,,
5016,tt1043904,Husband for Hire,2008,100+,226,19,22,7,3.1,46.0,,0,0,0,0,,
5017,tt0120783,The Parent Trap,1998,"250,000+",530979,11843,5046,17552,3.8,70.0,,53,46,7,53,6.90,87.0
5018,tt0360717,King Kong,2005,"250,000+",33766734,59147,58281,1687538,2.8,50.0,,268,226,42,268,7.70,84.0
5019,tt0076504,Orca,1977,"5,000+",8752,324,646,384,2.8,33.0,,35,3,32,35,3.60,9.0
5020,tt1270296,The Killing Jar,2010,500+,593,81,148,59,2.8,36.0,,8,0,8,8,3.20,0.0
5021,tt1716777,People Like Us,2012,"25,000+",31959,4043,2517,864,3.5,62.0,,119,63,56,119,5.70,53.0
5022,tt0119512,Left Luggage,1998,"1,000+",1162,162,22,59,4.3,88.0,,13,6,7,13,5.30,46.0
5023,tt0064086,Bhuvan Shome,1969,100+,128,11,1,5,4.4,92.0,,2,2,0,2,,
5024,tt0458176,Thambi,2006,50+,66,4,3,0,3.1,57.0,,0,0,0,0,,
5025,tt0065486,Borsalino,1970,250+,362,47,20,7,3.6,70.0,,1,1,0,1,,
5026,tt0313300,The Blue Butterfly,2004,"2,500+",2699,144,82,97,3.7,64.0,,9,4,5,9,4.90,44.0
5027,tt0094721,Beetlejuice,1988,"250,000+",917967,54334,11952,27247,4,82.0,,65,56,9,65,7.20,86.0
5028,tt0094888,Cobra Verde,1987,"2,500+",3124,462,150,193,3.8,76.0,,18,15,3,18,6.90,83.0
5029,tt0848542,Arranged,2007,"1,000+",2140,523,66,241,4.1,89.0,,14,9,5,14,6.30,64.0
5030,tt0063688,The Thomas Crown Affair,1968,"5,000+",9799,1347,480,557,3.8,74.0,,37,26,11,37,6.50,70.0
5031,tt0132245,Driven,2001,"25,000+",43234,901,1811,823,2.7,33.0,,111,15,96,111,3.60,14.0
5032,tt0319736,The Legend of Bhagat Singh,2002,250+,371,87,15,15,4.1,85.0,,0,0,0,0,,
5033,tt1781948,Vastadu Naa Raju,2011,100+,126,113,3,0,4.8,97.0,,0,0,0,0,,
5034,tt0107004,Geronimo: An American Legend,1993,"5,000+",8032,280,263,142,3.4,51.0,,22,11,11,22,6.30,50.0
5035,tt1388394,Daddy Cool,2009,50+,89,2,20,10,1.9,9.0,,1,0,1,1,,
5036,tt0078616,From Here to Eternity,1979,0,0,0,0,0,,,,0,0,0,0,,
5037,tt0790662,Fingerprints,2006,"1,000+",1549,112,253,185,2.8,31.0,,1,0,1,1,,
5038,tt0091699,Otello,1986,500+,677,13,14,6,3.4,48.0,,4,2,2,4,,
5039,tt0338497,This Thing of Ours,2002,250+,267,11,31,16,2.3,26.0,,15,6,9,15,5.00,40.0
5040,tt0172761,Major Saab,1998,"1,000+",1183,7,41,11,2.5,15.0,,0,0,0,0,,
5041,tt0436331,Friends with Money,2006,"50,000+",77467,2353,3484,2212,2.9,40.0,,156,113,43,156,6.60,72.0
5042,tt0150405,Drylanders,1962,0,0,0,0,0,,,,0,0,0,0,,
5043,tt0283084,Tuck Everlasting,2002,"50,000+",80678,3211,1399,2479,3.8,70.0,,121,73,48,121,6.30,60.0
5044,tt0340376,The Statement,2003,"1,000+",2171,89,158,91,3,36.0,,106,25,81,106,4.70,24.0
5045,tt0097028,Cat Chaser,1989,500+,686,5,30,7,2.6,14.0,,5,2,3,5,4.90,40.0
5046,tt0080761,Friday the 13th,1980,"100,000+",229750,8955,5915,6521,3.5,60.0,,59,39,20,59,5.90,66.0
5047,tt0401462,The Helix... Loaded,2005,50+,99,1,6,4,1.4,14.0,,0,0,0,0,,
5048,tt0077414,Deathsport,1978,"1,000+",2148,27,73,59,2.6,27.0,,4,1,3,4,,
5049,tt0183306,Jinnah,1998,500+,743,115,23,46,4.2,83.0,,1,1,0,1,,
5050,tt1554092,The Howling: Reborn,2011,250+,459,60,246,95,2.3,20.0,,6,1,5,6,3.90,17.0
5051,tt1446072,Game of Death,2011,"1,000+",1076,86,349,125,2.4,20.0,,2,0,2,2,,
5052,tt1547234,Premium Rush,2012,"100,000+",132338,16975,11380,3321,3.5,60.0,,166,124,42,166,6.30,75.0
5053,tt1368443,Same Same But Different,2009,250+,260,60,32,21,3.5,65.0,,0,0,0,0,,
5054,tt1621045,Think Like a Man,2012,"100,000+",224318,17323,4516,3190,4.1,79.0,,101,55,46,101,5.50,54.0
5055,tt2020110,The Kick,2011,50+,73,14,27,12,3.1,34.0,,0,0,0,0,,
5056,tt0096171,Stealing Home,1988,"5,000+",5402,339,93,174,4,78.0,,10,2,8,10,3.40,20.0
5057,tt0083642,The Best Little Whorehouse in Texas,1982,"10,000+",15528,775,369,524,3.7,68.0,,13,6,7,13,5.10,46.0
5058,tt0092654,The Big Easy,1986,"5,000+",6923,530,339,220,3.6,61.0,,38,34,4,38,7.50,89.0
5059,tt1308010,Princesa de África,2008,0,0,0,0,0,,,,0,0,0,0,,
5060,tt0098141,The Punisher,1989,"50,000+",51845,918,1829,1274,2.8,33.0,,16,4,12,16,3.50,25.0
5061,tt0117107,Mulholland Falls,1996,"5,000+",7513,345,544,214,3,39.0,,32,10,22,32,5.10,31.0
5062,tt0906108,Why Did I Get Married?,2007,"10,000+",18244,1733,497,785,4,78.0,,42,20,22,42,5.50,48.0
5063,tt0259709,Vachanam,1989,0,0,0,0,0,,,,0,0,0,0,,
5064,tt0357054,The Last Shot,2004,"2,500+",3230,103,220,103,2.9,32.0,,68,42,26,68,6.00,62.0
5065,tt0098320,Shocker,1989,"10,000+",11919,355,769,421,2.8,32.0,,27,8,19,27,4.30,30.0
5066,tt0068498,Doomwatch,1972,50+,91,3,12,9,2.7,20.0,,2,2,0,2,,
5067,tt2342061,Devudu Chesina Manushulu,2012,Fewer than 50,17,2,5,2,2.3,29.0,,0,0,0,0,,
5068,tt0100928,White Hunter Black Heart,1990,"5,000+",6035,361,220,146,3.5,62.0,,36,30,6,36,7.00,83.0
5069,tt0159443,Five Star Stories,1989,Fewer than 50,23,4,6,2,3,40.0,,0,0,0,0,,
5070,tt0054428,The Unforgiven,1960,"5,000+",6681,200,137,107,3.4,59.0,,5,3,2,5,6.80,60.0
5071,tt0467003,Sye,2004,0,0,0,0,0,,,,0,0,0,0,,
5072,tt0415003,Garv: Pride and Honour,2004,250+,348,8,17,1,2.6,32.0,,1,0,1,1,,
5073,tt0063356,No Way to Treat a Lady,1968,500+,865,53,18,21,3.7,75.0,,9,8,1,9,7.80,89.0
5074,tt0089755,Out of Africa,1985,"25,000+",40442,5959,1271,2101,4.1,82.0,,89,56,33,89,7.00,63.0
5075,tt0946999,Deadline: Sirf 24 Ghante,2006,100+,100,1,1,2,,,,0,0,0,0,,
5076,tt0167116,Desert Saints,2002,"1,000+",1062,82,70,54,3.4,54.0,,7,2,5,7,4.70,29.0
5077,tt0074906,The Missouri Breaks,1976,"2,500+",4027,318,215,193,3.5,60.0,,28,22,6,28,6.50,79.0
5078,tt0239236,Annayya,2000,0,0,0,0,0,,,,0,0,0,0,,
5079,tt1809287,Ecstasy,2011,Fewer than 50,49,2,6,3,1.8,25.0,,0,0,0,0,,
5080,tt0082821,No Place to Hide,1981,Fewer than 50,21,8,2,0,3.6,80.0,,0,0,0,0,,
5081,tt1422191,Held Hostage,2009,100+,112,11,27,9,2.7,29.0,,1,0,1,1,,
5082,tt1352361,Cigarette Girl,2009,0,0,0,0,0,,,,0,0,0,0,,
5083,tt0313670,Sweet Sixteen,2002,"5,000+",8063,1102,157,300,4,88.0,,88,85,3,88,7.90,97.0
5084,tt0457437,Pooh's Heffalump Halloween Movie,2005,"2,500+",3482,60,44,41,3.5,58.0,,2,1,1,2,,
5085,tt0402057,Beowulf & Grendel,2005,"25,000+",26598,1064,1574,1253,2.9,40.0,,35,17,18,35,5.40,49.0
5086,tt1918887,Kaaryasthan,2010,0,0,0,0,0,,,,0,0,0,0,,
5087,tt0093177,Hellraiser,1987,"50,000+",70167,7489,2825,3813,3.8,73.0,,53,37,16,53,6.50,70.0
5088,tt0076729,Smokey and the Bandit,1977,"50,000+",56489,4835,882,2115,4.2,85.0,,36,26,10,36,6.40,72.0
5089,tt0109650,Doomsday Gun,1994,500+,873,19,17,15,3.2,53.0,,1,1,0,1,,
5090,tt0094712,Bat*21,1988,"5,000+",8393,235,176,102,3.4,57.0,,17,14,3,17,6.20,82.0
5091,tt0068440,Cycle Psycho,1973,250+,380,1,7,3,2,12.0,,0,0,0,0,,
5092,tt0096764,The Adventures of Baron Munchausen,1988,"25,000+",36596,4097,903,1588,4,82.0,,60,54,6,60,7.30,90.0
5093,tt0912587,Hear and Now,2007,500+,516,56,4,34,4.3,93.0,,9,8,1,9,7.60,89.0
5094,tt0093931,Scoop,1987,Fewer than 50,9,1,1,0,,,,0,0,0,0,,
5095,tt2258337,Eega,2012,"2,500+",2867,234,42,58,4.1,85.0,,2,2,0,2,,
5096,tt0067804,Summertree,1971,Fewer than 50,29,1,3,1,,,,1,0,1,1,,
5097,tt1763303,The First Time,2012,"5,000+",5471,1453,769,205,3.7,65.0,,18,9,9,18,5.80,50.0
5098,tt0066319,Ryan's Daughter,1970,"2,500+",2782,410,152,185,3.9,73.0,,17,8,9,17,5.50,47.0
5099,tt0332313,Periyanna,1999,0,0,0,0,0,,,,0,0,0,0,,
5100,tt0405722,Baaja,2001,0,0,0,0,0,,,,0,0,0,0,,
5101,tt0116269,Faithful,1996,"1,000+",1632,50,51,42,3.3,50.0,,16,1,15,16,3.90,6.0
5102,tt0054594,The Absent Minded Professor,1961,"5,000+",7566,439,262,188,3.5,63.0,,23,19,4,23,7.30,83.0
5103,tt0103035,Taking Care of Business,1990,"5,000+",6316,157,143,89,3.4,52.0,,15,5,10,15,3.10,33.0
5104,tt0491747,Away from Her,2006,"100,000+",114793,5927,1366,3590,3.9,81.0,,144,136,8,144,8.10,94.0
5105,tt0084351,Monsignor,1982,50+,79,4,19,4,2.3,17.0,,7,0,7,7,2.40,0.0
5106,tt1677695,Amanush,2010,0,0,0,0,0,,,,0,0,0,0,,
5107,tt0310022,Private Property,2005,500+,894,124,66,69,3.4,65.0,,33,25,8,33,6.80,76.0
5108,tt0421239,Red Eye,2005,"250,000+",436463,14438,8139,15847,3.5,64.0,,196,156,40,196,6.70,80.0
5109,tt0113442,It Takes Two,1995,"100,000+",135278,3211,2137,2755,3.5,60.0,,24,2,22,24,3.90,8.0
5110,tt0057102,The Girl Hunters,1963,500+,850,7,11,9,3.2,39.0,,2,0,2,2,,
5111,tt0099391,Decoration Day,1990,50+,58,7,4,3,3.9,64.0,,1,1,0,1,,
5112,tt0092638,Benji the Hunted,1987,"10,000+",10309,184,118,146,3.6,61.0,,11,6,5,11,6.00,55.0
5113,tt0082263,The Devil and Max Devlin,1981,"1,000+",1595,14,41,23,2.6,25.0,,12,2,10,12,4.40,17.0
5114,tt0108555,When the Bough Breaks,1994,"1,000+",1311,34,31,17,3.4,52.0,,2,1,1,2,,
5115,tt0079271,Hardcore,1979,"1,000+",2439,304,148,175,3.6,67.0,,29,22,7,29,6.70,76.0
5116,tt0057480,Scum of the Earth,1963,Fewer than 50,32,2,13,4,2.3,13.0,,0,0,0,0,,
5117,tt0167427,Superstar,1999,"50,000+",64832,3507,2398,2649,3.5,59.0,,74,24,50,74,4.40,32.0
5118,tt0060429,Frankie and Johnny,1966,"1,000+",1099,61,62,35,3.3,50.0,,3,0,3,3,,
5119,tt0244585,Khubsoorat,1980,0,0,0,0,0,,,,0,0,0,0,,
5120,tt1570728,"Crazy, Stupid, Love.",2011,"100,000+",109251,52119,14983,7429,3.9,78.0,,239,190,49,239,6.90,79.0
5121,tt0416320,Match Point,2005,"250,000+",250875,22706,5347,8658,3.9,81.0,,216,166,50,216,7.20,77.0
5122,tt0979434,Lottery Ticket,2010,"25,000+",30007,1598,2035,653,3.2,44.0,,82,28,54,82,5.10,34.0
5123,tt0080923,Inferno,1980,"5,000+",7461,851,569,502,3.4,60.0,,16,10,6,16,5.70,63.0
5124,tt0127406,High Freakquency,1998,Fewer than 50,15,0,2,0,,,,0,0,0,0,,
5125,tt0127296,Splendor,1999,"1,000+",2334,157,93,79,3.5,63.0,,21,13,8,21,5.90,62.0
5126,tt0167190,Hellboy,2004,"250,000+",459332,26914,14043,14752,3.5,66.0,,203,166,37,203,6.80,82.0
5127,tt1484925,Battlefield Heroes,2009,Fewer than 50,26,2,8,1,2.4,20.0,,0,0,0,0,,
5128,tt0847526,Sugarhouse,2007,500+,919,104,97,120,3.2,52.0,,17,5,12,17,4.30,29.0
5129,tt0243017,Waking Life,2001,"50,000+",61497,11886,1718,4574,4.2,87.0,,144,116,28,144,7.40,81.0
5130,tt1460014,Muckman,2009,0,0,0,0,0,,,,0,0,0,0,,
5131,tt0055479,The Steel Claw,1961,Fewer than 50,40,0,1,1,,,,1,1,0,1,,
5132,tt0419663,Cruel World,2005,"1,000+",1058,39,105,75,2.4,27.0,,3,1,2,3,,
5133,tt1266583,Mumbai Meri Jaan,2008,"1,000+",1070,203,56,140,3.8,78.0,,2,2,0,2,,
5134,tt0791304,Georgia Rule,2007,"250,000+",421256,10317,9470,9855,3.2,52.0,,117,22,95,117,4.00,19.0
5135,tt1152397,American Violet,2008,"10,000+",16366,578,155,271,3.9,79.0,,57,43,14,57,6.70,75.0
5136,tt1136683,100 Million BC,2008,"2,500+",3307,121,435,281,2.2,22.0,,0,0,0,0,,
5137,tt0421539,9/Tenths,2006,0,0,0,0,0,,,,0,0,0,0,,
5138,tt0095270,Hairspray,1988,"50,000+",64209,9035,2331,4079,4,80.0,,46,45,1,46,7.90,98.0
5139,tt1627934,Sasirekha Parinayam,2009,Fewer than 50,1,0,1,0,,,,0,0,0,0,,
5140,tt0107478,Made in America,1993,"25,000+",42411,385,922,422,2.8,30.0,,30,10,20,30,4.50,33.0
5141,tt1692189,Don Seenu,2010,Fewer than 50,42,3,12,3,2.7,20.0,,0,0,0,0,,
5142,tt1025103,A Room with a View,2007,Fewer than 50,5,1,4,2,2.6,20.0,,5,3,2,5,8.00,60.0
5143,tt0094663,Another Woman,1988,"5,000+",5517,774,257,253,3.8,75.0,,27,16,11,27,6.50,59.0
5144,tt0087150,Dim Sum: A Little Bit of Heart,1985,100+,224,16,16,12,3.1,50.0,,10,9,1,10,6.90,90.0
5145,tt2325683,Englishkaran,2005,0,0,0,0,0,,,,0,0,0,0,,
5146,tt0349249,Cosmopolitan,2003,0,0,0,0,0,,,,1,1,0,1,,
5147,tt2296895,Over My Dead Body,2012,Fewer than 50,31,3,4,2,3.1,43.0,,0,0,0,0,,
5148,tt0117179,Night of the Twisters,1996,"5,000+",6431,271,135,167,3.7,67.0,,0,0,0,0,,
5149,tt0067055,Equinox,1970,250+,366,56,148,76,2.6,27.0,,6,2,4,6,5.20,33.0
5150,tt0082533,The Howling,1981,"25,000+",31533,1777,1170,1161,3.5,60.0,,43,32,11,43,6.40,74.0
5151,tt0305632,Fascination,2004,0,0,0,0,0,,,,0,0,0,0,,
5152,tt4978192,Sengottai,1996,0,0,0,0,0,,,,0,0,0,0,,
5153,tt0095348,I'm Gonna Git You Sucka,1988,"10,000+",10802,1139,484,522,3.7,70.0,,29,18,11,29,5.60,62.0
5154,tt0181907,Youngblood,1978,Fewer than 50,49,9,6,3,3.4,60.0,,0,0,0,0,,
5155,tt1058017,The Invention of Lying,2009,"250,000+",667403,9171,14307,7658,3,39.0,,188,105,83,188,5.90,56.0
5156,tt0060640,"Lt. Robin Crusoe, U.S.N.",1966,"1,000+",1516,27,39,27,3.2,41.0,,2,0,2,2,,
5157,tt0469640,Bathory,2008,"1,000+",2262,216,224,146,3.2,49.0,,2,0,2,2,,
5158,tt0460925,The Sasquatch Gang,2006,"2,500+",3280,607,452,495,3.4,57.0,,13,6,7,13,5.20,46.0
5159,tt0101373,At Play in the Fields of the Lord,1991,"2,500+",3519,133,46,63,3.8,74.0,,7,4,3,7,5.70,57.0
5160,tt0076301,The Late Show,1977,"1,000+",1153,89,26,46,3.8,77.0,,37,35,2,37,7.90,95.0
5161,tt1313113,The Firm,2009,"1,000+",2172,194,348,213,2.9,36.0,,25,17,8,25,5.50,68.0
5162,tt1178640,Beer for My Horses,2008,"5,000+",5805,235,147,168,3.6,62.0,,8,0,8,8,2.90,0.0
5163,tt0080735,Final Assignment,1980,Fewer than 50,34,1,1,4,,,,0,0,0,0,,
5164,tt1119178,80 Minutes,2008,250+,326,16,38,28,2.5,30.0,,0,0,0,0,,
5165,tt0167020,Bananes mécaniques,1973,0,0,0,0,0,,,,0,0,0,0,,
5166,tt0109745,Escape from Terror: The Teresa Stamper Story,1995,Fewer than 50,4,0,1,0,,,,0,0,0,0,,
5167,tt0054167,Peeping Tom,1960,"10,000+",13972,2165,373,772,4,85.0,,59,56,3,59,8.80,95.0
5168,tt0113730,Madagascar Skin,1995,500+,761,14,5,7,3.9,74.0,,3,2,1,3,,
5169,tt1537025,Evil Weed,2009,Fewer than 50,43,2,7,3,1.7,22.0,,0,0,0,0,,
5170,tt0838265,Hurricane on the Bayou,2006,500+,895,49,28,25,3.4,64.0,,20,17,3,20,7.10,85.0
5171,tt0088814,The Black Cauldron,1985,"25,000+",45869,1406,1528,1239,3.2,48.0,,35,20,15,35,5.70,57.0
5172,tt0145400,Poodle Springs,1998,250+,336,4,18,6,2.8,18.0,,1,1,0,1,,
5173,tt0461770,Enchanted,2007,"250,000+",407938,77860,19579,38479,4,80.0,,193,179,14,193,7.30,93.0
5174,tt0091530,The Mission,1986,"25,000+",38966,5179,775,1793,4.2,87.0,,29,19,10,29,6.40,66.0
5175,tt0473464,Cherry Crush,2007,"2,500+",3051,196,323,197,2.9,38.0,,1,1,0,1,,
5176,tt0071970,The Parallax View,1974,"5,000+",5271,875,251,400,3.8,78.0,,41,36,5,41,7.80,88.0
5177,tt0065795,The Grasshopper,1970,Fewer than 50,36,6,5,3,3.2,55.0,,4,3,1,4,,
5178,tt0104438,Honeymoon in Vegas,1992,"25,000+",28406,492,892,360,3,36.0,,36,23,13,36,6.10,64.0
5179,tt0095496,Last Rites,1988,100+,113,2,23,10,1.9,8.0,,2,0,2,2,,
5180,tt0117357,The Pompatus of Love,1995,50+,87,3,10,1,2.6,23.0,,6,1,5,6,4.60,17.0
5181,tt0241254,The Blue Diner,2001,100+,216,2,2,2,,,,0,0,0,0,,
5182,tt0064382,"Goodbye, Mr. Chips",1969,500+,640,113,47,53,3.7,71.0,,6,6,0,6,7.00,100.0
5183,tt0138524,Intolerable Cruelty,2003,"50,000+",66749,3694,4027,2202,3.2,48.0,,187,141,46,187,6.80,75.0
5184,tt1281374,Don McKay,2009,500+,594,59,192,96,2.6,23.0,,26,10,16,26,4.60,38.0
5185,tt0231469,Do Badan,1966,0,0,0,0,0,,,,0,0,0,0,,
5186,tt0115725,Bogus,1996,"5,000+",9197,226,276,150,3.2,45.0,,17,7,10,17,5.00,41.0
5187,tt0053901,Hell to Eternity,1960,100+,123,11,14,9,3.2,44.0,,6,5,1,6,6.80,83.0
5188,tt0105562,Terminal Bliss,1990,50+,76,4,3,2,3.6,57.0,,3,0,3,3,,
5189,tt0382383,Yuva,2004,"2,500+",4519,307,94,127,3.8,77.0,,4,4,0,4,,
5190,tt0484265,Dragons II: The Metal Ages,2005,"1,000+",1006,15,1,8,4,94.0,,1,1,0,1,,
5191,tt0076047,The Four Feathers,1978,50+,95,4,11,4,2.9,27.0,,1,1,0,1,,
5192,tt0436742,The Salon,2005,"2,500+",3570,133,70,83,3.7,66.0,,33,4,29,33,3.60,12.0
5193,tt0072288,Thunderbolt and Lightfoot,1974,"5,000+",8839,961,350,355,3.7,73.0,,34,30,4,34,7.00,88.0
5194,tt0272020,The Last Castle,2001,"25,000+",45963,3635,1263,1361,3.8,74.0,,117,61,56,117,5.60,52.0
5195,tt0810796,Chasing the Horizon,2006,0,0,0,0,0,,,,0,0,0,0,,
5196,tt0098022,Old Gringo,1989,"1,000+",1055,33,40,23,3.2,45.0,,13,6,7,13,5.20,46.0
5197,tt0073345,The Man in the Glass Booth,1975,100+,179,29,11,14,3.6,72.0,,5,4,1,5,7.00,80.0
5198,tt0268200,Brigham City,2001,"1,000+",1799,102,25,55,3.9,80.0,,24,17,7,24,6.20,71.0
5199,tt0100685,State of Grace,1990,"5,000+",9958,1435,303,553,3.9,83.0,,26,22,4,26,6.90,85.0
5200,tt0184858,Reindeer Games,2000,"25,000+",43173,715,1897,726,2.7,27.0,,91,23,68,91,4.30,25.0
5201,tt0079714,Phantasm,1979,"10,000+",24832,2273,1111,1323,3.6,67.0,,50,37,13,50,6.50,74.0
5202,tt0942903,Stargate: The Ark of Truth,2008,"10,000+",17053,2065,545,1055,4,79.0,,4,3,1,4,,
5203,tt0286493,The Badge,2002,500+,538,46,72,49,3,39.0,,6,2,4,6,5.60,33.0
5204,tt0059319,The Ipcress File,1965,"5,000+",6526,915,157,357,4.1,85.0,,31,30,1,31,7.80,97.0
5205,tt0078150,Remember My Name,1978,100+,166,16,23,13,3,41.0,,10,7,3,10,6.50,70.0
5206,tt0056112,Jack the Giant Killer,1962,"1,000+",2111,94,58,64,3.5,62.0,,8,6,2,8,6.60,75.0
5207,tt0390221,Maria Full of Grace,2004,"25,000+",39775,4861,747,1574,4,87.0,,145,141,4,145,8.00,97.0
5208,tt2309987,Hate Story,2012,50+,58,9,28,5,2.6,24.0,,2,0,2,2,,
5209,tt0089652,My Science Project,1985,"5,000+",6246,216,169,175,3.4,56.0,,9,1,8,9,3.60,11.0
5210,tt0147811,Ankhen,1968,Fewer than 50,29,3,0,1,,,,0,0,0,0,,
5211,tt0235737,The Salton Sea,2002,"10,000+",21368,2630,565,1110,4,82.0,,83,52,31,83,5.80,63.0
5212,tt0055830,Carnival of Souls,1962,"5,000+",9585,1407,513,745,3.7,73.0,,68,59,9,68,7.20,87.0
5213,tt0869099,Lies and Crimes,2007,Fewer than 50,31,1,4,3,2.3,20.0,,0,0,0,0,,
5214,tt0307683,Yellowknife,2002,Fewer than 50,49,3,2,0,3.8,60.0,,0,0,0,0,,
5215,tt0084494,A Piano for Mrs. Cimino,1982,Fewer than 50,11,4,1,0,4.1,80.0,,0,0,0,0,,
5216,tt1454461,Ek: The Power of One,2009,500+,774,6,19,13,2.4,24.0,,0,0,0,0,,
5217,tt0061996,Mouchette,1967,"2,500+",3579,602,97,156,4.1,86.0,,27,24,3,27,7.80,89.0
5218,tt0053912,High Time,1960,50+,70,6,10,7,3.1,38.0,,3,2,1,3,,
5219,tt0082138,Carbon Copy,1981,"1,000+",1407,64,101,52,3,39.0,,1,0,1,1,,
5220,tt0078878,Bloodbrothers,1978,100+,118,8,9,3,3.2,47.0,,2,1,1,2,,
5221,tt0062975,Firecreek,1968,500+,781,71,54,39,3.4,57.0,,3,2,1,3,,
5222,tt0110598,Muriel's Wedding,1994,"50,000+",50152,4274,795,2008,4.1,84.0,,48,39,9,48,6.90,81.0
5223,tt0102032,High Strung,1992,"1,000+",1325,187,48,95,4,79.0,,0,0,0,0,,
5224,tt0054086,The Millionairess,1960,250+,456,38,61,34,3,38.0,,5,1,4,5,5.00,20.0
5225,tt0064387,Goyôkin,1969,250+,403,54,10,21,3.9,84.0,,0,0,0,0,,
5226,tt0196335,Ang pinakamagandang hayop sa balat ng lupa,1974,0,0,0,0,0,,,,0,0,0,0,,
5227,tt0383060,Zoom,2006,"10,000+",11466,828,1652,1114,2.8,33.0,,67,3,64,67,3.20,4.0
5228,tt0095687,My Stepmother Is an Alien,1988,"25,000+",37950,385,891,448,2.8,30.0,,25,5,20,25,4.00,20.0
5229,tt0213857,Manjil Virinja Pookkal,1980,0,0,0,0,0,,,,0,0,0,0,,
5230,tt0096425,Watchers,1988,"1,000+",1365,74,171,89,2.8,30.0,,5,0,5,5,3.90,0.0
5231,tt0414161,Intermedio,2005,250+,389,8,44,23,1.9,15.0,,1,0,1,1,,
5232,tt0079802,The Return of the King,1980,"5,000+",8389,219,344,212,3,39.0,,15,10,5,15,5.90,67.0
5233,tt0094142,Throw Momma from the Train,1987,"25,000+",40595,1392,1171,842,3.4,54.0,,36,23,13,36,6.00,64.0
5234,tt0252503,Heist,2001,"10,000+",19431,1246,858,558,3.4,59.0,,130,88,42,130,6.30,68.0
5235,tt0993842,Hanna,2011,"50,000+",72698,19832,10192,6988,3.5,66.0,,238,171,67,238,6.90,72.0
5236,tt0075334,To the Devil a Daughter,1976,"1,000+",2217,83,138,95,3,37.0,,11,5,6,11,5.60,45.0
5237,tt0080057,Zombi 2,1979,"10,000+",20373,2040,916,1430,3.7,69.0,,27,11,16,27,5.30,41.0
5238,tt0094761,The Blob,1988,"10,000+",22568,1384,1040,967,3.4,57.0,,28,18,10,28,5.80,64.0
5239,tt0258038,Pootie Tang,2001,"25,000+",30474,1592,922,1126,3.5,63.0,,45,12,33,45,3.70,27.0
5240,tt1606183,Boss Engira Baskaran,2010,50+,52,18,10,7,3.5,64.0,,0,0,0,0,,
5241,tt0872020,Strawberry Shortcakes,2006,500+,542,75,34,42,3.6,69.0,,0,0,0,0,,
5242,tt0096246,The Terror Within,1989,100+,229,14,53,28,2.6,21.0,,4,2,2,4,,
5243,tt0090655,April Fool's Day,1986,"10,000+",13486,603,668,532,3.2,47.0,,23,13,10,23,5.50,57.0
5244,tt0349825,Miracle,2004,"50,000+",57163,8600,959,3254,4.3,90.0,,166,134,32,166,7.00,81.0
5245,tt0072938,End Play,1976,0,0,0,0,0,,,,0,0,0,0,,
5246,tt0064247,Don't Drink the Water,1969,"1,000+",1146,13,24,17,2.9,35.0,,1,0,1,1,,
5247,tt0095119,Everybody's All-American,1988,"1,000+",1828,72,82,39,3.3,47.0,,32,14,18,32,5.20,44.0
5248,tt0899138,An American Affair,2008,"1,000+",1722,83,119,64,3,41.0,,36,6,30,36,3.70,17.0
5249,tt1092037,Time of the Comet,2008,50+,58,7,0,2,4.4,100.0,,0,0,0,0,,
5250,tt0055452,The Sinister Urge,1960,100+,136,7,37,17,1.8,16.0,,2,2,0,2,,
5251,tt0071288,The Castaway Cowboy,1974,50+,61,8,24,9,2.9,25.0,,3,2,1,3,,
5252,tt0146838,Any Given Sunday,1999,"100,000+",139041,8339,3101,3430,3.8,73.0,,127,66,61,127,5.50,52.0
5253,tt0093433,Long Gone,1987,50+,74,25,2,6,4.6,93.0,,0,0,0,0,,
5254,tt1247704,Women in Trouble,2009,"1,000+",1899,181,444,156,2.7,29.0,,24,7,17,24,4.20,29.0
5255,tt0279113,The Good Girl,2002,"50,000+",66296,3510,2437,2151,3.4,59.0,,159,131,28,159,7.00,82.0
5256,tt1483821,Asal,2010,Fewer than 50,13,1,6,0,2.4,14.0,,0,0,0,0,,
5257,tt0246765,Lumumba,2000,"1,000+",1163,159,32,49,4,83.0,,60,49,11,60,7.10,82.0
5258,tt0232908,Voodoo Academy,2000,"1,000+",1161,11,29,20,2.2,28.0,,3,1,2,3,,
5259,tt1555126,The Secret Diaries of Miss Anne Lister,2010,100+,167,53,22,10,3.6,71.0,,0,0,0,0,,
5260,tt0339714,Speed Demon,2003,"1,000+",1249,11,15,10,2.5,44.0,,1,0,1,1,,
5261,tt0064621,The Madwoman of Chaillot,1969,250+,285,19,20,9,3.1,49.0,,5,1,4,5,4.30,20.0
5262,tt0101025,"¡Ay, Carmela!",1990,500+,628,63,23,11,3.7,73.0,,3,2,1,3,,
5263,tt0473700,September Dawn,2007,"5,000+",9270,344,362,346,3,49.0,,55,9,46,55,3.70,16.0
5264,tt1298831,La blonde aux seins nus,2010,50+,59,6,14,1,3,30.0,,0,0,0,0,,
5265,tt0090567,52 Pick-Up,1986,500+,762,90,107,70,3.2,46.0,,17,9,8,17,6.10,53.0
5266,tt1746153,Crime After Crime,2011,500+,929,70,16,15,4.1,81.0,,34,31,3,34,7.30,91.0
5267,tt0492490,Son of Man,2006,500+,517,29,6,18,3.9,83.0,,7,6,1,7,6.80,86.0
5268,tt0109783,The Favor,1994,"1,000+",2304,27,104,44,2.6,21.0,,11,3,8,11,4.90,27.0
5269,tt0081696,Urban Cowboy,1980,"25,000+",32838,2030,496,897,4.1,80.0,,23,16,7,23,6.60,70.0
5270,tt0822802,Death Toll,2008,250+,294,7,26,11,2,21.0,,0,0,0,0,,
5271,tt0098347,Slaves of New York,1989,500+,884,50,21,33,3.6,70.0,,10,3,7,10,3.30,30.0
5272,tt0091763,Platoon,1986,"100,000+",240410,36055,2723,9646,4.3,93.0,,123,110,13,123,8.50,89.0
5273,tt1496872,Siva Manasula Sakthi,2009,Fewer than 50,1,1,0,0,,,,0,0,0,0,,
5274,tt0365513,Monster Man,2003,"5,000+",5264,188,190,224,3.2,50.0,,6,3,3,6,5.00,50.0
5275,tt0071282,The Cars That Ate Paris,1974,"1,000+",2107,91,174,118,2.9,34.0,,17,11,6,17,6.20,65.0
5276,tt0055831,Carry on Cruising,1962,"1,000+",2077,82,79,50,3.4,51.0,,1,0,1,1,,
5277,tt0103129,Truly Madly Deeply,1990,"10,000+",10198,1188,169,621,4.3,88.0,,38,29,9,38,6.80,76.0
5278,tt1032755,RocknRolla,2008,"50,000+",57015,12044,4995,6025,3.6,71.0,,148,89,59,148,6.00,60.0
5279,tt0098188,Renegades,1989,"5,000+",5315,56,147,83,2.9,28.0,,6,2,4,6,4.10,33.0
5280,tt0064473,The Illustrated Man,1969,500+,911,62,98,75,3.1,39.0,,15,6,9,15,5.30,40.0
5281,tt2043757,2-Headed Shark Attack,2012,250+,451,45,260,100,1.8,15.0,,4,2,2,4,,
5282,tt0060355,Duel at Diablo,1966,250+,423,59,39,31,3.5,60.0,,4,4,0,4,,
5283,tt0073092,Hard Times,1975,"2,500+",4141,410,96,171,4,81.0,,16,15,1,16,7.20,94.0
5284,tt0483719,The Living and the Dead,2006,500+,892,148,102,111,3.3,59.0,,11,10,1,11,6.90,91.0
5285,tt0901481,Eichmann,2007,"1,000+",1148,50,137,55,2.8,26.0,,8,3,5,8,4.40,38.0
5286,tt0106709,Desperate Remedies,1992,100+,204,17,7,9,3.8,71.0,,5,2,3,5,5.00,40.0
5287,tt1093908,Confessions of a Shopaholic,2009,"250,000+",292111,8945,9473,9413,3.2,49.0,,172,46,126,172,4.40,27.0
5288,tt0196216,Small Time Crooks,2000,"10,000+",15694,1404,1075,449,3.4,57.0,,101,67,34,101,6.40,66.0
5289,tt5351492,Mon Jaai,2008,0,0,0,0,0,,,,0,0,0,0,,
5290,tt0870111,Frost/Nixon,2008,"100,000+",109937,16446,2272,7750,4,88.0,,258,239,19,258,8.00,93.0
5291,tt0289873,Brian's Song,2001,500+,746,135,39,67,4,77.0,,4,2,2,4,,
5292,tt0237865,Twilight: Los Angeles,2000,Fewer than 50,43,1,0,0,,,,4,3,1,4,,
5293,tt1120985,Blue Valentine,2010,"50,000+",59391,16839,5072,4699,3.8,77.0,,213,184,29,213,7.80,86.0
5294,tt0340380,Straight from the Heart,2003,Fewer than 50,10,2,0,0,,,,0,0,0,0,,
5295,tt0079753,The Prisoner of Zenda,1979,100+,238,11,16,10,3,41.0,,2,1,1,2,,
5296,tt0081207,My Bodyguard,1980,"5,000+",6205,453,196,181,3.7,70.0,,34,27,7,34,6.80,79.0
5297,tt0434165,Lucid,2005,500+,696,78,28,55,3.7,74.0,,7,1,6,7,4.80,14.0
5298,tt0807745,Blue Collar Comedy Tour: One for the Road,2006,"5,000+",8466,378,67,187,4.2,85.0,,0,0,0,0,,
5299,tt1850397,The Loft,2014,"10,000+",15317,1642,2780,421,2.9,37.0,,43,6,37,43,3.70,14.0
5300,tt0055069,The Ladies Man,1961,"2,500+",2838,173,85,84,3.7,67.0,,11,11,0,11,7.60,100.0
5301,tt1124377,John Rabe,2009,500+,913,242,83,80,3.7,74.0,,36,27,9,36,6.40,75.0
5302,tt1220628,I Hope They Serve Beer in Hell,2009,"5,000+",5083,753,1041,645,2.9,42.0,,36,7,29,36,3.70,19.0
5303,tt0114216,Quiet Days in Hollywood,1997,250+,382,2,9,3,2.1,18.0,,2,0,2,2,,
5304,tt0063671,Targets,1968,"2,500+",3373,437,102,191,3.9,81.0,,35,32,3,35,7.80,91.0
5305,tt0274407,Callas Forever,2002,"1,000+",1576,97,81,61,3.4,54.0,,59,24,35,59,5.40,41.0
5306,tt0387037,Aurora Borealis,2005,"10,000+",15136,152,87,111,3.6,64.0,,39,27,12,39,6.30,69.0
5307,tt1196134,Crazy on the Outside,2010,"2,500+",3377,248,618,225,2.7,29.0,,12,1,11,12,2.90,8.0
5308,tt0061858,The Karate Killers,1967,50+,96,3,13,9,2.8,19.0,,0,0,0,0,,
5309,tt0096037,Satisfaction,1988,"5,000+",5273,197,180,121,3.3,52.0,,5,2,3,5,4.10,40.0
5310,tt0091187,Heartbreak Ridge,1986,"10,000+",21941,2293,824,800,3.8,74.0,,28,19,9,28,6.80,68.0
5311,tt0175997,Out in Fifty,1999,"1,000+",1159,0,14,3,1.8,0.0,,0,0,0,0,,
5312,tt0353280,Chakkikotha Chankaran,1989,0,0,0,0,0,,,,0,0,0,0,,
5313,tt0328121,My Suicidal Sweetheart,2005,100+,154,9,14,8,3,39.0,,3,0,3,3,,
5314,tt0087333,Gimme an 'F',1984,50+,89,7,16,8,2.5,30.0,,0,0,0,0,,
5315,tt0065871,I Love My Wife,1970,Fewer than 50,46,1,0,1,,,,0,0,0,0,,
5316,tt0111438,Timecop,1994,"50,000+",57793,1158,2032,1091,3,36.0,,45,19,26,45,5.20,42.0
5317,tt1264880,Chaturanga,2008,Fewer than 50,6,2,0,1,,,,0,0,0,0,,
5318,tt0221073,Chopper,2000,"25,000+",31540,4155,496,1784,4.2,89.0,,80,61,19,80,6.90,76.0
5319,tt1230372,Endure,2010,50+,57,7,31,9,2.5,18.0,,0,0,0,0,,
5320,tt0094792,Braddock: Missing in Action III,1988,"5,000+",5880,152,227,119,3.1,40.0,,3,1,2,3,,
5321,tt0062671,The Anniversary,1968,500+,845,89,33,46,3.7,73.0,,5,4,1,5,6.90,80.0
5322,tt0216417,The Wog Boy,2000,Fewer than 50,14,6,2,0,3.7,75.0,,2,0,2,2,,
5323,tt0137904,The Landlady,1998,50+,88,4,23,9,2.4,15.0,,4,0,4,4,,
5324,tt0401997,Breach,2007,"250,000+",377427,14709,7275,11962,3.5,67.0,,177,148,29,177,7.10,84.0
5325,tt0192614,The Skulls,2000,"50,000+",56996,1289,1701,958,3.1,43.0,,87,8,79,87,3.30,9.0
5326,tt0204626,The Watcher,2000,"10,000+",21674,488,1238,539,2.6,28.0,,92,10,82,92,3.50,11.0
5327,tt0449870,Chehraa,2005,100+,165,3,10,2,2.4,23.0,,0,0,0,0,,
5328,tt0096463,Working Girl,1988,"25,000+",33682,2630,1285,986,3.6,67.0,,47,39,8,47,6.90,83.0
5329,tt0055276,Parakh,1960,0,0,0,0,0,,,,0,0,0,0,,
5330,tt0093148,Harry and the Hendersons,1987,"25,000+",45737,1497,1288,1130,3.4,54.0,,22,10,12,22,5.20,45.0
5331,tt1231580,Alvin and the Chipmunks: The Squeakquel,2009,"250,000+",368727,11773,12200,7618,3.2,49.0,,85,18,67,85,4.00,21.0
5332,tt0436359,Ghost of Mae Nak,2005,"1,000+",1153,46,64,52,3.1,42.0,,0,0,0,0,,
5333,tt1728239,Double Dhamaal,2011,500+,716,43,120,37,2.4,26.0,,6,1,5,6,4.30,17.0
5334,tt1017456,Race,2008,0,0,0,0,0,,,,0,0,0,0,,
5335,tt0096152,Spellbinder,1988,500+,942,37,65,44,2.9,36.0,,2,2,0,2,,
5336,tt0068658,Grave of the Vampire,1972,100+,149,4,23,18,2.6,15.0,,2,1,1,2,,
5337,tt0079154,The Fish That Saved Pittsburgh,1979,"1,000+",1168,66,28,57,3.8,70.0,,1,0,1,1,,
5338,tt0275409,The Honeytrap,2002,Fewer than 50,23,0,1,0,,,,0,0,0,0,,
5339,tt0121802,Thank You Mask Man,1971,0,0,0,0,0,,,,0,0,0,0,,
5340,tt0338337,Paycheck,2003,"100,000+",164408,5900,7089,4173,3.1,45.0,,155,42,113,155,4.70,27.0
5341,tt1124394,Sauna,2008,"1,000+",2353,383,355,284,3.2,52.0,,4,3,1,4,,
5342,tt0308194,Dukh Bhanjan Tera Naam,1974,0,0,0,0,0,,,,0,0,0,0,,
5343,tt0067972,Werewolves on Wheels,1971,500+,765,23,70,49,2.5,25.0,,0,0,0,0,,
5344,tt1979209,Chala Mussaddi - Office Office,2011,Fewer than 50,13,5,3,3,3.2,62.0,,1,0,1,1,,
5345,tt0083340,Word of Honor,1981,50+,66,2,2,0,,,,0,0,0,0,,
5346,tt0473310,Ram Gopal Varma Ki Aag,2007,500+,723,12,128,78,1.5,9.0,,3,0,3,3,,
5347,tt0119080,Eve's Bayou,1997,"5,000+",8349,1066,126,366,4.3,89.0,,131,109,22,131,7.40,83.0
5348,tt0217824,Goodbye Charlie Bright,2001,"2,500+",3637,291,83,156,4,78.0,,2,1,1,2,,
5349,tt0240944,The Substitute: Failure Is Not an Option,2001,"1,000+",1859,27,55,23,2.6,33.0,,6,1,5,6,3.80,17.0
5350,tt1038919,The Bounty Hunter,2010,"250,000+",264053,43042,41305,6287,3.3,51.0,,154,19,135,154,3.60,12.0
5351,tt0763840,Home of the Brave,2006,"10,000+",22236,1109,1281,941,3.1,46.0,,57,13,44,57,4.20,23.0
5352,tt0820466,Alien Agent,2007,250+,410,12,67,35,2.2,15.0,,0,0,0,0,,
5353,tt0213611,Dharam Veer,1977,250+,355,16,3,6,4.1,84.0,,0,0,0,0,,
5354,tt0108526,We're Back! A Dinosaur's Story,1993,"10,000+",17426,796,804,537,3.3,50.0,,16,6,10,16,4.10,38.0
5355,tt0330099,The Brown Bunny,2003,"5,000+",8295,774,928,696,2.9,46.0,,95,45,50,95,5.40,47.0
5356,tt0376890,Silver City,2004,"2,500+",2760,95,197,101,2.8,33.0,,127,61,66,127,5.50,48.0
5357,tt0434382,Tapas,2005,500+,745,135,53,41,3.7,72.0,,0,0,0,0,,
5358,tt0092721,Captive Hearts,1987,50+,73,2,8,3,2.8,20.0,,0,0,0,0,,
5359,tt0364745,Whirlygirl,2006,"1,000+",1423,70,96,56,3.1,42.0,,0,0,0,0,,
5360,tt0107664,Necronomicon,1993,"1,000+",1403,110,164,98,3,40.0,,2,0,2,2,,
5361,tt1456941,"Tomorrow, When the War Began",2010,"5,000+",9626,1618,1209,995,3.4,57.0,,59,37,22,59,5.60,63.0
5362,tt1233192,Brighton Rock,2010,"5,000+",7708,307,636,299,2.9,32.0,,95,48,47,95,5.60,51.0
5363,tt0090967,Down by Law,1986,"10,000+",22425,5025,348,1295,4.4,94.0,,32,28,4,32,7.70,88.0
5364,tt0099902,Ju Dou,1990,"5,000+",5306,626,81,150,4,89.0,,20,20,0,20,8.30,100.0
5365,tt1185264,Freakdog,2008,500+,693,48,241,136,2.3,16.0,,15,1,14,15,3.00,7.0
5366,tt2692250,Night at the Museum: Secret of the Tomb,2014,"100,000+",101100,11028,8430,1571,3.5,57.0,,114,54,60,114,4.90,47.0
5367,tt0091455,Luxo Jr.,1986,500+,800,242,63,68,4,80.0,,1,1,0,1,,
5368,tt0110364,Little Giants,1994,"50,000+",59441,2897,1711,1500,3.6,63.0,,11,4,7,11,4.80,36.0
5369,tt0113014,Fall Time,1995,500+,661,27,50,20,2.8,35.0,,3,0,3,3,,
5370,tt0067763,Skin Game,1971,50+,89,15,12,9,3.4,56.0,,3,3,0,3,,
5371,tt1640711,A Few Best Men,2011,"1,000+",2238,417,742,235,2.8,36.0,,38,7,31,38,3.50,18.0
5372,tt0097388,Friday the 13th Part VIII: Jason Takes Manhattan,1989,"50,000+",62319,1151,3184,1841,2.5,27.0,,27,3,24,27,3.30,11.0
5373,tt0446755,The Painted Veil,2006,"50,000+",55374,13533,2326,6621,4,85.0,,143,106,37,143,7.10,74.0
5374,tt0489062,Going to Pieces: The Rise and Fall of the Slasher Film,2006,"1,000+",2335,283,101,193,3.8,74.0,,2,1,1,2,,
5375,tt3031204,Lifeu Ishtene,2011,0,0,0,0,0,,,,0,0,0,0,,
5376,tt0228040,Ice Queen,2005,250+,347,19,53,42,2.2,26.0,,0,0,0,0,,
5377,tt0380366,Ae Fond Kiss...,2004,"2,500+",4537,595,182,192,3.8,77.0,,25,22,3,25,7.30,88.0
5378,tt0371724,The Hitchhiker's Guide to the Galaxy,2005,"100,000+",233876,14545,7843,12525,3.5,65.0,,199,120,79,199,6.10,60.0
5379,tt0114489,Soldier Boyz,1995,100+,102,7,13,11,2.9,35.0,,2,0,2,2,,
5380,tt0072777,Chhoti Si Baat,1976,250+,304,40,3,6,4.2,93.0,,1,1,0,1,,
5381,tt1600680,Paris Connections,2010,0,0,0,0,0,,,,0,0,0,0,,
5382,tt0067713,Scars of Dracula,1970,"2,500+",3200,130,173,131,3.2,43.0,,8,4,4,8,6.20,50.0
5383,tt0284674,Pauly Shore Is Dead,2003,"5,000+",9364,209,516,357,2.5,29.0,,13,7,6,13,5.60,54.0
5384,tt0105572,That Night,1992,"1,000+",2170,165,42,62,4.1,80.0,,6,4,2,6,6.30,67.0
5385,tt0417148,Snakes on a Plane,2006,"250,000+",463794,14849,15259,23847,3.2,49.0,,180,124,56,180,6.20,69.0
5386,tt1090650,Dhokha,2007,Fewer than 50,1,0,1,0,,,,0,0,0,0,,
5387,tt0077226,Besharam,1978,0,0,0,0,0,,,,0,0,0,0,,
5388,tt0402127,The Defender,2004,"1,000+",1022,29,59,31,2.8,33.0,,1,0,1,1,,
5389,tt0237295,Hall of Mirrors,2001,0,0,0,0,0,,,,3,2,1,3,,
5390,tt0959285,Azhagiya Tamilmagan,2007,250+,424,30,33,26,3.1,48.0,,0,0,0,0,,
5391,tt0113627,Leaving Las Vegas,1995,"50,000+",56708,7987,1410,2679,4.1,85.0,,53,48,5,53,7.70,91.0
5392,tt2097307,Hit and Run,2012,"10,000+",10283,55,296,166,2.1,16.0,,1,0,1,1,,
5393,tt0433383,"Good Night, and Good Luck.",2005,"100,000+",142797,11298,2305,4976,3.9,83.0,,225,210,15,225,8.10,93.0
5394,tt0093379,Lady Beware,1987,250+,289,22,21,9,3.4,51.0,,2,0,2,2,,
5395,tt1104066,Green Flash,2008,100+,224,10,33,18,2.6,23.0,,1,0,1,1,,
5396,tt1766009,Prankstar,2010,0,0,0,0,0,,,,0,0,0,0,,
5397,tt1876277,Into the White,2012,"1,000+",1368,393,187,91,3.6,68.0,,11,5,6,11,5.10,45.0
5398,tt0078474,Warlords of Atlantis,1978,500+,670,38,51,37,3.1,43.0,,1,1,0,1,,
5399,tt0063145,'It's Alive!',1969,Fewer than 50,39,2,19,8,1.9,10.0,,0,0,0,0,,
5400,tt1814797,Mirapakai,2011,Fewer than 50,10,1,1,0,,,,0,0,0,0,,
5401,tt0116151,Dunston Checks In,1996,"25,000+",46094,489,719,695,3,41.0,,18,3,15,18,4.10,17.0
5402,tt0093628,Nightmare Sisters,1988,500+,943,11,27,14,2.6,29.0,,1,0,1,1,,
5403,tt0116367,From Dusk Till Dawn,1996,"250,000+",274194,18850,5865,9971,3.8,76.0,,52,33,19,52,6.20,63.0
5404,tt0275217,Banarasi Babu,1973,0,0,0,0,0,,,,0,0,0,0,,
5405,tt0120536,The Wrong Guy,1997,"5,000+",5437,442,83,289,4.2,84.0,,3,0,3,3,,
5406,tt0119465,"Kiss Me, Guido",1997,"1,000+",1772,69,103,43,3.1,40.0,,16,6,10,16,5.40,38.0
5407,tt0101669,Dead Again,1991,"10,000+",11973,1518,475,628,3.8,76.0,,52,42,10,52,7.20,81.0
5408,tt0176097,Rocktober Blood,1984,50+,92,3,14,3,2.2,18.0,,0,0,0,0,,
5409,tt0064132,Carry on Again Doctor,1969,50+,61,18,23,8,3.1,44.0,,0,0,0,0,,
5410,tt0061189,The Wild Angels,1966,"1,000+",1847,83,101,84,3.2,45.0,,19,12,7,19,5.80,63.0
5411,tt0155606,Charandas Chor,1975,0,0,0,0,0,,,,0,0,0,0,,
5412,tt2004262,Jesse Stone: Benefit of the Doubt,2012,100+,166,39,32,18,3.6,55.0,,0,0,0,0,,
5413,tt0072100,Roti Kapada Aur Makaan,1974,Fewer than 50,1,1,0,1,,,,0,0,0,0,,
5414,tt0074286,Carry on England,1976,500+,655,23,62,30,2.6,27.0,,0,0,0,0,,
5415,tt2073070,Saheb Biwi Aur Gangster,2011,0,0,0,0,0,,,,0,0,0,0,,
5416,tt0120689,The Green Mile,1999,"250,000+",815012,93120,5759,31687,4.4,94.0,,136,107,29,136,6.80,79.0
5417,tt0096486,Young Einstein,1988,"10,000+",12142,321,323,333,3.2,50.0,,33,12,21,33,4.20,36.0
5418,tt1371117,Dear Mr. Gacy,2010,500+,548,155,147,103,3.3,51.0,,2,1,1,2,,
5419,tt0360639,"Hey, Stop Stabbing Me!",2003,50+,86,4,2,3,3.6,67.0,,0,0,0,0,,
5420,tt1126596,Adulthood,2008,"2,500+",4448,1128,463,694,3.7,71.0,,2,2,0,2,,
5421,tt1825157,The Double,2013,"10,000+",18483,3110,2167,647,3.3,59.0,,133,111,22,133,6.90,83.0
5422,tt0323465,Octane,2003,"2,500+",2682,64,220,86,2.5,23.0,,6,1,5,6,3.90,17.0
5423,tt0096945,Blind Fury,1989,"5,000+",9626,404,393,296,3.3,51.0,,15,8,7,15,4.90,53.0
5424,tt0263467,In the Time of the Butterflies,2001,"2,500+",3868,370,114,163,3.9,76.0,,0,0,0,0,,
5425,tt1114680,That Evening Sun,2009,500+,921,283,88,116,3.7,76.0,,38,31,7,38,6.80,82.0
5426,tt0155802,Kattathe Kilikoodu,1983,0,0,0,0,0,,,,0,0,0,0,,
5427,tt0065611,Darling Lili,1970,"1,000+",1862,91,40,46,3.7,69.0,,5,2,3,5,4.80,40.0
5428,tt0091828,Raw Deal,1986,"10,000+",21282,527,1315,500,2.8,29.0,,16,5,11,16,4.60,31.0
5429,tt1441956,West Is West,2010,"2,500+",3174,323,262,182,3.3,55.0,,27,17,10,27,5.30,63.0
5430,tt0137494,Entrapment,1999,"100,000+",204865,3280,3281,3113,3.3,50.0,,85,34,51,85,5.20,40.0
5431,tt0119468,Kiss the Girls,1997,"50,000+",60824,3126,1892,1489,3.5,62.0,,34,11,23,34,5.40,32.0
5432,tt1704137,Ashta Chamma,2008,50+,58,12,1,2,4.2,92.0,,0,0,0,0,,
5433,tt0388973,The Girl from Monday,2005,500+,519,32,63,43,2.7,34.0,,22,9,13,22,5.00,41.0
5434,tt0785025,Love's Abiding Joy,2006,"10,000+",13992,526,134,248,4.1,80.0,,8,1,7,8,3.40,13.0
5435,tt0107798,The Pelican Brief,1993,"50,000+",75761,3354,2167,1267,3.5,61.0,,54,29,25,54,5.50,54.0
5436,tt0076639,Roseland,1977,100+,111,4,12,8,2.9,25.0,,3,1,2,3,,
5437,tt0970416,The Day the Earth Stood Still,2008,"250,000+",303727,7946,21052,18097,2.6,27.0,,195,40,155,195,4.20,21.0
5438,tt0265029,America's Sweethearts,2001,"100,000+",132433,2393,3637,2000,3,40.0,,145,47,98,145,4.60,32.0
5439,tt0286915,Duct Tape Forever,2002,500+,556,51,37,34,3.6,59.0,,10,3,7,10,5.00,30.0
5440,tt0813980,24: Redemption,2008,"5,000+",6245,1033,506,583,3.7,67.0,,20,16,4,20,6.60,80.0
5441,tt1258137,Give 'em Hell Malone,2009,"1,000+",2034,149,270,153,2.8,35.0,,1,0,1,1,,
5442,tt0154104,Aag Aur Shola,1986,0,0,0,0,0,,,,0,0,0,0,,
5443,tt0257756,High Crimes,2002,"25,000+",38909,1218,1226,572,3.3,50.0,,132,40,92,132,5.00,30.0
5444,tt0377471,Be Cool,2005,"100,000+",212654,3082,4319,3929,3,42.0,,170,51,119,170,4.60,30.0
5445,tt0082334,The Entity,1982,"10,000+",10229,683,432,494,3.5,61.0,,13,8,5,13,5.80,62.0
5446,tt0264464,Catch Me If You Can,2002,"250,000+",750347,59964,7290,19232,4.1,89.0,,203,194,9,203,7.90,96.0
5447,tt0220656,Mudhalvan,1999,50+,84,23,3,2,4.2,88.0,,0,0,0,0,,
5448,tt0352482,Kakkothi Kaavile Appoppan Thaadikal,1988,0,0,0,0,0,,,,0,0,0,0,,
5449,tt0328589,Under the Tuscan Sun,2003,"50,000+",63921,6635,1864,3155,4,78.0,,155,96,59,155,6.20,62.0
5450,tt0445934,Blades of Glory,2007,"250,000+",1403228,69470,32111,68343,3.7,68.0,,188,132,56,188,6.30,70.0
5451,tt0155068,Punnagai Mannan,1986,250+,339,21,2,6,4.3,91.0,,0,0,0,0,,
5452,tt0457875,Ek Ajnabee,2005,500+,558,30,41,18,3.1,42.0,,0,0,0,0,,
5453,tt0106677,Dazed and Confused,1993,"100,000+",236735,37718,4236,12145,4.3,90.0,,68,63,5,68,8.00,93.0
5454,tt0104522,Into the West,1992,"2,500+",4354,216,58,109,4,79.0,,13,10,3,13,6.60,77.0
5455,tt0103838,The Inner Circle,1991,250+,426,59,17,19,3.9,78.0,,8,4,4,8,5.40,50.0
5456,tt1043491,Juju Factory,2007,0,0,0,0,0,,,,0,0,0,0,,
5457,tt0107808,A Perfect World,1993,"25,000+",42023,3916,760,1040,4,84.0,,32,25,7,32,7.30,78.0
5458,tt0086230,Sadma,1983,500+,593,88,6,40,4.5,94.0,,0,0,0,0,,
5459,tt0150683,Gaman,1978,0,0,0,0,0,,,,0,0,0,0,,
5460,tt0472062,Charlie Wilson's War,2007,"100,000+",226570,27531,9959,15004,3.7,73.0,,207,170,37,207,7.00,82.0
5461,tt0066498,Ucho,1970,0,0,0,0,0,,,,0,0,0,0,,
5462,tt1510906,Third Star,2010,"1,000+",1070,482,93,113,4.2,84.0,,17,8,9,17,5.20,47.0
5463,tt0104031,Cruel Doubt,1992,Fewer than 50,32,6,2,1,3.8,75.0,,1,0,1,1,,
5464,tt0082642,The Last Chase,1981,100+,122,15,18,11,2.9,45.0,,1,1,0,1,,
5465,tt1034032,Gamer,2009,"250,000+",252028,9042,14292,8196,2.9,39.0,,82,24,58,82,4.30,29.0
5466,tt0084714,Split Image,1982,Fewer than 50,44,17,7,8,3.6,71.0,,2,1,1,2,,
5467,tt0057879,Behold a Pale Horse,1964,500+,505,35,14,12,3.6,71.0,,10,9,1,10,7.10,90.0
5468,tt2196224,Desi Romeos,2012,Fewer than 50,1,0,1,0,,,,0,0,0,0,,
5469,tt0785012,In Tranzit,2008,250+,453,57,93,48,3,38.0,,1,1,0,1,,
5470,tt2326065,Vallal,2000,0,0,0,0,0,,,,0,0,0,0,,
5471,tt0155711,Flawless,1999,"5,000+",7732,624,540,311,3.3,54.0,,57,23,34,57,5.40,40.0
5472,tt0071571,Gone in 60 Seconds,1974,"100,000+",196443,2495,1312,2151,3.7,66.0,,14,6,8,14,4.90,43.0
5473,tt0790788,The Yellow Wallpaper,2012,"1,000+",1409,1311,86,3,4.7,94.0,,0,0,0,0,,
5474,tt0077827,Lady Oscar,1979,50+,88,6,13,7,2.7,28.0,,1,0,1,1,,
5475,tt0110123,In the Army Now,1994,"25,000+",44290,839,1059,826,3,44.0,,32,2,30,32,2.60,6.0
5476,tt0356774,Kaiyethum Doorath,2002,0,0,0,0,0,,,,0,0,0,0,,
5477,tt0092236,Women of Valor,1986,50+,70,7,5,1,3.2,58.0,,0,0,0,0,,
5478,tt0305396,The Crocodile Hunter: Collision Course,2002,"25,000+",43938,415,534,847,3.1,44.0,,83,44,39,83,5.40,53.0
5479,tt0249783,Sri Manjunatha,2001,50+,55,3,3,0,3.8,50.0,,0,0,0,0,,
5480,tt0181852,Terminator 3: Rise of the Machines,2003,"250,000+",442205,13049,15202,13701,3.2,46.0,,207,144,63,207,6.60,70.0
5481,tt0833444,Dombivli Fast,2005,Fewer than 50,14,6,1,0,3.9,86.0,,0,0,0,0,,
5482,tt1204979,Vacancy 2: The First Cut,2008,"5,000+",8841,156,604,292,2.4,21.0,,4,2,2,4,,
5483,tt0951257,Bi the Way,2008,0,0,0,0,0,,,,0,0,0,0,,
5484,tt0058969,The Big Job,1965,100+,139,7,12,10,3.2,37.0,,0,0,0,0,,
5485,tt3440256,Manasu Mata Vinadu,2005,0,0,0,0,0,,,,0,0,0,0,,
5486,tt0268380,Ice Age,2002,"250,000+",1135453,64050,14204,27834,4,82.0,,168,129,39,168,6.80,77.0
5487,tt1716753,Monster Brawl,2011,250+,256,31,167,70,1.9,16.0,,0,0,0,0,,
5488,tt0985694,Machete,2010,"100,000+",109734,16787,9689,7430,3.5,63.0,,195,137,58,195,6.30,70.0
5489,tt0283911,Bas Itna Sa Khwaab Hai...,2001,0,0,0,0,0,,,,0,0,0,0,,
5490,tt0473342,Car Babes,2006,100+,151,5,13,6,2.8,28.0,,0,0,0,0,,
5491,tt1361843,Van Diemen's Land,2009,500+,931,139,155,126,3.1,47.0,,10,8,2,10,6.60,80.0
5492,tt1708534,The Dragon Pearl,2011,100+,114,26,39,14,3,40.0,,4,4,0,4,,
5493,tt0102653,Perfect Harmony,1991,"1,000+",1189,69,6,34,4.4,92.0,,2,1,1,2,,
5494,tt0081617,Terror Train,1980,"5,000+",5506,280,465,275,3,38.0,,16,7,9,16,5.00,44.0
5495,tt0073722,Smile,1975,"1,000+",1159,96,41,54,3.5,70.0,,19,19,0,19,7.80,100.0
5496,tt0069080,Pete 'n' Tillie,1972,100+,197,20,8,3,3.5,71.0,,6,4,2,6,6.80,67.0
5497,tt0097276,Enemies: A Love Story,1989,"1,000+",1295,46,39,24,3.4,54.0,,28,25,3,28,7.30,89.0
5498,tt0073181,It Seemed Like a Good Idea at the Time,1975,50+,72,0,7,1,2.1,0.0,,0,0,0,0,,
5499,tt0098442,Tap,1989,"1,000+",2073,97,43,55,3.9,69.0,,9,5,4,9,5.60,56.0
5500,tt0832313,Nice Bombs,2006,50+,85,3,0,2,,,,7,4,3,7,5.70,57.0
5501,tt0229260,Book of Shadows: Blair Witch 2,2000,"50,000+",58245,570,2648,1557,2,18.0,,110,15,95,110,3.50,14.0
5502,tt1014673,Can Mr. Smith Get to Washington Anymore?,2006,0,0,0,0,0,,,,0,0,0,0,,
5503,tt0102300,Lies Before Kisses,1991,Fewer than 50,28,1,2,1,,,,0,0,0,0,,
5504,tt0407887,The Departed,2006,"250,000+",739210,163638,11058,58090,4.4,94.0,,287,260,27,287,8.30,91.0
5505,tt0066601,Zabriskie Point,1970,"10,000+",11132,882,304,341,3.8,74.0,,32,21,11,32,6.50,66.0
5506,tt0775080,Closed for Winter,2009,500+,870,12,36,26,2.7,25.0,,4,0,4,4,,
5507,tt0115484,Agni Sakshi,1996,0,0,0,0,0,,,,0,0,0,0,,
5508,tt0054744,The Choppers,1961,50+,58,1,4,4,3,20.0,,0,0,0,0,,
5509,tt1431152,Sivandha Mann,1969,0,0,0,0,0,,,,0,0,0,0,,
5510,tt0054020,The Leech Woman,1960,100+,172,7,59,32,2.2,11.0,,1,1,0,1,,
5511,tt0205214,The Magical Legend of the Leprechauns,1999,"2,500+",3682,263,66,155,4.1,80.0,,2,1,1,2,,
5512,tt0920457,Billa,2007,250+,394,46,20,20,3.9,70.0,,0,0,0,0,,
5513,tt0111474,Trancers 4: Jack of Swords,1994,"1,000+",1054,12,43,23,2.6,22.0,,0,0,0,0,,
5514,tt0920457,Billa,2007,250+,394,46,20,20,3.9,70.0,,0,0,0,0,,
5515,tt0804452,Bratz,2007,"25,000+",49278,2002,2326,2107,3,46.0,,80,8,72,80,3.40,10.0
5516,tt0059028,Chemmeen,1965,0,0,0,0,0,,,,0,0,0,0,,
5517,tt0344485,Toutes ces belles promesses,2003,0,0,0,0,0,,,,1,1,0,1,,
5518,tt0120794,The Prince of Egypt,1998,Fewer than 50,22,20,2,5,4.5,91.0,,0,0,0,0,,
5519,tt0379504,Shriman Shrimati,1982,Fewer than 50,26,1,1,0,,,,0,0,0,0,,
5520,tt0081036,The Lathe of Heaven,1980,500+,882,104,40,59,3.8,72.0,,4,2,2,4,,
5521,tt1316037,Birdemic: Shock and Terror,2010,"1,000+",1897,362,976,575,1.9,27.0,,17,3,14,17,4.00,18.0
5522,tt0079668,The Onion Field,1979,"1,000+",1998,197,109,67,3.5,64.0,,14,12,2,14,7.40,86.0
5523,tt0082000,Contamination,1980,500+,804,63,141,101,2.8,31.0,,5,2,3,5,3.20,40.0
5524,tt0145547,Two Hands,1999,"5,000+",7506,899,225,410,3.9,80.0,,8,6,2,8,6.10,75.0
5525,tt0065207,Where Eagles Dare,1968,"25,000+",27749,3352,430,1262,4.2,89.0,,24,20,4,24,6.50,83.0
5526,tt1202056,Waveriders,2008,100+,101,17,12,12,3.6,59.0,,16,9,7,16,5.40,56.0
5527,tt5332216,Krishnan Love Story,2010,0,0,0,0,0,,,,0,0,0,0,,
5528,tt0831280,Waking Madison,2010,100+,173,29,37,12,3,43.0,,2,0,2,2,,
5529,tt0086265,Scrubbers,1982,Fewer than 50,47,3,4,3,3.3,43.0,,1,1,0,1,,
5530,tt1802480,Kizhakku Kadarkarai Salai,2006,0,0,0,0,0,,,,0,0,0,0,,
5531,tt0084675,Shoot the Moon,1982,500+,736,100,33,39,3.8,75.0,,14,12,2,14,7.70,86.0
5532,tt0094226,The Untouchables,1987,"100,000+",218041,25257,3257,7520,4.1,89.0,,75,62,13,75,7.60,83.0
5533,tt1371619,Chakk De Phatte,2008,Fewer than 50,1,0,1,0,,,,1,1,0,1,,
5534,tt0091064,The Fly,1986,"50,000+",90438,10320,2096,3629,4,83.0,,75,70,5,75,8.40,93.0
5535,tt0144964,Highlander: Endgame,2000,"25,000+",46380,635,1036,839,2.9,38.0,,53,6,47,53,3.30,11.0
5536,tt0146984,The Legend of Bagger Vance,2000,"50,000+",51214,3621,1971,1434,3.6,65.0,,130,56,74,130,5.30,43.0
5537,tt0089015,Desert Hearts,1985,"2,500+",3501,346,103,115,4,77.0,,30,27,3,30,7.50,90.0
5538,tt0071517,Foxy Brown,1974,"5,000+",7790,727,375,387,3.6,66.0,,22,14,8,22,5.70,64.0
5539,tt1612611,Phoonk 2,2010,Fewer than 50,4,0,3,0,,,,2,1,1,2,,
5540,tt0064806,The Phantom Tollbooth,1970,"2,500+",3585,368,117,201,3.9,76.0,,11,11,0,11,7.00,100.0
5541,tt0080012,That Sinking Feeling,1979,Fewer than 50,35,10,6,0,3.4,62.0,,3,2,1,3,,
5542,tt1305591,Mars Needs Moms,2011,"25,000+",27792,1913,2901,977,3,40.0,,116,43,73,116,5.00,37.0
5543,tt0451850,Paheli,2005,"5,000+",7255,373,195,195,3.6,66.0,,8,5,3,8,6.00,63.0
5544,tt0093993,Sleeping Beauty,1987,"1,000+",1240,24,24,24,3.5,50.0,,0,0,0,0,,
5545,tt0454082,Black Christmas,2006,"100,000+",138064,2978,4919,4211,2.8,38.0,,65,9,56,65,3.50,14.0
5546,tt0189525,First Daughter,1999,500+,568,28,31,13,3.2,47.0,,0,0,0,0,,
5547,tt0089463,Latino,1985,Fewer than 50,40,4,0,0,,,,0,0,0,0,,
5548,tt0057197,Jason and the Argonauts,1963,"10,000+",22821,1980,527,899,3.9,79.0,,46,41,5,46,7.50,89.0
5549,tt0362506,Chrystal,2004,"1,000+",1223,79,59,47,3.5,57.0,,20,16,4,20,7.00,80.0
5550,tt0390384,Primer,2004,"25,000+",46629,8733,2295,4086,3.9,79.0,,131,95,36,131,6.60,73.0
5551,tt0073139,I Wonder Who's Killing Her Now?,1975,50+,58,1,9,4,2.4,10.0,,0,0,0,0,,
5552,tt0054345,Strangers When We Meet,1960,"1,000+",1102,31,25,26,3.4,55.0,,5,3,2,5,5.80,60.0
5553,tt0055916,The Dock Brief,1962,100+,103,4,5,2,3.1,44.0,,3,2,1,3,,
5554,tt0078294,Somebody Killed Her Husband,1978,Fewer than 50,2,1,1,0,,,,2,0,2,2,,
5555,tt0126871,Deewana,1992,500+,811,55,45,19,3.4,55.0,,0,0,0,0,,
5556,tt1059925,Greta,2009,"2,500+",2797,597,470,233,3.4,56.0,,5,3,2,5,5.20,60.0
5557,tt0301215,Doosara Aadmi,1977,Fewer than 50,36,2,1,1,,,,0,0,0,0,,
5558,tt0077278,Buck Rogers in the 25th Century,1979,"2,500+",2616,110,94,94,3.4,54.0,,12,3,9,12,4.30,25.0
5559,tt0061722,The Graduate,1967,"100,000+",183862,21821,2493,6996,4.2,90.0,,88,76,12,88,8.90,86.0
5560,tt0456413,Fight Club: Members Only,2006,"5,000+",8678,114,79,119,3.4,59.0,,0,0,0,0,,
5561,tt0278291,Ajnabee,2001,500+,992,58,56,25,3.2,51.0,,0,0,0,0,,
5562,tt1254966,Northern Comfort,2010,0,0,0,0,0,,,,1,1,0,1,,
5563,tt0462482,Population 436,2006,"5,000+",9317,327,633,470,2.9,34.0,,4,3,1,4,,
5564,tt0102729,Pure Luck,1991,"5,000+",6549,325,212,205,3.5,60.0,,13,2,11,13,3.90,15.0
5565,tt0073605,Rancho Deluxe,1975,"1,000+",1522,32,50,34,3,40.0,,22,16,6,22,6.30,73.0
5566,tt1385867,Cop Out,2010,"250,000+",489096,7565,11604,5668,3,39.0,,164,29,135,164,3.90,18.0
5567,tt1336620,Between Heaven and Hell,2008,0,0,0,0,0,,,,0,0,0,0,,
5568,tt1042497,Exit Speed,2008,"1,000+",2093,45,111,68,2.7,29.0,,0,0,0,0,,
5569,tt1458924,Ivar Vivahitharayal...?,2009,Fewer than 50,14,0,1,0,,,,0,0,0,0,,
5570,tt0261996,Sri Krishnanjaneya Yuddham,1972,0,0,0,0,0,,,,0,0,0,0,,
5571,tt0292097,Markova: Comfort Gay,2000,50+,63,6,3,5,3.4,67.0,,0,0,0,0,,
5572,tt0087262,Firestarter,1984,"50,000+",55184,1682,1514,919,3.4,53.0,,34,13,21,34,5.00,38.0
5573,tt0057890,The Black Torment,1964,50+,71,4,8,4,3.1,33.0,,1,1,0,1,,
5574,tt0822868,Make It Happen,2008,"10,000+",13116,470,689,521,3,40.0,,17,4,13,17,4.50,24.0
5575,tt0058383,Murder Most Foul,1964,500+,521,103,40,37,3.8,72.0,,4,2,2,4,,
5576,tt0445022,Jurm,2005,250+,336,7,17,3,2.8,29.0,,0,0,0,0,,
5577,tt0108473,The Vanishing,1993,"10,000+",15524,858,1011,547,3.1,46.0,,37,18,19,37,5.20,49.0
5578,tt0429482,50 Ways of Saying Fabulous,2005,"1,000+",1062,28,29,35,3,49.0,,10,3,7,10,4.90,30.0
5579,tt0054805,The Devil at 4 O'Clock,1961,500+,879,39,33,25,3.4,54.0,,5,4,1,5,6.10,80.0
5580,tt1263679,Firaaq,2008,250+,305,86,20,41,3.8,81.0,,3,3,0,3,,
5581,tt0065063,Take the Money and Run,1969,"10,000+",11951,2014,501,558,3.9,80.0,,23,21,2,23,6.90,91.0
5582,tt0107086,Hated: GG Allin & the Murder Junkies,1993,"1,000+",1154,250,73,122,3.9,78.0,,8,5,3,8,6.20,63.0
5583,tt0099045,Anything to Survive,1990,100+,144,7,4,3,3.8,64.0,,0,0,0,0,,
5584,tt14338048,Jothe Jotheyali,2006,Fewer than 50,2,2,0,0,,,,0,0,0,0,,
5585,tt0067180,"Happy Birthday, Wanda June",1971,100+,179,6,2,2,3.7,75.0,,0,0,0,0,,
5586,tt0095583,Maniac Cop,1988,"5,000+",8264,462,674,391,3.1,41.0,,15,8,7,15,5.00,53.0
5587,tt0420225,Path of Destruction,2005,Fewer than 50,12,1,5,3,1.8,17.0,,0,0,0,0,,
5588,tt0169806,Dropout,1970,0,0,0,0,0,,,,0,0,0,0,,
5589,tt0206963,My First Mister,2001,"5,000+",5228,440,144,215,3.8,75.0,,81,43,38,81,5.60,53.0
5590,tt0832937,Radiant City,2006,"2,500+",3729,125,39,85,3.8,76.0,,17,16,1,17,6.90,94.0
5591,tt0099277,Class of 1999,1990,"1,000+",1451,182,186,132,3.3,50.0,,8,5,3,8,5.50,63.0
5592,tt0086320,Sleepaway Camp,1983,"10,000+",18154,1954,1269,1512,3.5,61.0,,27,22,5,27,6.50,81.0
5593,tt0145734,Playing by Heart,1998,"10,000+",20103,1760,473,762,4,79.0,,53,32,21,53,6.00,60.0
5594,tt0325005,[Anti]killer,2002,Fewer than 50,2,1,1,0,,,,0,0,0,0,,
5595,tt0120873,U.S. Marshals,1998,"50,000+",90792,3800,3331,1831,3.3,53.0,,43,13,30,43,4.90,30.0
5596,tt5171096,Suren Suror Putek,2005,0,0,0,0,0,,,,0,0,0,0,,
5597,tt0478976,Bad Reputation,2007,250+,409,18,46,32,2.7,29.0,,1,1,0,1,,
5598,tt0106601,Conflict of Interest,1993,50+,85,2,11,3,2.1,15.0,,0,0,0,0,,
5599,tt2050633,The Barrens,2012,500+,727,79,287,85,2.4,22.0,,3,1,2,3,,
5600,tt0163579,Chill Factor,1999,"10,000+",13211,183,423,172,2.7,30.0,,79,8,71,79,3.60,10.0
5601,tt0084049,Hanky Panky,1982,"1,000+",1275,37,83,42,2.9,31.0,,10,4,6,10,5.10,40.0
5602,tt1253864,Immortals,2011,"50,000+",68792,15228,16063,5575,3.2,49.0,,138,68,70,138,5.40,49.0
5603,tt0155886,Mouna Geethanagal,1981,0,0,0,0,0,,,,0,0,0,0,,
5604,tt0331933,Man of the House,2005,"50,000+",61642,1602,1893,1343,3.1,46.0,,67,6,61,67,3.40,9.0
5605,tt0067817,T.R. Baskin,1971,Fewer than 50,2,1,0,1,,,,6,0,6,6,4.00,0.0
5606,tt1453409,Dinocroc vs. Supergator,2010,250+,310,26,105,48,2,20.0,,1,0,1,1,,
5607,tt1715802,How to Die in Oregon,2011,500+,637,341,23,93,4.4,94.0,,11,11,0,11,8.30,100.0
5608,tt0485486,Something Something... Unnakum Ennakum,2006,0,0,0,0,0,,,,0,0,0,0,,
5609,tt0110950,Reality Bites,1994,"50,000+",53223,5570,1952,2217,3.8,74.0,,59,37,22,59,6.10,63.0
5610,tt1577854,Munde U.K. De,2009,0,0,0,0,0,,,,2,0,2,2,,
5611,tt0085809,Koyaanisqatsi,1982,"10,000+",15174,3166,309,1152,4.4,91.0,,23,21,2,23,8.10,91.0
5612,tt0120199,Space Truckers,1996,"5,000+",5425,96,218,150,2.6,31.0,,12,2,10,12,4.30,17.0
5613,tt0090835,Choices,1986,50+,60,1,1,1,,,,0,0,0,0,,
5614,tt0171741,Shot Through the Heart,1998,500+,745,64,13,32,4,83.0,,1,0,1,1,,
5615,tt0085244,The Big Chill,1983,"10,000+",22403,2643,789,1004,3.9,77.0,,41,29,12,41,6.20,71.0
5616,tt0234853,The Tao of Steve,2000,"5,000+",6246,571,257,283,3.6,69.0,,49,39,10,49,6.80,80.0
5617,tt0425598,Dave Chappelle's Block Party,2005,"50,000+",96746,2179,760,1348,3.8,74.0,,128,118,10,128,7.70,92.0
5618,tt0449010,Eragon,2006,"250,000+",519544,19246,22211,28928,3,46.0,,126,20,106,126,4.10,16.0
5619,tt0060648,Mademoiselle,1966,500+,554,44,14,17,3.8,76.0,,3,2,1,3,,
5620,tt8947996,Enakkoru Magan Pirappan,1996,0,0,0,0,0,,,,0,0,0,0,,
5621,tt0110518,A Million to Juan,1994,"1,000+",1257,29,20,17,3.6,59.0,,2,0,2,2,,
5622,tt0398286,Tangled,2010,"100,000+",151241,52916,7949,11280,4.2,87.0,,228,203,25,228,7.50,89.0
5623,tt0116908,The Long Kiss Goodnight,1996,"50,000+",62455,3989,1672,2181,3.7,70.0,,59,40,19,59,6.10,68.0
5624,tt1230449,Black Bridge,2006,0,0,0,0,0,,,,0,0,0,0,,
5625,tt0419967,Miracle Run,2004,"2,500+",3981,280,35,158,4.3,89.0,,1,1,0,1,,
5626,tt0100200,Mr. & Mrs. Bridge,1990,"1,000+",1369,54,70,33,3.2,44.0,,17,14,3,17,6.00,82.0
5627,tt0056331,Panic in Year Zero!,1962,500+,666,105,62,74,3.5,63.0,,9,6,3,9,5.70,67.0
5628,tt1425633,Venezzia,2009,50+,81,13,6,7,3.6,68.0,,0,0,0,0,,
5629,tt0904127,The Poet,2007,250+,441,35,47,27,2.9,43.0,,3,0,3,3,,
5630,tt4338904,Puli Vesham,2011,0,0,0,0,0,,,,0,0,0,0,,
5631,tt0086383,Sudden Impact,1983,"10,000+",21981,1399,1191,700,3.4,54.0,,40,21,19,40,5.60,53.0
5632,tt0160459,The Lesser Evil,1998,50+,75,11,4,6,3.5,73.0,,5,3,2,5,7.10,60.0
5633,tt0816179,Stand Up for Justice,2004,0,0,0,0,0,,,,0,0,0,0,,
5634,tt0058166,Guns at Batasi,1964,100+,163,34,11,14,3.8,77.0,,0,0,0,0,,
5635,tt0444682,The Reaping,2007,"50,000+",79023,7172,7460,6624,3.2,49.0,,132,10,122,132,3.50,8.0
5636,tt0216799,Harrison's Flowers,2000,"2,500+",4753,387,122,156,3.8,76.0,,86,42,44,86,5.60,49.0
5637,tt0146990,Like It Is,1998,"1,000+",1052,39,46,36,3.4,46.0,,9,1,8,9,3.70,11.0
5638,tt1037033,A Complete History of My Sexual Failures,2008,"1,000+",2408,443,347,377,3.3,56.0,,9,5,4,9,5.50,56.0
5639,tt0087635,The Lonely Guy,1984,"2,500+",4909,276,311,185,3.2,47.0,,21,10,11,21,5.20,48.0
5640,tt1847731,Tomboy,2011,"5,000+",8362,1798,378,272,3.9,83.0,,72,69,3,72,7.80,96.0
5641,tt0105321,Saved by the Bell: Hawaiian Style,1992,"2,500+",4795,233,139,116,3.7,63.0,,1,1,0,1,,
5642,tt0426190,Un rey en La Habana,2005,500+,507,49,6,24,4.3,89.0,,0,0,0,0,,
5643,tt0297181,I Spy,2002,"50,000+",78705,1374,2771,1357,2.8,33.0,,134,20,114,134,4.10,15.0
5644,tt0089628,Movers & Shakers,1985,100+,138,7,20,4,2.5,26.0,,1,0,1,1,,
5645,tt0111693,When a Man Loves a Woman,1994,"25,000+",41291,2436,710,1064,4,77.0,,99,68,31,99,6.60,69.0
5646,tt0108956,World War II: When Lions Roared,1994,Fewer than 50,42,5,5,5,3.2,50.0,,1,1,0,1,,
5647,tt1037015,The Big Shot-Caller,2008,"5,000+",5529,4,3,1,3.2,57.0,,13,3,10,13,4.80,23.0
5648,tt0308208,Ballistic: Ecks vs. Sever,2002,"10,000+",23068,347,1393,668,2,20.0,,119,0,119,119,2.80,0.0
5649,tt0323103,"Long Life, Happiness & Prosperity",2002,500+,680,72,42,53,3.6,63.0,,7,2,5,7,5.30,29.0
5650,tt0350061,Ripper 2: Letter from Within,2004,100+,108,3,12,6,2.1,20.0,,2,0,2,2,,
5651,tt0418763,Jarhead,2005,"250,000+",393033,18644,8722,13156,3.6,68.0,,199,120,79,199,6.40,60.0
5652,tt0070190,Horror Hospital,1973,250+,413,26,37,28,2.9,41.0,,2,1,1,2,,
5653,tt0363833,Mumbai Se Aaya Mera Dost,2003,250+,397,6,18,2,2,25.0,,0,0,0,0,,
5654,tt0113224,The Grotesque,1995,100+,207,5,11,3,2.8,31.0,,1,1,0,1,,
5655,tt0181836,The Specials,2000,"1,000+",2416,156,127,144,3.3,55.0,,15,7,8,15,5.10,47.0
5656,tt1471332,Kali Sankar,2007,0,0,0,0,0,,,,0,0,0,0,,
5657,tt0053908,Hideout in the Sun,1960,0,0,0,0,0,,,,3,3,0,3,,
5658,tt0383053,Windy City Heat,2003,"1,000+",1334,285,62,111,4.2,82.0,,6,3,3,6,3.70,50.0
5659,tt0068637,Get to Know Your Rabbit,1972,100+,206,16,22,12,3.2,42.0,,4,2,2,4,,
5660,tt1098360,The Next Hit,2008,50+,70,2,2,2,,,,0,0,0,0,,
5661,tt0461703,Skinwalkers,2006,"100,000+",104857,1062,3144,2032,2.5,25.0,,38,5,33,38,3.60,13.0
5662,tt0217031,Second to Die,2002,500+,880,4,7,5,2.6,36.0,,2,1,1,2,,
5663,tt0091653,Nothing in Common,1986,"5,000+",6100,162,243,82,3.1,40.0,,24,13,11,24,5.90,54.0
5664,tt1360875,Katalin Varga,2009,500+,532,127,51,55,3.6,72.0,,21,20,1,21,7.40,95.0
5665,tt0057813,The 7th Dawn,1964,100+,109,11,5,2,3.8,69.0,,2,0,2,2,,
5666,tt0491223,A Very Serious Person,2006,100+,202,15,15,18,3.1,50.0,,1,0,1,1,,
5667,tt0073569,Prem Kahani,1975,Fewer than 50,17,1,0,0,,,,0,0,0,0,,
5668,tt0433416,The Namesake,2006,"50,000+",64329,7959,2124,4218,3.8,79.0,,135,115,20,135,7.50,85.0
5669,tt0094765,Bloodstone,1988,100+,205,6,10,9,3.2,38.0,,3,0,3,3,,
5670,tt0363721,Joggers' Park,2003,250+,306,11,13,7,3,46.0,,1,0,1,1,,
5671,tt1345777,Ishqiya,2010,500+,992,200,122,142,3.4,62.0,,2,2,0,2,,
5672,tt1443519,Saat Pake Bandha,2009,0,0,0,0,0,,,,0,0,0,0,,
5673,tt2170285,Arasu,2007,Fewer than 50,1,1,0,0,,,,0,0,0,0,,
5674,tt0085724,Independence Day,1983,100+,114,5,3,0,3.5,62.0,,1,1,0,1,,
5675,tt0091860,River's Edge,1986,"5,000+",9174,1182,382,521,3.8,75.0,,43,38,5,43,7.40,88.0
5676,tt0339707,Song for a Raggy Boy,2003,"1,000+",2121,273,34,132,4.2,89.0,,6,4,2,6,5.80,67.0
5677,tt0405266,Raincoat,2004,"2,500+",2778,203,54,87,3.9,79.0,,5,4,1,5,7.40,80.0
5678,tt1176740,Away We Go,2009,"50,000+",59475,8007,2826,3848,3.7,74.0,,192,129,63,192,6.60,67.0
5679,tt0101811,Enchanted April,1991,"5,000+",7657,643,127,261,4.1,83.0,,33,28,5,33,7.00,85.0
5680,tt0892051,Evil Angel,2009,100+,179,17,58,19,2.4,23.0,,0,0,0,0,,
5681,tt0120888,The Wedding Singer,1998,"250,000+",746558,34577,8507,21259,4,80.0,,69,50,19,69,6.30,72.0
5682,tt0103064,Terminator 2: Judgment Day,1991,"250,000+",750539,62527,3598,25584,4.5,95.0,,87,79,8,87,8.40,91.0
5683,tt0084749,The Sword and the Sorcerer,1982,"2,500+",4617,187,229,184,3.1,45.0,,12,8,4,12,6.10,67.0
5684,tt0112864,Die Hard with a Vengeance,1995,"250,000+",412131,35531,7075,13414,4,83.0,,77,45,32,77,6.10,58.0
5685,tt0414387,Pride & Prejudice,2005,"250,000+",460099,62859,7386,32709,4.3,89.0,,180,156,24,180,7.70,87.0
5686,tt0424867,Bristol Boys,2006,250+,363,26,18,17,3.4,59.0,,0,0,0,0,,
5687,tt0790604,Deck the Halls,2006,"50,000+",55849,1187,2802,1634,2.6,30.0,,86,5,81,86,3.00,6.0
5688,tt0425055,Game 6,2005,"10,000+",24154,122,205,148,3,37.0,,42,26,16,42,6.00,62.0
5689,tt0078351,Sweeney 2,1978,250+,334,26,16,19,3.6,62.0,,2,2,0,2,,
5690,tt0339847,Urutoraman Kosumosu: The First Contact,2001,0,0,0,0,0,,,,0,0,0,0,,
5691,tt0110546,Mohra,1994,500+,506,52,26,13,3.7,67.0,,0,0,0,0,,
5692,tt0056307,On the Beat,1962,500+,708,39,11,25,4.2,78.0,,1,0,1,1,,
5693,tt0236034,Born Romantic,2000,"1,000+",1770,71,59,54,3.4,55.0,,31,18,13,31,5.50,58.0
5694,tt0093737,The Pick-up Artist,1987,"5,000+",7697,259,435,147,3,37.0,,23,14,9,23,5.10,61.0
5695,tt0091892,Sarraounia,1986,Fewer than 50,20,2,0,1,,,,3,2,1,3,,
5696,tt0105112,Patriot Games,1992,"50,000+",70861,5130,1946,1524,3.7,73.0,,102,73,29,102,6.80,72.0
5697,tt0268449,Mehbooba,1976,50+,62,3,1,0,,,,0,0,0,0,,
5698,tt1394329,Free Willy: Escape from Pirate's Cove,2010,"1,000+",1477,157,162,76,3.4,49.0,,3,1,2,3,,
5699,tt0060636,Lord Love a Duck,1966,"1,000+",1363,87,33,57,3.8,72.0,,10,7,3,10,7.20,70.0
5700,tt2108661,Won't Last a Day Without You,2011,Fewer than 50,45,10,10,5,3.5,50.0,,0,0,0,0,,
5701,tt0099652,Ghayal,1990,Fewer than 50,1,1,0,0,,,,1,1,0,1,,
5702,tt0090852,Clockwise,1986,"5,000+",6743,421,222,235,3.6,65.0,,5,4,1,5,6.00,80.0
5703,tt1282142,The Nanny Express,2008,250+,270,42,28,13,3.6,60.0,,0,0,0,0,,
5704,tt0102945,Sleeping with the Enemy,1991,"50,000+",63929,2904,1908,1535,3.5,60.0,,37,8,29,37,4.50,22.0
5705,tt0080431,Beyond Evil,1980,100+,175,5,22,4,2.4,19.0,,0,0,0,0,,
5706,tt0106375,Beethoven's 2nd,1993,"50,000+",68715,470,1049,718,2.8,31.0,,13,3,10,13,4.50,23.0
5707,tt0069000,Nidhanaya,1972,0,0,0,0,0,,,,0,0,0,0,,
5708,tt1417579,Yaya & Angelina: The Spoiled Brat Movie,2009,0,0,0,0,0,,,,0,0,0,0,,
5709,tt0266425,Conspiracy,2001,"2,500+",3586,902,140,315,4.1,87.0,,7,7,0,7,6.50,100.0
5710,tt0165625,Ankhiyon Ke Jharokhon Se,1978,Fewer than 50,35,3,1,1,,,,0,0,0,0,,
5711,tt0294345,Beethoven's 4th,2001,"50,000+",70170,86,216,320,2.6,29.0,,8,0,8,8,4.10,0.0
5712,tt0056195,Lonely Are the Brave,1962,"1,000+",1146,291,52,107,4,85.0,,14,13,1,14,8.30,93.0
5713,tt2357211,Mirza: The Untold Story,2012,100+,150,35,13,19,3.8,74.0,,0,0,0,0,,
5714,tt0181689,Minority Report,2002,"250,000+",482174,45494,11307,16849,3.8,80.0,,260,232,28,260,8.20,89.0
5715,tt0261296,Shaitani Ilaaka,1990,0,0,0,0,0,,,,0,0,0,0,,
5716,tt13582502,Mahesh Saranya Matrum Palar,2008,0,0,0,0,0,,,,0,0,0,0,,
5717,tt0063231,"Live a Little, Love a Little",1968,"2,500+",4899,73,40,67,3.6,65.0,,0,0,0,0,,
5718,tt0102510,The Naked Gun 2½: The Smell of Fear,1991,"100,000+",123279,4582,2460,1814,3.6,65.0,,45,26,19,45,6.00,58.0
5719,tt1531911,Princess of Mars,2009,250+,364,13,112,63,1.7,10.0,,0,0,0,0,,
5720,tt1965272,Velayudham,2011,100+,163,60,34,24,3.6,63.0,,0,0,0,0,,
5721,tt0077856,Little Boy Lost,1978,Fewer than 50,39,2,1,2,,,,0,0,0,0,,
5722,tt0090830,Children of a Lesser God,1986,"5,000+",8584,1006,280,375,3.9,78.0,,35,28,7,35,7.10,80.0
5723,tt0080550,Coast to Coast,1980,Fewer than 50,35,4,7,6,2.5,36.0,,2,1,1,2,,
5724,tt0271972,Arachnid,2001,250+,304,11,84,40,1.9,12.0,,4,1,3,4,,
5725,tt0419984,Mr. Woodcock,2007,"100,000+",246621,6157,13273,7278,2.8,32.0,,111,15,96,111,4.00,14.0
5726,tt0441048,Dhoom:2,2006,"10,000+",21038,1935,583,1145,4,77.0,,14,13,1,14,7.00,93.0
5727,tt0093198,A Hobo's Christmas,1987,250+,393,7,9,7,3.4,44.0,,0,0,0,0,,
5728,tt0065828,Hello-Goodbye,1970,0,0,0,0,0,,,,1,0,1,1,,
5729,tt1326820,The Mosque in Morgantown,2009,0,0,0,0,0,,,,0,0,0,0,,
5730,tt0155265,Thillu Mullu,1981,Fewer than 50,1,1,0,0,,,,0,0,0,0,,
5731,tt0995740,No Smoking,2007,"1,000+",1848,371,154,178,3.8,71.0,,13,6,7,13,5.10,46.0
5732,tt0162650,Shaft,2000,"50,000+",64867,1961,2838,1308,3.1,41.0,,118,79,39,118,6.10,67.0
5733,tt0088758,The Aviator,1985,100+,243,21,27,20,3.2,44.0,,5,1,4,5,4.70,20.0
5734,tt0327403,Afsana Pyar Ka,1991,100+,178,1,4,0,2.6,20.0,,0,0,0,0,,
5735,tt0086058,The Osterman Weekend,1983,"2,500+",3190,143,238,119,3,38.0,,19,8,11,19,5.40,42.0
5736,tt0081459,Schizoid,1980,100+,103,8,37,14,2.6,18.0,,1,0,1,1,,
5737,tt0116654,The Island of Dr. Moreau,1996,"25,000+",43265,431,1712,921,2.3,20.0,,36,8,28,36,4.30,22.0
5738,tt0099606,The Fourth War,1990,100+,138,9,21,11,2.9,30.0,,11,7,4,11,5.80,64.0
5739,tt0271563,Indraprastham,1996,0,0,0,0,0,,,,0,0,0,0,,
5740,tt0097435,The Girl in a Swing,1988,100+,113,5,10,5,2.7,33.0,,6,2,4,6,6.40,33.0
5741,tt0076299,The Last Wave,1977,"2,500+",3444,486,132,171,3.8,79.0,,17,14,3,17,7.40,82.0
5742,tt0120318,That Old Feeling,1997,"5,000+",6626,202,138,118,3.6,59.0,,14,6,8,14,5.20,43.0
5743,tt0489327,Venus,2006,"10,000+",11468,2188,754,1458,3.7,74.0,,153,134,19,153,7.30,88.0
5744,tt0106873,Fatal Instinct,1993,"5,000+",5629,167,246,134,3,41.0,,23,4,19,23,4.30,17.0
5745,tt0079522,Manhattan,1979,"50,000+",51933,12146,1114,2780,4.3,92.0,,70,66,4,70,8.50,94.0
5746,tt0088115,Silence of the Heart,1984,500+,540,9,9,2,3.4,50.0,,0,0,0,0,,
5747,tt1323045,Frozen,2010,"250,000+",307782,96585,16650,11394,4.2,85.0,,251,225,26,251,7.70,90.0
5748,tt0896872,The Whistleblower,2010,"10,000+",12603,2517,1010,645,3.6,71.0,,120,91,29,120,6.50,76.0
5749,tt0892100,Steam,2007,100+,134,8,17,9,2.7,32.0,,8,1,7,8,4.50,13.0
5750,tt0119657,Men with Guns,1997,"1,000+",1465,151,16,47,4.2,90.0,,27,24,3,27,7.60,89.0
5751,tt0282496,Flying Virus,2001,100+,154,2,21,9,1.8,9.0,,1,0,1,1,,
5752,tt0090036,The Slugger's Wife,1985,500+,871,12,45,19,2.4,21.0,,10,0,10,10,3.50,0.0
5753,tt0102014,Hear My Song,1991,500+,631,63,20,33,4,76.0,,31,28,3,31,7.50,90.0
5754,tt0082332,Enter the Ninja,1981,"2,500+",3118,119,203,164,2.9,37.0,,7,3,4,7,5.10,43.0
5755,tt1613062,The Music Never Stopped,2011,"2,500+",2512,734,173,238,4,81.0,,49,33,16,49,6.50,67.0
5756,tt0384286,Cry Wolf,2005,"50,000+",69958,2195,2114,2373,3.2,51.0,,47,11,36,47,4.20,23.0
5757,tt0091306,Jumpin' Jack Flash,1986,"25,000+",46700,914,667,757,3.5,58.0,,23,7,16,23,4.00,30.0
5758,tt0189464,Dear Sarah,1989,0,0,0,0,0,,,,0,0,0,0,,
5759,tt0059015,Casanova '70,1965,50+,82,17,12,5,3.6,59.0,,2,1,1,2,,
5760,tt0496693,Don't Give Up on Us,2006,0,0,0,0,0,,,,0,0,0,0,,
5761,tt6827298,Love Today,1997,Fewer than 50,1,0,1,0,,,,0,0,0,0,,
5762,tt0104073,Deep Cover,1992,"5,000+",8568,674,196,248,3.9,77.0,,31,27,4,31,6.90,87.0
5763,tt0267248,Abandon,2002,"10,000+",13085,333,744,415,2.7,31.0,,111,18,93,111,4.30,16.0
5764,tt0116363,Frequent Flyer,1996,0,0,0,0,0,,,,0,0,0,0,,
5765,tt0131325,Bowfinger,1999,"50,000+",74269,3215,2050,1747,3.4,61.0,,112,91,21,112,7.00,81.0
5766,tt0073511,Paper Tiger,1975,100+,200,7,10,8,3.3,41.0,,2,1,1,2,,
5767,tt0334541,Tremors 4: The Legend Begins,2004,"10,000+",16683,504,1003,521,2.8,33.0,,0,0,0,0,,
5768,tt0104940,The Muppet Christmas Carol,1992,"100,000+",122558,6172,1022,3905,4.1,86.0,,56,43,13,56,7.00,77.0
5769,tt8669138,Kadhal Azhivathillai,2002,0,0,0,0,0,,,,0,0,0,0,,
5770,tt0077418,The Defection of Simas Kudirka,1978,0,0,0,0,0,,,,0,0,0,0,,
5771,tt0078222,Seeta Aur Geeta,1972,250+,460,33,6,11,4,85.0,,0,0,0,0,,
5772,tt0054853,The Errand Boy,1961,"1,000+",2260,115,44,43,3.8,72.0,,10,5,5,10,5.50,50.0
5773,tt0100888,Voodoo Dawn,1990,50+,59,3,2,1,2.8,60.0,,0,0,0,0,,
5774,tt0091024,Extremities,1986,"1,000+",1287,93,54,51,3.6,63.0,,10,4,6,10,5.80,40.0
5775,tt0335185,"Jasper, Texas",2003,500+,669,27,11,17,3.9,71.0,,4,4,0,4,,
5776,tt1444300,Blind Company,2009,0,0,0,0,0,,,,0,0,0,0,,
5777,tt0250720,See Spot Run,2001,"25,000+",36846,519,656,513,3.1,44.0,,77,18,59,77,3.90,23.0
5778,tt0816672,Tehilim,2007,100+,105,5,9,7,2.9,36.0,,7,2,5,7,5.00,29.0
5779,tt0056583,Tiara Tahiti,1962,Fewer than 50,7,0,4,1,,,,1,1,0,1,,
5780,tt0119560,No Looking Back,1998,"1,000+",1581,107,59,43,3.6,64.0,,22,8,14,22,5.20,36.0
5781,tt0072822,"Cornbread, Earl and Me",1975,500+,825,109,18,51,4.2,86.0,,3,2,1,3,,
5782,tt1137999,Blood River,2009,Fewer than 50,1,1,0,0,,,,0,0,0,0,,
5783,tt0233856,Hello Brother,1999,"1,000+",1895,49,64,21,2.9,43.0,,0,0,0,0,,
5784,tt1365030,Madrasapattinam,2010,100+,160,42,9,18,4,82.0,,0,0,0,0,,
5785,tt0319803,Man of the Year,2002,"1,000+",1111,9,10,2,3.3,47.0,,0,0,0,0,,
5786,tt0338077,Grind,2003,"50,000+",52914,3279,874,1841,4.1,79.0,,74,6,68,74,3.40,8.0
5787,tt0364621,Qayamat: City Under Threat,2003,100+,208,9,16,7,2.5,36.0,,1,0,1,1,,
5788,tt0400717,Open Season,2006,"250,000+",468764,13203,10173,10371,3.4,57.0,,103,50,53,103,5.40,49.0
5789,tt1234433,Ice People,2008,Fewer than 50,37,6,0,1,4.2,100.0,,10,8,2,10,6.20,80.0
5790,tt1414111,The Tiger Next Door,2009,Fewer than 50,37,7,1,3,4.1,88.0,,1,1,0,1,,
5791,tt0061434,"C'mon, Let's Live a Little",1967,0,0,0,0,0,,,,0,0,0,0,,
5792,tt0107180,I Yabba-Dabba Do!,1993,50+,79,14,8,4,3.4,64.0,,1,0,1,1,,
5793,tt1814836,Project Nim,2011,"10,000+",10331,1838,352,436,4,84.0,,146,142,4,146,8.10,97.0
5794,tt0155877,Mixing Nia,1998,50+,60,3,2,0,3,60.0,,5,1,4,5,4.90,20.0
5795,tt0116830,Last Man Standing,1996,"50,000+",50134,1838,1752,1155,3.3,51.0,,32,13,19,32,5.40,41.0
5796,tt0087351,Gone Are the Dayes,1984,0,0,0,0,0,,,,0,0,0,0,,
5797,tt0402763,Americanese,2006,50+,71,2,2,2,,,,9,6,3,9,6.20,67.0
5798,tt1263795,Madambi,2008,50+,72,2,6,1,2.8,25.0,,0,0,0,0,,
5799,tt0455669,Oru Naal Oru Kanavu,2005,0,0,0,0,0,,,,0,0,0,0,,
5800,tt0443501,Expiration Date,2006,500+,611,53,17,41,3.9,76.0,,8,5,3,8,6.10,63.0
5801,tt0463850,10.5: Apocalypse,2006,"10,000+",12913,136,138,183,3.1,50.0,,2,0,2,2,,
5802,tt0178043,Stranger Than Fiction,2000,250+,297,25,19,13,3.4,57.0,,8,3,5,8,5.60,38.0
5803,tt0087451,The Ice Pirates,1984,"5,000+",9263,476,480,435,3.2,50.0,,12,2,10,12,4.50,17.0
5804,tt0207988,The Sleepy Time Gal,2001,250+,487,11,9,13,3.3,55.0,,23,19,4,23,6.90,83.0
5805,tt0415978,Me and You and Everyone We Know,2005,"25,000+",46710,8130,1506,3284,4,84.0,,119,97,22,119,7.40,82.0
5806,tt2130142,Nazis at the Center of the Earth,2012,250+,254,34,167,95,2,17.0,,0,0,0,0,,
5807,tt1360153,Gandhada Gudi,1973,0,0,0,0,0,,,,0,0,0,0,,
5808,tt0118556,Addicted to Love,1997,"25,000+",36073,961,972,540,3.3,50.0,,33,18,15,33,5.70,55.0
5809,tt0066122,Deep End,1970,500+,831,218,75,78,3.8,74.0,,20,18,2,20,7.80,90.0
5810,tt0119791,Nightwatch,1997,"5,000+",9359,635,750,365,3.2,46.0,,30,8,22,30,4.60,27.0
5811,tt0396096,Pit Fighter,2005,250+,279,11,28,22,2.4,28.0,,3,0,3,3,,
5812,tt1961604,The Undefeated,2011,"1,000+",2344,199,328,105,2.2,38.0,,15,0,15,15,3.00,0.0
5813,tt0083525,After the Axe,1981,Fewer than 50,1,0,1,0,,,,0,0,0,0,,
5814,tt0073195,Jaws,1975,"250,000+",946651,57312,6037,35382,4.4,90.0,,101,98,3,101,9.30,97.0
5815,tt0418819,Land of the Dead,2005,"100,000+",137818,8201,7582,6177,3.3,52.0,,180,134,46,180,6.70,74.0
5816,tt1372266,Kisaan,2009,50+,65,7,5,3,3.4,58.0,,1,0,1,1,,
5817,tt0057178,In the Cool of the Day,1963,Fewer than 50,6,2,3,2,3,40.0,,1,0,1,1,,
5818,tt0266727,Little Soldiers,1996,0,0,0,0,0,,,,0,0,0,0,,
5819,tt0419424,Al otro lado,2004,500+,792,61,16,25,4,79.0,,9,7,2,9,6.10,78.0
5820,tt0286499,Bend It Like Beckham,2002,"250,000+",469874,17169,6357,12595,3.7,73.0,,158,135,23,158,7.20,85.0
5821,tt0120906,Zero Effect,1998,"5,000+",7845,862,266,396,3.8,76.0,,56,37,19,56,6.80,66.0
5822,tt0113264,Harrison Bergeron,1995,"1,000+",1002,124,28,66,4,82.0,,2,1,1,2,,
5823,tt0882765,Eavesdrop,2008,Fewer than 50,14,3,2,1,4.1,60.0,,0,0,0,0,,
5824,tt0415167,Mortuary,2005,"2,500+",4932,99,463,308,2.2,18.0,,3,0,3,3,,
5825,tt0054934,Gold of the Seven Saints,1961,Fewer than 50,3,1,2,2,,,,1,1,0,1,,
5826,tt0097136,Cutting Class,1989,"2,500+",3817,80,290,168,2.5,22.0,,7,1,6,7,4.20,14.0
5827,tt0091149,The Great Mouse Detective,1986,"50,000+",58923,3793,1030,1874,3.9,79.0,,25,19,6,25,7.10,76.0
5828,tt0054475,The Wild Ride,1960,50+,56,1,4,1,2.1,20.0,,0,0,0,0,,
5829,tt0403702,Youth in Revolt,2009,"100,000+",114629,8375,7612,4006,3.3,52.0,,171,114,57,171,6.30,67.0
5830,tt0056872,Black Zoo,1963,50+,64,1,3,3,,,,2,2,0,2,,
5831,tt0355169,Aaram Thamburan,1997,0,0,0,0,0,,,,0,0,0,0,,
5832,tt1286141,Deb and Sisi,2008,Fewer than 50,1,0,1,0,,,,0,0,0,0,,
5833,tt0473697,Satanás,2007,500+,874,220,37,83,4.1,85.0,,0,0,0,0,,
5834,tt0115033,The Young Poisoner's Handbook,1995,"1,000+",2333,196,38,80,3.9,84.0,,15,13,2,15,7.20,87.0
5835,tt0158827,Nikaah,1982,100+,157,7,6,3,3.4,54.0,,0,0,0,0,,
5836,tt0092800,Cronaca di una morte annunciata,1987,50+,82,8,9,3,3.2,47.0,,1,1,0,1,,
5837,tt0079117,Escape to Athena,1979,"1,000+",1490,54,116,45,2.9,32.0,,3,3,0,3,,
5838,tt0382866,Nala Damayanthi,2003,0,0,0,0,0,,,,0,0,0,0,,
5839,tt0148841,Shikar,1968,0,0,0,0,0,,,,0,0,0,0,,
5840,tt0907657,Once,2007,0,0,0,0,0,,,,0,0,0,0,,
5841,tt0118826,The Castle,1997,"10,000+",14647,2294,205,1119,4.4,92.0,,39,34,5,39,7.10,87.0
5842,tt1132623,You Don't Know Jack,2010,"2,500+",3878,1809,364,597,3.9,83.0,,24,20,4,24,7.80,83.0
5843,tt0107943,The Remains of the Day,1993,"10,000+",24488,4102,482,1128,4.2,89.0,,47,45,2,47,8.50,96.0
5844,tt0119521,A Letter from Death Row,1998,"1,000+",1331,28,18,21,3.7,61.0,,0,0,0,0,,
5845,tt0112313,Akele Hum Akele Tum,1995,250+,462,40,34,7,3.3,54.0,,0,0,0,0,,
5846,tt0254683,Phool Aur Kaante,1991,250+,324,11,4,3,3.9,73.0,,0,0,0,0,,
5847,tt0095088,Elvira: Mistress of the Dark,1988,"10,000+",10464,907,474,554,3.7,66.0,,25,14,11,25,5.30,56.0
5848,tt1135977,Let's All Hate Toronto,2007,250+,346,18,26,28,3.1,41.0,,1,1,0,1,,
5849,tt0449590,FAQ: Frequently Asked Questions,2004,50+,96,3,7,3,2.8,30.0,,0,0,0,0,,
5850,tt0068505,Dracula A.D. 1972,1972,"2,500+",4693,158,242,188,3.1,40.0,,11,3,8,11,4.50,27.0
5851,tt0199777,Molokh,1999,500+,742,87,50,31,3.6,63.0,,4,2,2,4,,
5852,tt0110955,The Ref,1994,"25,000+",27043,1887,691,928,3.8,73.0,,55,40,15,55,6.50,73.0
5853,tt0276816,Below,2002,"5,000+",7952,569,711,409,3.1,44.0,,70,46,24,70,6.20,66.0
5854,tt0181156,The Whole Shootin' Match,1978,100+,193,14,2,8,4,88.0,,6,6,0,6,7.20,100.0
5855,tt0082073,"Bianco, rosso e Verdone",1981,Fewer than 50,2,2,0,0,,,,0,0,0,0,,
5856,tt1801521,Khap,2011,Fewer than 50,4,1,0,0,,,,1,0,1,1,,
5857,tt0104288,"For Richer, for Poorer",1992,50+,95,2,8,3,3.1,20.0,,0,0,0,0,,
5858,tt0113008,The Face on the Milk Carton,1995,500+,576,55,37,21,3.7,60.0,,0,0,0,0,,
5859,tt0057974,Crooks in Cloisters,1964,100+,165,4,6,4,2.7,40.0,,1,1,0,1,,
5860,tt0107247,Jack the Bear,1993,"2,500+",4770,227,161,126,3.5,59.0,,18,5,13,18,4.70,28.0
5861,tt0258886,Pookkalam Varavayi,1991,0,0,0,0,0,,,,0,0,0,0,,
5862,tt0811138,The Love Guru,2008,"100,000+",240636,5513,11068,8543,2.7,33.0,,178,24,154,178,3.50,13.0
5863,tt0097911,Moontrap,1988,500+,890,41,112,61,2.6,27.0,,2,2,0,2,,
5864,tt0087160,The Dollmaker,1984,500+,994,59,4,30,4.4,94.0,,2,2,0,2,,
5865,tt0383222,BloodRayne,2005,"100,000+",136008,1028,5128,3438,1.8,17.0,,52,2,50,52,2.90,4.0
5866,tt0104969,The Naked Truth,1992,500+,730,5,2,0,3.8,71.0,,0,0,0,0,,
5867,tt0119054,Eight Days a Week,1997,"2,500+",3335,211,101,129,3.6,68.0,,10,2,8,10,4.30,20.0
5868,tt0246412,Adiyozhukkukal,1984,0,0,0,0,0,,,,0,0,0,0,,
5869,tt1496380,Chennai 600028,2007,Fewer than 50,1,1,0,0,,,,0,0,0,0,,
5870,tt0060666,Manos: The Hands of Fate,1966,"5,000+",8262,347,1403,1231,1.6,20.0,,15,0,15,15,2.60,0.0
5871,tt0481390,Kokoda,2006,"2,500+",3049,146,125,129,3.3,54.0,,7,5,2,7,6.80,71.0
5872,tt0101477,Blood Ties,1991,"1,000+",1801,17,12,10,3.6,59.0,,0,0,0,0,,
5873,tt0362269,Kinsey,2004,"25,000+",34271,3775,1250,1521,3.7,75.0,,197,177,20,197,7.70,90.0
5874,tt0072812,Conduct Unbecoming,1975,250+,458,9,14,10,2.9,39.0,,7,4,3,7,6.50,57.0
5875,tt0294806,The Keeper: The Legend of Omar Khayyam,2005,100+,160,11,14,11,3,44.0,,22,9,13,22,5.30,41.0
5876,tt0962736,The Young Victoria,2009,"100,000+",164793,6554,2273,2671,3.8,74.0,,157,119,38,157,6.50,76.0
5877,tt1226276,Bob and the Monster,2011,100+,184,20,4,4,4,83.0,,1,1,0,1,,
5878,tt0086005,Never Cry Wolf,1983,"5,000+",5169,499,97,204,4.1,84.0,,19,19,0,19,7.70,100.0
5879,tt0412536,Brideshead Revisited,2008,"10,000+",21866,1414,1302,1238,3.3,52.0,,139,86,53,139,6.20,62.0
5880,tt0089218,The Goonies,1985,"250,000+",580236,62017,6482,28846,4.4,91.0,,64,49,15,64,6.50,77.0
5881,tt0100475,Repossessed,1990,"5,000+",7684,558,321,198,3.7,64.0,,7,0,7,7,3.40,0.0
5882,tt0276951,Faat Kiné,2001,100+,219,17,4,7,4,81.0,,9,7,2,9,7.40,78.0
5883,tt1672723,Batman: Year One,2011,"2,500+",4269,2484,664,567,3.8,79.0,,9,8,1,9,6.90,89.0
5884,tt0094834,Cannibal Women in the Avocado Jungle of Death,1989,"2,500+",4544,100,99,107,3.2,50.0,,2,1,1,2,,
5885,tt0092267,You Must Be Joking!,1986,0,0,0,0,0,,,,0,0,0,0,,
5886,tt1285124,Lost Song,2008,50+,81,5,8,6,2.8,38.0,,6,4,2,6,5.50,67.0
5887,tt1572311,Tees Maar Khan,2010,"1,000+",2011,79,356,162,1.8,18.0,,11,1,10,11,3.80,9.0
5888,tt1590950,Age of Heroes,2011,"1,000+",1159,90,299,130,2.6,23.0,,5,2,3,5,4.80,40.0
5889,tt12978034,Sandai,2008,0,0,0,0,0,,,,0,0,0,0,,
5890,tt1440363,Tumaku Paruni Ta Bhuli,2007,0,0,0,0,0,,,,0,0,0,0,,
5891,tt1330181,Antaratama,2008,0,0,0,0,0,,,,0,0,0,0,,
5892,tt0239641,Mimic 2,2001,"5,000+",8974,50,349,110,2.2,13.0,,13,1,12,13,4.00,8.0
5893,tt0155197,Speedway Junky,1999,"1,000+",1689,69,54,36,3.4,56.0,,7,2,5,7,4.40,29.0
5894,tt3308446,Ooruku Nooruper,2001,0,0,0,0,0,,,,0,0,0,0,,
5895,tt1599348,Safe House,2012,"100,000+",118831,25393,14695,5563,3.6,63.0,,195,103,92,195,5.70,53.0
5896,tt0098356,Some Girls,1988,500+,910,74,101,60,3.1,42.0,,7,3,4,7,5.40,43.0
5897,tt0120753,The Million Dollar Hotel,2000,"10,000+",11406,1404,680,422,3.6,67.0,,45,11,34,45,4.20,24.0
5898,tt0300996,The Biggest Fan,2005,"5,000+",5680,170,16,188,4.5,92.0,,1,0,1,1,,
5899,tt0060564,Johnny Reno,1966,"1,000+",1241,5,16,5,2.8,24.0,,2,1,1,2,,
5900,tt1094294,Blood on the Highway,2008,100+,107,11,14,10,3.2,44.0,,1,0,1,1,,
5901,tt0138541,Judas Kiss,1998,"1,000+",1317,56,62,42,3.2,47.0,,7,3,4,7,5.90,43.0
5902,tt0796335,Molière,2007,"10,000+",10942,1586,428,826,3.8,79.0,,89,61,28,89,6.50,69.0
5903,tt0062365,Thunder Alley,1967,100+,123,2,6,2,2.8,25.0,,0,0,0,0,,
5904,tt1703958,Ek Main Aur Ekk Tu,2012,"1,000+",1302,127,203,68,3,38.0,,9,6,3,9,5.30,67.0
5905,tt0119891,Phantoms,1998,"10,000+",12626,432,1143,659,2.6,27.0,,31,3,28,31,4.10,10.0
5906,tt0388286,Mullavalliyum Thenmavum,2003,0,0,0,0,0,,,,0,0,0,0,,
5907,tt0267657,The Land Before Time VII: The Stone of Cold Fire,2000,"10,000+",12457,125,146,118,3.3,46.0,,2,0,2,2,,
5908,tt0177789,Galaxy Quest,1999,"100,000+",224612,12558,3365,7311,3.9,79.0,,130,117,13,130,7.30,90.0
5909,tt1027698,Invasion of the Pod People,2007,100+,220,5,38,25,1.6,12.0,,0,0,0,0,,
5910,tt0143088,Adieu Philippine,1962,100+,203,14,9,6,3.5,61.0,,1,1,0,1,,
5911,tt0084866,Vidhaata,1982,250+,289,9,3,2,3.8,75.0,,0,0,0,0,,
5912,tt0489134,Last Order: Final Fantasy VII,2005,"10,000+",11274,1030,192,505,4.1,84.0,,0,0,0,0,,
5913,tt1201167,Funny People,2009,"250,000+",845172,17230,18797,13704,3.1,48.0,,236,162,74,236,6.40,69.0
5914,tt0098439,Tango & Cash,1989,"50,000+",60196,2540,2327,1526,3.3,52.0,,49,15,34,49,4.40,31.0
5915,tt0436319,Fjorton suger,2004,0,0,0,0,0,,,,0,0,0,0,,
5916,tt0281358,A Walk to Remember,2002,"250,000+",31402117,101977,29245,1042359,3.3,78.0,,105,30,75,105,4.20,29.0
5917,tt0352526,London Voodoo,2004,50+,98,4,9,6,3.2,31.0,,1,0,1,1,,
5918,tt0093828,Real Men,1987,"2,500+",3523,143,96,98,3.5,60.0,,4,2,2,4,,
5919,tt1287468,Cats & Dogs: The Revenge of Kitty Galore,2010,"50,000+",70190,1436,2330,1037,2.9,38.0,,99,13,86,99,3.80,13.0
5920,tt0116735,Justice for Annie: A Moment of Truth Movie,1996,Fewer than 50,29,3,3,1,3.7,50.0,,0,0,0,0,,
5921,tt0066214,Performance,1970,"5,000+",5208,777,216,363,3.9,78.0,,34,28,6,34,8.00,82.0
5922,tt2084977,The Scapegoat,2012,Fewer than 50,13,1,7,1,2.9,12.0,,0,0,0,0,,
5923,tt1337032,Trailer Park Boys: Countdown to Liquor Day,2009,500+,807,296,126,67,3.8,70.0,,5,3,2,5,6.60,60.0
5924,tt1045655,The Haunting of Molly Hartley,2008,"50,000+",62319,519,2343,1390,2.2,18.0,,41,1,40,41,3.10,2.0
5925,tt0069371,They Only Kill Their Masters,1972,100+,178,6,15,5,2.9,29.0,,3,2,1,3,,
5926,tt0082797,Naseeb,1981,0,0,0,0,0,,,,0,0,0,0,,
5927,tt0462421,Mentor,2006,100+,160,2,9,4,2.9,18.0,,0,0,0,0,,
5928,tt0087260,Finders Keepers,1984,100+,134,4,12,3,2.4,25.0,,0,0,0,0,,
5929,tt0457993,Lilo & Stitch 2: Stitch Has a Glitch,2005,"50,000+",63499,1054,825,773,3.5,56.0,,10,4,6,10,5.50,40.0
5930,tt2016168,Come Morning,2012,Fewer than 50,33,14,8,5,3.9,64.0,,4,4,0,4,,
5931,tt0103069,Texasville,1990,"1,000+",1279,62,73,45,3.1,46.0,,27,16,11,27,5.50,59.0
5932,tt0120216,"Stolen Women, Captured Hearts",1997,100+,212,45,8,15,4.2,85.0,,0,0,0,0,,
5933,tt1349451,Butter,2011,"10,000+",10034,1884,2382,485,3.1,44.0,,67,23,44,67,4.60,34.0
5934,tt0384560,Star Warp'd,2002,100+,189,6,16,5,2.2,27.0,,0,0,0,0,,
5935,tt0112966,The Englishman Who Went Up a Hill But Came Down a Mountain,1995,"10,000+",11997,742,614,352,3.4,55.0,,33,22,11,33,6.00,67.0
5936,tt0257882,Love Song,2000,100+,150,24,8,9,4.1,75.0,,0,0,0,0,,
5937,tt0926187,Arjun Devaa,2001,0,0,0,0,0,,,,0,0,0,0,,
5938,tt0216216,The 6th Day,2000,"100,000+",125973,2022,4206,2025,2.9,32.0,,117,47,70,117,5.20,40.0
5939,tt0216817,Hum Saath-Saath Hain,1999,"1,000+",2345,206,54,57,4,79.0,,0,0,0,0,,
5940,tt0089966,Scandal Sheet,1985,Fewer than 50,37,0,5,3,1.5,0.0,,0,0,0,0,,
5941,tt0113199,Gordy,1994,"5,000+",6908,94,287,154,2.4,25.0,,19,4,15,19,4.30,21.0
5942,tt0287634,Plaster Caster,2001,50+,55,3,4,1,3.4,43.0,,1,0,1,1,,
5943,tt1105512,The Missing Person,2009,"5,000+",6771,87,111,71,3.1,44.0,,27,18,9,27,5.70,67.0
5944,tt0939681,What Would Jesus Buy?,2007,"2,500+",2882,309,209,291,3.4,60.0,,57,32,25,57,6.00,56.0
5945,tt0096180,Stormy Monday,1988,"1,000+",1425,78,83,38,3.3,48.0,,18,14,4,18,6.90,78.0
5946,tt0200427,Diamond Men,2000,"1,000+",1301,56,40,32,3.4,58.0,,62,50,12,62,7.00,81.0
5947,tt0102609,Other People's Money,1991,"5,000+",5993,220,257,109,3.2,46.0,,16,5,11,16,5.00,31.0
5948,tt0100224,Narrow Margin,1990,"2,500+",2838,156,152,63,3.3,51.0,,16,10,6,16,6.00,63.0
5949,tt0073774,The Swiss Conspiracy,1976,500+,928,5,14,11,2.9,26.0,,0,0,0,0,,
5950,tt8942480,Sabrina Down Under,1999,"2,500+",3304,93,108,60,3.2,46.0,,0,0,0,0,,
5951,tt4089724,Gulama,2009,0,0,0,0,0,,,,0,0,0,0,,
5952,tt0273923,Orange County,2002,"100,000+",174420,5039,3203,3764,3.5,61.0,,122,57,65,122,5.20,47.0
5953,tt0390022,Friday Night Lights,2004,"100,000+",185947,19601,3355,6948,4.1,85.0,,174,142,32,174,7.10,82.0
5954,tt0457270,Cyber Seduction: His Secret Life,2005,500+,764,73,92,79,2.9,44.0,,0,0,0,0,,
5955,tt0186726,Zenon: Girl of the 21st Century,1999,"5,000+",7290,478,299,218,3.6,62.0,,2,2,0,2,,
5956,tt0116629,Independence Day,1996,"250,000+",978092,48317,16406,29245,3.8,75.0,,81,55,26,81,6.60,68.0
5957,tt0455829,Vettaiyaadu Vilaiyaadu,2006,Fewer than 50,3,3,0,0,,,,0,0,0,0,,
5958,tt0114323,Safe,1995,"5,000+",6524,916,302,366,3.8,75.0,,62,54,8,62,7.50,87.0
5959,tt0114781,Under Siege 2: Dark Territory,1995,"25,000+",47582,921,1484,985,3,38.0,,32,11,21,32,4.70,34.0
5960,tt0091276,Invaders from Mars,1986,"2,500+",3532,138,278,157,2.8,33.0,,16,6,10,16,4.60,38.0
5961,tt2980794,Highway,2014,Fewer than 50,1,1,0,0,,,,0,0,0,0,,
5962,tt0070935,Yaadon Ki Baaraat,1973,500+,629,45,8,9,4.1,85.0,,0,0,0,0,,
5963,tt0083133,Student Bodies,1981,"2,500+",3027,234,212,222,3.3,52.0,,9,3,6,9,3.80,33.0
5964,tt1604887,Bava Nachadu,2001,0,0,0,0,0,,,,0,0,0,0,,
5965,tt0193166,The Flintstones Meet Rockula and Frankenstone,1979,100+,128,14,12,3,3.5,54.0,,0,0,0,0,,
5966,tt0482552,My Family and Other Animals,2005,250+,330,48,10,21,4,83.0,,1,1,0,1,,
5967,tt0104697,Leaving Normal,1992,500+,854,63,29,34,3.8,68.0,,10,4,6,10,4.40,40.0
5968,tt1885266,Grand Prix,2010,0,0,0,0,0,,,,0,0,0,0,,
5969,tt0090670,At Close Range,1986,"5,000+",9019,919,249,356,3.9,79.0,,22,19,3,22,7.00,86.0
5970,tt0395972,North Country,2005,"50,000+",93184,3724,1194,2217,3.8,76.0,,175,122,53,175,6.70,70.0
5971,tt1462758,Buried,2010,"50,000+",64376,13485,7403,6302,3.4,65.0,,161,140,21,161,7.40,87.0
5972,tt0116072,Demolition High,1996,50+,74,11,20,11,3,35.0,,1,0,1,1,,
5973,tt0304283,Kermit's Swamp Years,2002,Fewer than 50,6,3,3,3,3.1,50.0,,0,0,0,0,,
5974,tt0097609,Jaadugar,1989,Fewer than 50,33,1,5,1,1.8,17.0,,0,0,0,0,,
5975,tt0065522,Captain Nemo and the Underwater City,1969,50+,69,7,16,9,3,30.0,,0,0,0,0,,
5976,tt0288477,Ghost Ship,2002,"250,000+",377168,3460,5791,7838,2.9,37.0,,128,19,109,128,3.80,15.0
5977,tt1107850,Unrelated,2007,500+,582,124,80,40,3.4,61.0,,19,17,2,19,6.90,89.0
5978,tt1392170,The Hunger Games,2012,"250,000+",904083,196573,46757,27400,4,81.0,,318,268,50,318,7.30,84.0
5979,tt0378826,Swapnakoodu,2003,0,0,0,0,0,,,,0,0,0,0,,
5980,tt0086250,Scarface,1983,"250,000+",489822,91809,6395,30641,4.5,93.0,,77,61,16,77,7.50,79.0
5981,tt0287138,Who's Your Daddy?,2002,"2,500+",4880,105,163,99,2.9,39.0,,1,1,0,1,,
5982,tt0070605,Rhinoceros,1974,500+,842,45,43,41,3.3,51.0,,0,0,0,0,,
5983,tt0135165,Bug Buster,1998,250+,384,4,28,11,2,12.0,,4,0,4,4,,
5984,tt0372784,Batman Begins,2005,"250,000+",1117707,169443,11349,66703,4.3,94.0,,291,247,44,291,7.70,85.0
5985,tt0164221,Virtual Sexuality,1999,"1,000+",1458,57,67,59,3.1,46.0,,4,1,3,4,,
5986,tt0088708,American Ninja,1985,"10,000+",11508,451,516,422,3.2,47.0,,9,0,9,9,4.20,0.0
5987,tt0254284,Dog Eat Dog,2001,Fewer than 50,35,3,3,4,3.5,50.0,,1,0,1,1,,
5988,tt0090274,Volunteers,1985,"5,000+",8465,209,429,157,2.9,33.0,,12,7,5,12,4.90,58.0
5989,tt2009443,Chaalbaaz,2003,0,0,0,0,0,,,,0,0,0,0,,
5990,tt0248216,Na Tum Jaano Na Hum,2002,0,0,0,0,0,,,,0,0,0,0,,
5991,tt0074937,Murder by Death,1976,"10,000+",13175,2132,458,983,4,82.0,,21,14,7,21,6.00,67.0
5992,tt0085407,The Dead Zone,1983,"25,000+",36596,3752,1144,1346,3.7,77.0,,54,48,6,54,7.70,89.0
5993,tt0780608,Smiley Face,2007,"10,000+",10291,1429,1811,1389,3,44.0,,38,25,13,38,5.80,66.0
5994,tt0389337,Runway,2004,0,0,0,0,0,,,,0,0,0,0,,
5995,tt0474361,Sisters in Law,2005,500+,543,25,4,13,3.9,86.0,,26,24,2,26,7.10,92.0
5996,tt0362165,Son of the Mask,2005,"25,000+",38757,452,2414,1329,1.7,16.0,,105,6,99,105,3.00,6.0
5997,tt0056349,The Pigeon That Took Rome,1962,Fewer than 50,49,4,4,3,3.1,50.0,,0,0,0,0,,
5998,tt0096869,Babar: The Movie,1989,"5,000+",6097,66,24,54,3.9,73.0,,3,2,1,3,,
5999,tt0103924,Captain Ron,1992,"25,000+",48034,1198,1106,848,3.3,52.0,,23,6,17,23,4.30,26.0
6000,tt0092812,Cyclone,1987,"1,000+",1440,7,36,16,2.6,16.0,,0,0,0,0,,
6001,tt0119239,Gupt: The Hidden Truth,1997,500+,813,83,41,24,3.7,67.0,,1,1,0,1,,
6002,tt0923985,We Are the Strange,2007,500+,770,135,56,102,3.8,71.0,,2,2,0,2,,
6003,tt0416891,The Kid & I,2005,"10,000+",11790,31,61,39,2.8,34.0,,26,9,17,26,4.70,35.0
6004,tt0473604,Anukokunda Oka Roju,2005,Fewer than 50,8,2,0,0,,,,1,1,0,1,,
6005,tt0833476,Jhoom Barabar Jhoom,2007,"5,000+",6256,326,522,513,2.7,38.0,,13,6,7,13,5.60,46.0
6006,tt0426462,Fifty Pills,2006,"2,500+",4081,164,330,216,2.8,33.0,,1,0,1,1,,
6007,tt0107611,Mr. Jones,1993,"5,000+",5191,209,205,87,3.3,50.0,,14,6,8,14,5.20,43.0
6008,tt0419261,The Warrior Class,2007,50+,74,1,11,7,2.1,8.0,,0,0,0,0,,
6009,tt4064028,Hoodwinked,2006,Fewer than 50,1,1,0,0,,,,0,0,0,0,,
6010,tt0056267,My Geisha,1962,250+,453,34,21,21,3.6,62.0,,0,0,0,0,,
6011,tt0419142,Slavoj Zizek: The Reality of the Virtual,2004,Fewer than 50,21,4,1,1,4,80.0,,1,1,0,1,,
6012,tt0066209,The People Next Door,1970,100+,175,6,8,4,3,43.0,,2,1,1,2,,
6013,tt1160026,Team Picture,2007,100+,205,10,8,6,2.9,56.0,,1,1,0,1,,
6014,tt0429173,The Tenants,2005,"50,000+",87452,41,95,99,2.7,30.0,,19,6,13,19,4.80,32.0
6015,tt0115891,Christmas Every Day,1996,100+,114,15,25,6,3.1,38.0,,0,0,0,0,,
6016,tt0085255,Blue Thunder,1983,"5,000+",9252,517,467,291,3.3,53.0,,23,18,5,23,6.60,78.0
6017,tt1027743,Sea Monsters: A Prehistoric Adventure,2007,500+,999,126,52,72,3.8,71.0,,13,13,0,13,7.70,100.0
6018,tt0118570,Air Bud,1997,"250,000+",347329,1113,1819,4641,2.9,38.0,,22,10,12,22,4.80,45.0
6019,tt0758037,Heebie Jeebies,2005,50+,98,2,22,11,1.4,8.0,,0,0,0,0,,
6020,tt0279843,Gulabi,1996,0,0,0,0,0,,,,0,0,0,0,,
6021,tt1294213,Solitary Man,2009,"10,000+",14735,1392,1422,829,3.2,50.0,,100,78,22,100,6.80,78.0
6022,tt1376709,I Love You Too,2010,"1,000+",1693,100,119,101,3.2,46.0,,13,7,6,13,5.40,54.0
6023,tt0070292,The Laughing Policeman,1973,500+,868,54,58,36,3.2,48.0,,16,9,7,16,5.50,56.0
6024,tt0374840,Ma'am May We Go Out?,1985,0,0,0,0,0,,,,0,0,0,0,,
6025,tt0098136,Prom Night III: The Last Kiss,1990,"1,000+",1336,25,135,55,2.3,16.0,,3,0,3,3,,
6026,tt0105236,Reservoir Dogs,1992,"250,000+",447504,109858,7204,25888,4.4,94.0,,81,73,8,81,8.90,90.0
6027,tt1034325,Phoebe in Wonderland,2008,"25,000+",32822,972,424,458,3.7,70.0,,54,33,21,54,6.00,61.0
6028,tt0119141,Fools Rush In,1997,"50,000+",63125,2904,1616,1713,3.7,64.0,,32,11,21,32,5.20,34.0
6029,tt1657283,Honey 2,2011,"2,500+",4614,578,516,127,3.4,53.0,,21,2,19,21,3.70,10.0
6030,tt0435390,Shukriya: Till Death Do Us Apart,2004,50+,66,3,2,2,3.4,60.0,,0,0,0,0,,
6031,tt0054412,Tunes of Glory,1960,"1,000+",1097,141,39,50,4,78.0,,11,8,3,11,6.30,73.0
6032,tt0230347,Jaanwar,1999,0,0,0,0,0,,,,0,0,0,0,,
6033,tt0316882,Warriors of Virtue: The Return to Tao,2002,100+,211,6,12,2,2.7,33.0,,1,0,1,1,,
6034,tt0829482,Superbad,2007,"250,000+",635505,200985,29988,83762,4.2,87.0,,208,182,26,208,7.40,88.0
6035,tt0087247,Fear City,1984,"1,000+",1631,51,102,49,2.9,33.0,,11,7,4,11,5.60,64.0
6036,tt0217505,Gangs of New York,2002,"250,000+",294825,28820,6722,11175,3.9,81.0,,215,156,59,215,7.00,73.0
6037,tt0126252,The Cool Mikado,1963,100+,102,2,0,2,,,,0,0,0,0,,
6038,tt0250483,Kya Kehna,2000,500+,553,41,27,19,3.3,60.0,,0,0,0,0,,
6039,tt0430431,One Night with the King,2006,"25,000+",31234,2564,720,1935,4,78.0,,25,5,20,25,4.40,20.0
6040,tt0174856,The Hurricane,1999,"50,000+",55707,5914,874,1694,4.1,87.0,,113,93,20,113,6.90,82.0
6041,tt0083611,La balance,1982,250+,294,35,17,9,3.7,67.0,,4,3,1,4,,
6042,tt1934231,Delhi Belly,2011,"2,500+",4425,1449,314,455,4,82.0,,19,17,2,19,6.50,89.0
6043,tt0058154,Goodbye Charlie,1964,250+,378,27,11,12,3.9,71.0,,8,4,4,8,5.30,50.0
6044,tt0087284,Fort Saganne,1984,100+,184,12,5,3,3.7,71.0,,0,0,0,0,,
6045,tt0375735,Enduring Love,2004,"5,000+",8590,937,631,697,3.4,60.0,,99,58,41,99,6.20,59.0
6046,tt0135666,Takkar,1995,Fewer than 50,49,1,0,0,,,,0,0,0,0,,
6047,tt0896817,Inspector Garud,2007,100+,206,1,1,0,,,,0,0,0,0,,
6048,tt0078879,Bloodline,1979,250+,462,16,43,20,2.3,27.0,,2,1,1,2,,
6049,tt0119743,My Son the Fanatic,1997,"1,000+",1071,81,26,33,3.7,75.0,,28,22,6,28,6.90,79.0
6050,tt0206067,Kachche Dhaage,1999,0,0,0,0,0,,,,0,0,0,0,,
6051,tt2174089,Lives Worth Living,2011,Fewer than 50,4,1,1,0,,,,0,0,0,0,,
6052,tt0064010,Amblin',1968,250+,312,42,29,20,3.3,60.0,,0,0,0,0,,
6053,tt0221027,Blow,2001,"250,000+",385105,72004,11208,14941,4.2,87.0,,141,78,63,141,5.80,55.0
6054,tt0080646,Don't Go in the House,1979,500+,736,71,140,91,2.8,34.0,,7,3,4,7,4.10,43.0
6055,tt0119572,Love Jones,1997,"25,000+",25732,2852,95,1210,4.7,97.0,,29,22,7,29,6.70,76.0
6056,tt0118882,Conceiving Ada,1997,100+,142,11,8,8,3.1,58.0,,11,9,2,11,6.60,82.0
6057,tt1277737,The Stoning of Soraya M.,2008,"5,000+",6681,1491,218,638,4.2,87.0,,86,50,36,86,6.00,58.0
6058,tt0104040,The Cutting Edge,1992,"25,000+",43320,2565,786,1397,3.9,77.0,,35,20,15,35,5.80,57.0
6059,tt0331639,Shakthi: The Power,2002,"2,500+",3405,75,78,58,3.2,49.0,,1,1,0,1,,
6060,tt0384699,Missing in America,2005,"1,000+",1992,104,43,74,3.8,71.0,,0,0,0,0,,
6061,tt1139668,The Unborn,2009,"250,000+",831884,3755,8879,7261,2.6,30.0,,118,12,106,118,3.30,10.0
6062,tt2218988,Ustad Hotel,2012,Fewer than 50,38,29,3,5,4.3,91.0,,1,1,0,1,,
6063,tt0120655,Dogma,1999,"250,000+",363218,39784,6912,18496,4.1,85.0,,130,88,42,130,6.30,68.0
6064,tt0443489,Dreamgirls,2006,"250,000+",388353,24002,9730,16751,3.8,71.0,,207,163,44,207,7.30,79.0
6065,tt0262714,Pyaasa Sawan,1981,50+,71,2,0,0,,,,1,1,0,1,,
6066,tt1374992,Upside Down,2012,0,0,0,0,0,,,,1,0,1,1,,
6067,tt4736026,Paglu 2,2012,0,0,0,0,0,,,,0,0,0,0,,
6068,tt1316622,Wrecked,2010,"2,500+",4787,400,1284,394,2.6,24.0,,27,13,14,27,5.30,48.0
6069,tt0087682,Maria's Lovers,1984,500+,537,49,33,25,3.6,60.0,,7,3,4,7,5.90,43.0
6070,tt0292644,The Rules of Attraction,2002,"50,000+",50676,5139,2149,2903,3.7,71.0,,142,63,79,142,5.40,44.0
6071,tt0072189,Son of Dracula,1973,0,0,0,0,0,,,,0,0,0,0,,
6072,tt0450506,Suburban Mayhem,2006,"10,000+",15272,180,131,162,3.4,58.0,,5,1,4,5,4.10,20.0
6073,tt1055368,The Unidentified,2008,0,0,0,0,0,,,,0,0,0,0,,
6074,tt1142804,Within the Whirlwind,2009,50+,50,9,10,4,3.4,47.0,,2,2,0,2,,
6075,tt0328880,Brother Bear,2003,"100,000+",189152,4701,2490,3520,3.7,65.0,,131,49,82,131,5.50,37.0
6076,tt0056579,The Three Stooges Meet Hercules,1962,"1,000+",1198,67,26,36,3.8,72.0,,3,0,3,3,,
6077,tt1055292,Life as We Know It,2010,"50,000+",82549,11102,7203,3359,3.5,61.0,,154,46,108,154,4.60,30.0
6078,tt2325589,Chithiram Pesuthadi,2006,0,0,0,0,0,,,,0,0,0,0,,
6079,tt0389790,Bee Movie,2007,"250,000+",388921,26213,23514,16771,3.3,53.0,,173,86,87,173,5.60,50.0
6080,tt0426470,Go West,2005,250+,480,22,8,9,3.9,72.0,,1,0,1,1,,
6081,tt0093428,The Living Daylights,1987,"50,000+",54117,3952,2028,2067,3.6,66.0,,59,43,16,59,6.40,73.0
6082,tt0370356,Blessings,2003,0,0,0,0,0,,,,0,0,0,0,,
6083,tt1855400,Thiruttu Payale,2006,0,0,0,0,0,,,,0,0,0,0,,
6084,tt0270933,Escaflowne,2000,"10,000+",11554,578,267,470,3.7,68.0,,14,6,8,14,5.30,43.0
6085,tt0080514,Chakra,1981,Fewer than 50,41,2,0,0,,,,0,0,0,0,,
6086,tt0062490,Who's Minding the Mint?,1967,100+,142,20,7,11,3.9,74.0,,0,0,0,0,,
6087,tt0306846,"No Pain, No Gain",2004,Fewer than 50,19,3,1,0,,,,0,0,0,0,,
6088,tt0304857,Two Men Went to War,2002,500+,962,35,15,31,3.8,70.0,,29,17,12,29,5.60,59.0
6089,tt0109534,Dangerous Touch,1994,50+,88,0,9,3,2.1,0.0,,1,0,1,1,,
6090,tt1359552,Antaheen,2009,50+,70,30,3,11,4.1,91.0,,0,0,0,0,,
6091,tt0064949,Scream and Scream Again,1970,"1,000+",1203,45,113,69,2.7,28.0,,16,10,6,16,5.60,63.0
6092,tt1972663,Into the Abyss,2011,"5,000+",8645,2003,631,427,3.8,76.0,,118,109,9,118,7.80,92.0
6093,tt1368116,Merantau,2009,"2,500+",2809,317,193,169,3.5,62.0,,2,1,1,2,,
6094,tt0092929,Drowning by Numbers,1988,"2,500+",4126,634,83,153,4.2,88.0,,16,14,2,16,7.10,88.0
6095,tt0115985,Crossworlds,1996,"1,000+",1769,55,82,47,3,40.0,,5,1,4,5,2.70,20.0
6096,tt0118643,The Prophecy II,1998,"5,000+",8395,291,367,216,3.2,44.0,,6,2,4,6,4.70,33.0
6097,tt0212867,Soulkeeper,2001,250+,299,10,20,12,2.8,33.0,,2,2,0,2,,
6098,tt1031280,Splinter,2008,"10,000+",13278,1261,1299,1103,3.2,49.0,,37,28,9,37,6.40,76.0
6099,tt0106292,Another Stakeout,1993,"10,000+",19556,224,572,240,2.7,28.0,,25,4,21,25,4.50,16.0
6100,tt0299930,Gigli,2003,"25,000+",45269,364,2360,1433,1.7,13.0,,186,12,174,186,3.10,6.0
6101,tt0087985,Red Dawn,1984,"25,000+",49299,4422,2350,2697,3.6,65.0,,27,14,13,27,5.60,52.0
6102,tt1197624,Law Abiding Citizen,2009,"250,000+",517618,225098,73357,13868,4,75.0,,163,42,121,163,4.40,26.0
6103,tt0218505,Path to War,2002,500+,506,97,34,43,3.7,74.0,,11,11,0,11,8.00,100.0
6104,tt0071718,Killer Bees,1974,Fewer than 50,49,1,5,1,2.5,17.0,,0,0,0,0,,
6105,tt1343727,Dredd,2012,"100,000+",154299,34240,13074,7164,3.7,72.0,,170,136,34,170,6.60,80.0
6106,tt0323808,The Wicker Tree,2011,"1,000+",1511,32,293,95,1.7,10.0,,15,3,12,15,3.80,20.0
6107,tt0845535,Shakalaka Boom Boom,2007,0,0,0,0,0,,,,0,0,0,0,,
6108,tt0301454,Inspector Gadget 2,2003,"10,000+",14202,140,484,276,2.2,22.0,,5,2,3,5,4.40,40.0
6109,tt1981677,Pitch Perfect,2012,"100,000+",127544,47007,9649,6154,4.1,83.0,,157,128,29,157,6.50,82.0
6110,tt1264914,Zift,2008,250+,377,105,41,40,3.6,72.0,,1,1,0,1,,
6111,tt0323810,Right on Track,2003,500+,868,128,48,45,4,73.0,,2,1,1,2,,
6112,tt0814012,Anuranan,2006,250+,264,27,14,24,3.2,66.0,,0,0,0,0,,
6113,tt0088261,The Three Wishes of Billy Grier,1984,0,0,0,0,0,,,,0,0,0,0,,
6114,tt1229367,Living Proof,2008,500+,524,76,26,41,3.8,75.0,,0,0,0,0,,
6115,tt1321860,The Beaver,2011,"10,000+",24088,3510,2888,1599,3.3,55.0,,187,117,70,187,6.10,63.0
6116,tt0060397,Fantastic Voyage,1966,"5,000+",6911,680,322,291,3.6,68.0,,36,33,3,36,7.00,92.0
6117,tt0188160,Price of Glory,2000,"1,000+",1400,86,27,34,4.1,76.0,,60,20,40,60,4.80,33.0
6118,tt0246778,Melnattu Marumagal,1975,Fewer than 50,1,0,1,1,,,,0,0,0,0,,
6119,tt1280546,Signs of the Time,2008,Fewer than 50,7,0,2,2,,,,0,0,0,0,,
6120,tt0837562,Hotel Transylvania,2012,"100,000+",151742,33710,13405,4732,3.9,72.0,,143,64,79,143,5.40,45.0
6121,tt0056141,A Kind of Loving,1962,250+,435,72,11,24,4,87.0,,14,13,1,14,7.30,93.0
6122,tt0102522,Nekromantik 2,1991,"1,000+",1596,121,102,88,3.3,54.0,,3,3,0,3,,
6123,tt0305951,Pavithra,1994,0,0,0,0,0,,,,0,0,0,0,,
6124,tt0187512,"Slap Her, She's French!",2002,"5,000+",8727,245,397,255,2.9,38.0,,24,9,15,24,4.70,38.0
6125,tt0092644,Beverly Hills Cop II,1987,"250,000+",276383,3756,2781,2779,3.5,57.0,,39,18,21,39,5.10,46.0
6126,tt0167150,Restraining Order,1999,Fewer than 50,43,0,5,1,1.5,0.0,,2,0,2,2,,
6127,tt0068575,Fat City,1972,"1,000+",2359,431,83,151,3.9,84.0,,27,27,0,27,8.50,100.0
6128,tt0346578,Batman: Mystery of the Batwoman,2003,"10,000+",16117,1207,723,337,3.8,63.0,,5,3,2,5,5.30,60.0
6129,tt0276893,Daresalam,2001,Fewer than 50,31,2,1,1,,,,1,0,1,1,,
6130,tt0112722,Copycat,1995,"25,000+",41213,1826,1022,841,3.5,64.0,,57,43,14,57,6.50,75.0
6131,tt0298388,Jonah: A VeggieTales Movie,2002,"10,000+",23662,1086,371,683,3.9,75.0,,56,37,19,56,5.90,66.0
6132,tt0108072,The Secret Rapture,1993,50+,75,0,1,0,,,,4,2,2,4,,
6133,tt0275608,Pyaar Mein Kabhi Kabhi...,1999,0,0,0,0,0,,,,0,0,0,0,,
6134,tt0101284,Akayla,1991,50+,70,1,5,0,2.5,17.0,,0,0,0,0,,
6135,tt0164021,Eleftherios Venizelos: 1910-1927,1980,Fewer than 50,38,5,1,0,3.9,83.0,,0,0,0,0,,
6136,tt1232829,21 Jump Street,2012,"250,000+",258336,79005,16743,12040,4,83.0,,229,194,35,229,7.10,85.0
6137,tt0348354,Wasabi Tuna,2003,100+,128,3,7,2,2.6,30.0,,4,1,3,4,,
6138,tt0762121,The Nativity Story,2006,"50,000+",82887,2746,886,2132,3.9,76.0,,131,49,82,131,5.30,37.0
6139,tt0212815,Big Eden,2000,"2,500+",3958,381,101,207,4,79.0,,53,34,19,53,5.90,64.0
6140,tt0074815,Look What's Happened to Rosemary's Baby,1976,100+,128,3,22,6,1.6,12.0,,0,0,0,0,,
6141,tt0067976,When Eight Bells Toll,1971,500+,618,49,46,33,3.3,52.0,,3,2,1,3,,
6142,tt0166973,An American Tail: The Treasure of Manhattan Island,1998,500+,612,32,67,22,2.8,32.0,,3,0,3,3,,
6143,tt0069958,A Delicate Balance,1973,250+,328,21,14,13,3.4,60.0,,9,6,3,9,7.60,67.0
6144,tt0163986,The Brave Little Toaster to the Rescue,1997,"2,500+",4645,91,105,79,3.2,47.0,,4,1,3,4,,
6145,tt0099327,A Cry in the Wild,1990,500+,652,30,47,27,3,39.0,,0,0,0,0,,
6146,tt0120484,The Waterboy,1998,"250,000+",911096,29475,12008,21553,3.7,71.0,,75,25,50,75,4.50,33.0
6147,tt0380268,Cocaine Cowboys,2006,"50,000+",77131,2290,600,813,3.9,79.0,,51,36,15,51,6.40,71.0
6148,tt0080856,Heerak Rajar Deshe,1980,250+,367,54,5,16,4.5,92.0,,1,1,0,1,,
6149,tt0430932,Buffalo Dreams,2005,250+,401,33,21,19,3.7,61.0,,2,2,0,2,,
6150,tt1127877,Cold Souls,2009,"25,000+",29151,1185,1024,819,3.2,54.0,,125,94,31,125,6.40,75.0
6151,tt0085271,Brainstorm,1983,"5,000+",6895,361,288,222,3.4,56.0,,21,12,9,21,5.80,57.0
6152,tt0128445,Rushmore,1998,"100,000+",186454,30726,2996,8569,4.3,91.0,,108,97,11,108,8.10,90.0
6153,tt0929742,Deep Gold,2011,100+,114,6,15,5,1.9,29.0,,1,0,1,1,,
6154,tt0076513,Outrageous!,1977,250+,250,26,5,14,3.9,84.0,,8,8,0,8,7.80,100.0
6155,tt0405296,A Scanner Darkly,2006,"100,000+",140170,16839,6026,9022,3.7,74.0,,188,128,60,188,6.60,68.0
6156,tt0055905,Diamond Head,1962,500+,657,15,12,12,3.2,56.0,,0,0,0,0,,
6157,tt1722441,Katha Screenplay Darsakatvam: Appalaraju,2011,0,0,0,0,0,,,,0,0,0,0,,
6158,tt0100130,Megaville,1990,Fewer than 50,47,1,2,3,,,,0,0,0,0,,
6159,tt0141006,Fearless Tiger,1991,Fewer than 50,36,0,2,1,,,,0,0,0,0,,
6160,tt0257360,About Schmidt,2002,"50,000+",90788,6690,2327,2741,3.7,74.0,,205,175,30,205,7.70,85.0
6161,tt0408524,Bad News Bears,2005,"50,000+",76736,1942,2309,1751,3.2,46.0,,163,78,85,163,5.70,48.0
6162,tt0870195,Before the Rains,2007,"1,000+",1643,173,171,175,3.3,50.0,,69,34,35,69,5.30,49.0
6163,tt0960144,You Don't Mess with the Zohan,2008,"250,000+",410864,26164,32503,19452,3.1,45.0,,190,71,119,190,4.90,37.0
6164,tt0278102,Trembling Before G-d,2001,"1,000+",1503,97,34,58,3.8,74.0,,63,56,7,63,7.10,89.0
6165,tt0174741,Hitman's Run,1999,100+,119,3,10,6,2.2,23.0,,2,0,2,2,,
6166,tt1348305,Deadly Little Christmas,2009,50+,52,0,9,5,1,0.0,,1,0,1,1,,
6167,tt0117705,Space Jam,1996,"250,000+",656413,18031,10556,16876,3.7,63.0,,86,37,49,86,5.30,43.0
6168,tt0054673,The Beast of Yucca Flats,1961,"1,000+",1862,21,251,145,1.2,8.0,,3,0,3,3,,
6169,tt0215149,Sarvakalasala,1987,0,0,0,0,0,,,,0,0,0,0,,
6170,tt0321359,Return to the Batcave: The Misadventures of Adam and Burt,2003,100+,190,21,6,7,3.6,78.0,,1,1,0,1,,
6171,tt0096933,Black Rain,1989,"25,000+",27876,1526,1268,733,3.4,55.0,,24,13,11,24,5.30,54.0
6172,tt0100050,Look Who's Talking Too,1990,"100,000+",196761,1231,2624,2021,2.8,32.0,,16,2,14,16,3.50,13.0
6173,tt0064366,Genesis II,1973,Fewer than 50,46,6,5,3,3.3,55.0,,3,1,2,3,,
6174,tt0437459,Rollin' with the Nines,2006,"1,000+",1369,106,38,81,3.9,74.0,,0,0,0,0,,
6175,tt1235124,Dorian Gray,2009,"25,000+",45592,2883,4534,2190,3,39.0,,40,17,23,40,5.00,43.0
6176,tt0092072,Terror at Tenkiller,1986,Fewer than 50,37,0,24,10,1.3,0.0,,0,0,0,0,,
6177,tt0863136,Peter & the Wolf,2006,100+,126,36,7,5,4.1,84.0,,0,0,0,0,,
6178,tt0091975,A Smoky Mountain Christmas,1986,"1,000+",1937,125,30,77,4.3,81.0,,0,0,0,0,,
6179,tt0497465,Vicky Cristina Barcelona,2008,"100,000+",104180,22294,7984,10348,3.7,74.0,,214,172,42,214,6.90,80.0
6180,tt0102432,Men of Respect,1990,250+,374,12,17,16,3.1,41.0,,3,0,3,3,,
6181,tt0460898,Pervert!,2005,"1,000+",1084,71,165,113,2.6,30.0,,4,4,0,4,,
6182,tt0419259,Wannabe,2005,Fewer than 50,3,1,0,0,,,,0,0,0,0,,
6183,tt0109297,Blink,1993,"2,500+",4608,173,213,87,3.2,45.0,,25,16,9,25,5.70,64.0
6184,tt0181316,Blue Streak,1999,"100,000+",201681,3962,2190,2617,3.6,64.0,,69,25,44,69,4.80,36.0
6185,tt1504691,Plastic Bag,2009,Fewer than 50,1,1,0,0,,,,0,0,0,0,,
6186,tt0327016,The Locket,2002,250+,481,15,10,12,3.6,60.0,,1,1,0,1,,
6187,tt0926129,Prom Night,2008,"250,000+",269962,5143,8463,7506,2.8,38.0,,69,6,63,69,3.00,9.0
6188,tt0443680,The Assassination of Jesse James by the Coward Robert Ford,2007,"50,000+",98434,24156,8053,13962,3.8,75.0,,177,136,41,177,7.20,77.0
6189,tt0056059,Hatari!,1962,"5,000+",8702,673,206,303,3.9,77.0,,25,16,9,25,6.80,64.0
6190,tt0093058,Full Metal Jacket,1987,"250,000+",325334,67122,4300,18547,4.4,94.0,,86,77,9,86,8.30,90.0
6191,tt0105636,Trespass,1992,"5,000+",7491,320,353,171,3.2,47.0,,30,21,9,30,6.30,70.0
6192,tt0086205,Romantic Comedy,1983,"1,000+",1606,25,34,19,3.1,42.0,,14,4,10,14,5.10,29.0
6193,tt1242642,Judas Kiss,2011,500+,584,67,72,34,3.1,48.0,,1,0,1,1,,
6194,tt0092646,Beyond Therapy,1987,"1,000+",1223,19,45,20,2.5,30.0,,12,2,10,12,4.30,17.0
6195,tt0060135,Assault on a Queen,1966,Fewer than 50,39,4,7,7,3.4,36.0,,0,0,0,0,,
6196,tt0361693,Happy Endings,2005,"5,000+",9121,1078,626,658,3.5,63.0,,106,58,48,106,5.90,55.0
6197,tt0089050,The Dream Is Alive,1985,500+,658,24,2,9,4,92.0,,1,1,0,1,,
6198,tt0105459,Split Second,1992,"5,000+",5518,315,244,230,3.4,56.0,,4,1,3,4,,
6199,tt0117626,She Cried No,1996,100+,106,11,15,11,3.1,42.0,,0,0,0,0,,
6200,tt0094293,Wanted: Dead or Alive,1986,"5,000+",5300,110,118,104,3.2,48.0,,10,3,7,10,4.20,30.0
6201,tt0059794,That Funny Feeling,1965,500+,931,54,23,26,3.8,70.0,,1,0,1,1,,
6202,tt0089851,Pulgasari,1985,0,0,0,0,0,,,,0,0,0,0,,
6203,tt0095626,Messenger of Death,1988,"1,000+",1716,31,99,48,2.7,24.0,,0,0,0,0,,
6204,tt0065398,And Soon the Darkness,1970,250+,439,77,46,57,3.4,63.0,,7,2,5,7,4.60,29.0
6205,tt0476568,Meet Me in Miami,2005,Fewer than 50,10,0,1,0,,,,1,1,0,1,,
6206,tt0212720,A.I. Artificial Intelligence,2001,"250,000+",414410,17968,9966,15325,3.5,64.0,,200,151,49,200,6.70,76.0
6207,tt0235553,Love and a Bullet,2002,"1,000+",1739,77,41,46,3.7,65.0,,2,0,2,2,,
6208,tt0096934,Black Snow,1989,250+,253,7,1,2,3.6,88.0,,0,0,0,0,,
6209,tt0089686,A Nightmare on Elm Street Part 2: Freddy's Revenge,1985,"250,000+",321696,2555,5205,4785,2.8,33.0,,31,13,18,31,5.10,42.0
6210,tt0287065,Udaan,1997,0,0,0,0,0,,,,0,0,0,0,,
6211,tt0092695,The Brave Little Toaster,1987,"25,000+",47885,3197,753,2421,4,81.0,,13,10,3,13,7.30,77.0
6212,tt0268978,A Beautiful Mind,2001,"250,000+",491450,81611,6576,20882,4.3,93.0,,214,159,55,214,7.20,74.0
6213,tt0054483,The World of Suzie Wong,1960,"1,000+",1101,112,52,62,3.7,68.0,,8,3,5,8,5.80,38.0
6214,tt0099371,Days of Thunder,1990,"100,000+",132625,5033,3376,2552,3.6,60.0,,66,25,41,66,5.00,38.0
6215,tt1330015,Christmas Town,2008,100+,127,17,43,17,2.6,28.0,,1,0,1,1,,
6216,tt0075686,Annie Hall,1977,"100,000+",153991,23616,1974,6518,4.4,92.0,,127,123,4,127,9.10,97.0
6217,tt0113819,Mighty Aphrodite,1995,"10,000+",21136,2138,797,618,3.6,73.0,,37,29,8,37,6.80,78.0
6218,tt0060522,How to Steal a Million,1966,"10,000+",10999,2260,301,660,4.1,88.0,,11,11,0,11,7.10,100.0
6219,tt0453446,Alien Planet,2005,250+,304,39,6,17,4.1,87.0,,1,1,0,1,,
6220,tt0095036,Distant Thunder,1988,250+,346,15,19,11,3,44.0,,7,3,4,7,5.30,43.0
6221,tt1234546,Master Harold ... and the Boys,2010,50+,98,21,20,13,3.4,51.0,,2,1,1,2,,
6222,tt0473043,Hell to Pay,2005,Fewer than 50,9,1,1,2,,,,0,0,0,0,,
6223,tt0067457,Murders in the Rue Morgue,1971,100+,223,9,29,13,2.4,24.0,,5,1,4,5,4.00,20.0
6224,tt2023690,Sightseers,2012,"5,000+",9100,2062,1257,568,3.4,62.0,,110,95,15,110,7.40,86.0
6225,tt0108330,This Boy's Life,1993,"10,000+",23052,2544,652,688,3.8,80.0,,37,28,9,37,6.40,76.0
6226,tt1596350,This Means War,2012,"50,000+",89895,17861,13877,4313,3.4,56.0,,184,47,137,184,4.50,26.0
6227,tt0435185,Marker,2005,50+,66,0,3,0,,,,0,0,0,0,,
6228,tt1695131,Hating kapatid,2010,Fewer than 50,37,6,7,3,3,46.0,,0,0,0,0,,
6229,tt0054938,Gorgo,1961,"1,000+",1422,75,121,87,2.9,38.0,,4,3,1,4,,
6230,tt0109675,Drop Squad,1994,500+,669,18,22,7,3.2,45.0,,7,1,6,7,4.40,14.0
6231,tt0078295,Someone's Watching Me!,1978,500+,637,73,98,56,3.2,43.0,,7,6,1,7,7.10,86.0
6232,tt1324059,Wake Up Sid,2009,"5,000+",5194,700,229,354,3.7,75.0,,6,5,1,6,6.60,83.0
6233,tt0058085,The Fall of the Roman Empire,1964,"2,500+",3285,277,127,119,3.6,69.0,,13,12,1,13,7.20,92.0
6234,tt1326204,Crude,2009,"1,000+",1479,195,35,77,4,85.0,,64,61,3,64,7.40,95.0
6235,tt0218619,Soul Survivors,2001,"10,000+",11397,302,851,381,2.4,26.0,,47,2,45,47,2.90,4.0
6236,tt0157556,Dream Girl,1977,Fewer than 50,12,4,1,1,4,80.0,,0,0,0,0,,
6237,tt0448408,Chandrolsavam,2005,0,0,0,0,0,,,,0,0,0,0,,
6238,tt0221982,Gaja Gamini,2000,500+,944,7,17,5,2.5,29.0,,0,0,0,0,,
6239,tt0262258,Balipeetam,1975,0,0,0,0,0,,,,0,0,0,0,,
6240,tt0456521,"Ma fille, mon ange",2007,Fewer than 50,12,1,3,0,,,,1,1,0,1,,
6241,tt0055962,Escape from East Berlin,1962,50+,60,6,6,4,3.2,50.0,,0,0,0,0,,
6242,tt0062362,Thoroughly Modern Millie,1967,"5,000+",9191,831,197,473,4.1,81.0,,13,11,2,13,7.50,85.0
6243,tt0120769,The Newton Boys,1998,"10,000+",10110,342,441,176,3.2,44.0,,40,26,14,40,6.20,65.0
6244,tt1129427,Miss Nobody,2010,Fewer than 50,2,2,0,0,,,,0,0,0,0,,
6245,tt0058557,Seance on a Wet Afternoon,1964,"1,000+",1268,173,37,88,3.9,82.0,,18,14,4,18,7.40,78.0
6246,tt0425200,Little Terrorist,2004,Fewer than 50,21,12,9,2,3.5,57.0,,1,1,0,1,,
6247,tt0107612,Mr. Nanny,1993,"25,000+",40892,306,624,579,2.7,33.0,,16,1,15,16,3.10,6.0
6248,tt0896923,The City of Your Final Destination,2009,"2,500+",2893,116,180,111,2.9,39.0,,57,22,35,57,5.20,39.0
6249,tt0429715,The Business,2005,"10,000+",20003,2467,463,1123,4.2,84.0,,7,4,3,7,5.80,57.0
6250,tt0115645,Before and After,1996,"5,000+",5466,176,334,141,3,35.0,,19,6,13,19,4.80,32.0
6251,tt0103192,Vegas in Space,1991,500+,541,16,14,16,3.1,53.0,,1,1,0,1,,
6252,tt0322023,"Die, Mommie, Die!",2003,"2,500+",2774,189,70,95,3.7,73.0,,60,39,21,60,6.00,65.0
6253,tt5439126,Manam Kothi Paravai,2012,Fewer than 50,21,6,3,1,3.9,67.0,,0,0,0,0,,
6254,tt0091258,Ilzaam,1986,0,0,0,0,0,,,,0,0,0,0,,
6255,tt0071370,The Crazy World of Julius Vrooder,1974,Fewer than 50,1,1,0,1,,,,0,0,0,0,,
6256,tt1462054,Letters to God,2010,"10,000+",19680,1499,510,505,4,75.0,,24,6,18,24,4.70,25.0
6257,tt0118617,Anastasia,1997,Fewer than 50,16,15,1,2,4.3,94.0,,0,0,0,0,,
6258,tt1071875,Ghost Rider: Spirit of Vengeance,2011,"100,000+",113064,8467,18476,4721,2.6,31.0,,120,23,97,120,4.00,19.0
6259,tt0335559,Win a Date with Tad Hamilton!,2004,"50,000+",74549,1793,2060,2073,3.2,47.0,,149,82,67,149,5.60,55.0
6260,tt2271431,Keshu,2009,0,0,0,0,0,,,,0,0,0,0,,
6261,tt0443274,Vantage Point,2008,"250,000+",373614,27195,20670,24535,3.4,57.0,,157,53,104,157,4.90,34.0
6262,tt1298649,The Watch,2012,"50,000+",80888,10616,16482,3376,3,39.0,,167,27,140,167,4.10,16.0
6263,tt0837800,The Mark of Cain,2007,500+,660,111,67,58,3.4,62.0,,0,0,0,0,,
6264,tt0056285,What a Carve Up!,1961,250+,296,20,12,19,3.5,62.0,,1,1,0,1,,
6265,tt0816545,Kabluey,2007,"2,500+",2897,511,280,372,3.5,65.0,,36,30,6,36,6.90,83.0
6266,tt0312603,Deathlands,2003,Fewer than 50,24,0,9,5,1.2,0.0,,0,0,0,0,,
6267,tt0111201,Sirens,1994,"5,000+",7115,222,321,156,3,41.0,,31,23,8,31,6.30,74.0
6268,tt0120724,Knock Off,1998,"10,000+",10490,181,513,217,2.5,26.0,,41,4,37,41,3.40,10.0
6269,tt0066065,Medea,1969,"1,000+",1707,191,65,47,3.8,74.0,,11,8,3,11,6.10,73.0
6270,tt0109903,Girls in Prison,1994,50+,83,2,14,5,2.2,12.0,,2,2,0,2,,
6271,tt0090358,Yudh,1985,Fewer than 50,9,1,0,0,,,,0,0,0,0,,
6272,tt0237395,Lal Patthar,1971,0,0,0,0,0,,,,0,0,0,0,,
6273,tt1464590,The Weathered Underground,2010,50+,79,46,2,1,4.8,96.0,,1,0,1,1,,
6274,tt0075148,Rocky,1976,"250,000+",33403994,74632,33408,1432746,3.2,69.0,,72,66,6,72,8.30,92.0
6275,tt0234207,Marte Dam Tak,1987,Fewer than 50,43,1,0,0,,,,0,0,0,0,,
6276,tt1464580,Stake Land,2010,"5,000+",8205,2424,1492,918,3.4,62.0,,67,50,17,67,6.50,75.0
6277,tt0054042,Macario,1960,500+,538,135,8,37,4.4,94.0,,6,6,0,6,9.00,100.0
6278,tt0363475,Black Cloud,2004,"1,000+",2220,113,28,88,4,80.0,,7,2,5,7,5.30,29.0
6279,tt0124555,Finding North,1998,"1,000+",1193,6,8,8,3.3,43.0,,11,4,7,11,5.00,36.0
6280,tt0252056,Thachiledathu Chundan,1999,0,0,0,0,0,,,,0,0,0,0,,
6281,tt0373908,The Honeymooners,2005,"5,000+",9588,161,378,199,2.6,30.0,,111,14,97,111,3.70,13.0
6282,tt0054353,The Sundowners,1960,500+,601,92,52,40,3.5,64.0,,14,11,3,14,7.00,79.0
6283,tt0110367,Little Women,1994,"50,000+",87702,6742,1304,3051,4.1,84.0,,43,40,3,43,7.30,93.0
6284,tt0090856,Club Paradise,1986,"5,000+",6955,133,242,120,3,35.0,,28,3,25,28,4.30,11.0
6285,tt0114534,The Stars Fell on Henrietta,1995,100+,117,5,7,6,3.2,42.0,,10,5,5,10,5.80,50.0
6286,tt1305797,Enthiran,2010,50+,85,64,12,15,4.2,84.0,,13,9,4,13,5.60,69.0
6287,tt0053640,The Beatniks,1958,250+,290,4,49,23,1.6,8.0,,1,0,1,1,,
6288,tt0398808,Bridge to Terabithia,2007,"250,000+",468769,26492,11149,24778,3.7,70.0,,163,138,25,163,7.20,85.0
6289,tt1038685,The King of Fighters,2010,"1,000+",1534,47,381,175,1.7,11.0,,3,0,3,3,,
6290,tt0120737,The Lord of the Rings: The Fellowship of the Ring,2001,"250,000+",1355751,167643,8379,80557,4.1,95.0,,235,215,20,235,8.20,91.0
6291,tt0371735,Hungama,2003,0,0,0,0,0,,,,0,0,0,0,,
6292,tt0083747,The Comeback Kid,1980,Fewer than 50,23,4,5,3,3.6,44.0,,0,0,0,0,,
6293,tt0311113,Master and Commander: The Far Side of the World,2003,"100,000+",141450,12119,2956,5391,3.9,80.0,,224,191,33,224,7.60,85.0
6294,tt0115433,101 Dalmatians,1996,"250,000+",625491,3815,5792,10039,3.1,40.0,,36,14,22,36,5.30,39.0
6295,tt0133313,Night of the Living Bread,1990,Fewer than 50,16,10,6,6,3.6,62.0,,0,0,0,0,,
6296,tt0195618,Crossroads to Crime,1960,0,0,0,0,0,,,,0,0,0,0,,
6297,tt0183659,Pollock,2000,"10,000+",12157,1766,625,638,3.7,74.0,,109,87,22,109,6.90,80.0
6298,tt0464990,Jaanam,1992,0,0,0,0,0,,,,0,0,0,0,,
6299,tt0099166,Book of Love,1990,"1,000+",1754,57,43,23,3.5,57.0,,3,2,1,3,,
6300,tt0289864,Big Ain't Bad,2002,500+,758,1,1,3,,,,0,0,0,0,,
6301,tt0094331,Wish You Were Here,1987,"1,000+",1039,137,40,68,4,77.0,,33,28,5,33,7.20,85.0
6302,tt1242432,I Spit on Your Grave,2010,"10,000+",10973,2414,2688,1465,3.1,47.0,,62,19,43,62,4.50,31.0
6303,tt1456939,Searching for Sonny,2011,50+,83,21,8,4,4,72.0,,2,1,1,2,,
6304,tt0108539,Weekend at Bernie's II,1993,"25,000+",37280,487,707,740,2.9,41.0,,31,4,27,31,3.60,13.0
6305,tt0355410,Ee Puzhayum Kadannu,1996,0,0,0,0,0,,,,0,0,0,0,,
6306,tt0443295,"Yours, Mine & Ours",2005,"250,000+",398106,4518,4322,7374,3.3,51.0,,106,6,100,106,3.40,6.0
6307,tt0249074,Parannu Parannu Parannu,1984,0,0,0,0,0,,,,0,0,0,0,,
6308,tt0765010,Brothers,2009,100+,209,20,20,13,3.4,50.0,,1,0,1,1,,
6309,tt0060138,Au hasard Balthazar,1966,"5,000+",7005,1258,213,387,4.2,86.0,,45,45,0,45,9.20,100.0
6310,tt0396587,FAQs,2005,250+,286,19,19,18,3.2,50.0,,3,0,3,3,,
6311,tt0107211,Indecent Proposal,1993,"25,000+",46487,1916,2177,1049,3.2,47.0,,47,16,31,47,4.80,34.0
6312,tt1175735,Special Delivery,2008,100+,147,12,13,8,3.2,48.0,,1,1,0,1,,
6313,tt0182251,Jab Pyaar Kisise Hota Hai,1998,500+,567,27,37,9,3.3,42.0,,0,0,0,0,,
6314,tt0083922,Fanny och Alexander,1982,"10,000+",21461,4077,274,1027,4.5,94.0,,45,45,0,45,9.00,100.0
6315,tt0087054,Choose Me,1984,"1,000+",1317,96,36,46,3.7,73.0,,18,17,1,18,7.60,94.0
6316,tt0287624,Paradise Found,2003,250+,491,13,26,13,2.9,33.0,,1,0,1,1,,
6317,tt0430328,Madhoshi,2004,250+,411,13,26,7,2.6,33.0,,0,0,0,0,,
6318,tt0070915,White Lightning,1973,"1,000+",1666,158,101,97,3.5,61.0,,8,5,3,8,6.00,63.0
6319,tt0850648,American Cowslip,2009,500+,766,20,20,14,3.2,51.0,,2,0,2,2,,
6320,tt0111780,Yaar Gaddar,1994,0,0,0,0,0,,,,0,0,0,0,,
6321,tt0309820,Luther,2003,"5,000+",8732,1303,465,715,3.8,74.0,,62,28,34,62,5.20,45.0
6322,tt0097977,Nightbreaker,1989,50+,96,6,3,1,3.5,67.0,,0,0,0,0,,
6323,tt0119272,Heaven's Burning,1997,"1,000+",1687,35,62,35,3,36.0,,3,1,2,3,,
6324,tt0084931,"Yes, Giorgio",1982,100+,216,10,17,12,2.4,37.0,,6,2,4,6,4.90,33.0
6325,tt0101324,American Friends,1991,250+,409,14,18,14,3.3,44.0,,4,2,2,4,,
6326,tt0119862,Pardesi Babu,1998,0,0,0,0,0,,,,0,0,0,0,,
6327,tt0110347,Lies of the Heart: The Story of Laurie Kellogg,1994,0,0,0,0,0,,,,0,0,0,0,,
6328,tt0114559,The Stranger Beside Me,1995,250+,344,18,15,5,3.5,55.0,,0,0,0,0,,
6329,tt13667134,Pallikoodam,2007,0,0,0,0,0,,,,0,0,0,0,,
6330,tt0381442,Narco,2004,"1,000+",1563,185,110,53,3.5,63.0,,0,0,0,0,,
6331,tt0074236,The Boy in the Plastic Bubble,1976,"5,000+",8589,228,255,194,3.2,47.0,,2,2,0,2,,
6332,tt0083987,Gandhi,1982,"25,000+",49947,8374,731,2481,4.3,92.0,,110,98,12,110,8.30,89.0
6333,tt0477916,Viva Cuba,2005,500+,852,158,44,76,3.9,79.0,,4,2,2,4,,
6334,tt0458471,Second in Command,2006,"2,500+",2904,115,239,125,2.7,32.0,,1,0,1,1,,
6335,tt0341549,Rishtey,2002,100+,192,6,11,1,2.7,35.0,,0,0,0,0,,
6336,tt0120102,Seven Years in Tibet,1997,"50,000+",60228,5461,1974,1616,3.7,73.0,,36,21,15,36,6.20,58.0
6337,tt0410603,Sidekick,2005,250+,311,18,31,25,2.8,37.0,,14,14,0,14,7.20,100.0
6338,tt0275285,Curse of the Talisman,2001,250+,404,4,17,9,2.1,19.0,,1,0,1,1,,
6339,tt1232824,Into Temptation,2009,250+,422,122,50,67,3.7,71.0,,5,4,1,5,7.10,80.0
6340,tt1233519,Caregiver,2008,100+,229,22,5,13,3.7,81.0,,0,0,0,0,,
6341,tt0105402,Sidekicks,1992,"5,000+",7278,397,426,369,3.2,48.0,,19,5,14,19,4.00,26.0
6342,tt0118554,Adam & Eva,1997,500+,537,85,36,22,3.8,70.0,,0,0,0,0,,
6343,tt0078946,Cathy's Child,1979,0,0,0,0,0,,,,0,0,0,0,,
6344,tt0115862,The Chamber,1996,"5,000+",7389,299,471,193,3,39.0,,25,3,22,25,4.40,12.0
6345,tt0148573,Painted Lady,1997,100+,149,15,10,9,3.3,60.0,,1,1,0,1,,
6346,tt1583256,Gamyam,2008,100+,156,25,4,5,4,86.0,,0,0,0,0,,
6347,tt0371021,Nosey Parker,2003,Fewer than 50,8,1,0,1,,,,7,7,0,7,8.00,100.0
6348,tt0368268,Shiner,2004,50+,78,2,5,3,3,29.0,,0,0,0,0,,
6349,tt0094317,White Mischief,1987,500+,917,51,44,19,3.4,54.0,,10,8,2,10,6.30,80.0
6350,tt0119285,Hero No. 1,1997,250+,293,15,10,4,3.4,60.0,,0,0,0,0,,
6351,tt0094946,Dangerous Curves,1988,100+,109,1,18,4,2.1,5.0,,0,0,0,0,,
6352,tt0055317,Portrait of a Mobster,1961,0,0,0,0,0,,,,0,0,0,0,,
6353,tt0077469,Dr. Strange,1978,250+,475,143,58,39,4,71.0,,1,1,0,1,,
6354,tt0800308,Appaloosa,2008,"50,000+",55773,4971,4118,4096,3.3,55.0,,163,124,39,163,6.70,76.0
6355,tt1426329,Lovelace,2013,"10,000+",14418,1916,3457,551,3,36.0,,127,67,60,127,5.70,53.0
6356,tt0104029,Cronos,1992,"10,000+",13069,2421,1063,1035,3.6,69.0,,58,52,6,58,7.30,90.0
6357,tt0114671,Land and Freedom,1995,"5,000+",5300,1034,62,265,4.4,94.0,,14,11,3,14,7.70,79.0
6358,tt1683981,Thomas & Friends: Misty Island Rescue,2010,100+,158,18,18,19,2.9,50.0,,1,1,0,1,,
6359,tt0484039,Glue,2006,500+,916,121,68,79,3.6,63.0,,2,2,0,2,,
6360,tt0368688,Direct Action,2004,500+,885,28,40,20,2.9,41.0,,0,0,0,0,,
6361,tt0097351,Field of Dreams,1989,"100,000+",193224,13910,2261,6181,4.2,86.0,,65,57,8,65,8.00,88.0
6362,tt0406622,C.I. Mahadevan 5 Adi 4 Inchu,2004,0,0,0,0,0,,,,0,0,0,0,,
6363,tt0088008,Roadhouse 66,1984,500+,528,26,27,10,3.2,49.0,,1,0,1,1,,
6364,tt1135968,Dean Spanley,2008,500+,977,354,87,178,4,81.0,,32,28,4,32,6.60,88.0
6365,tt0064111,Bronco Bullfrog,1970,Fewer than 50,14,6,8,3,3.2,43.0,,13,13,0,13,7.50,100.0
6366,tt0274019,Pyaar Diwana Hota Hai,2002,Fewer than 50,18,1,4,0,2.2,20.0,,0,0,0,0,,
6367,tt0094642,American Gothic,1987,500+,794,109,105,82,3.3,51.0,,4,0,4,4,,
6368,tt1034302,The Cry of the Owl,2009,"5,000+",7891,108,448,170,2.4,19.0,,9,1,8,9,3.90,11.0
6369,tt0758752,Love & Other Drugs,2010,"50,000+",74625,11921,10659,4634,3.3,53.0,,170,84,86,170,5.80,49.0
6370,tt0057963,The Beauty Jungle,1964,0,0,0,0,0,,,,0,0,0,0,,
6371,tt0083798,Dead Men Don't Wear Plaid,1982,"10,000+",10110,1237,484,579,3.7,72.0,,26,20,6,26,6.50,77.0
6372,tt0323642,Piglet's Big Movie,2003,"5,000+",9691,402,230,284,3.7,64.0,,77,54,23,77,6.20,70.0
6373,tt0059460,The Money Trap,1965,50+,71,4,8,7,3.1,36.0,,2,1,1,2,,
6374,tt0320241,Particles of Truth,2003,500+,952,80,25,43,4,78.0,,12,6,6,12,5.10,50.0
6375,tt0292319,Varavelpu,1989,0,0,0,0,0,,,,0,0,0,0,,
6376,tt0286664,Gudgudee,1997,0,0,0,0,0,,,,0,0,0,0,,
6377,tt0071361,Coonskin,1974,500+,801,207,54,91,3.9,80.0,,3,2,1,3,,
6378,tt0897374,Munna,2007,250+,271,5,10,2,3.2,33.0,,0,0,0,0,,
6379,tt0482267,Susuk,2008,0,0,0,0,0,,,,0,0,0,0,,
6380,tt0263101,Bangkok Dangerous,2000,"2,500+",3265,263,163,178,3.5,62.0,,38,20,18,38,5.60,53.0
6381,tt0117652,Silent Lies,1996,0,0,0,0,0,,,,0,0,0,0,,
6382,tt0097262,Eddie and the Cruisers II: Eddie Lives!,1989,"5,000+",6334,258,102,179,3.9,72.0,,3,0,3,3,,
6383,tt0064652,Medium Cool,1969,"1,000+",1884,260,72,122,3.8,78.0,,27,26,1,27,8.20,96.0
6384,tt0075188,The Sell Out,1976,Fewer than 50,39,1,4,3,2.4,20.0,,0,0,0,0,,
6385,tt1479534,Skyrunners,2009,100+,235,32,65,37,2.9,33.0,,0,0,0,0,,
6386,tt0304229,Japanese Story,2003,"5,000+",5402,598,262,361,3.6,69.0,,92,63,29,92,6.40,68.0
6387,tt10681962,Kizhakku Mugam,1996,0,0,0,0,0,,,,0,0,0,0,,
6388,tt6754642,Tata Birla,1996,0,0,0,0,0,,,,0,0,0,0,,
6389,tt0057608,Twice-Told Tales,1963,500+,522,64,50,37,3.5,56.0,,9,5,4,9,5.90,56.0
6390,tt0285627,Daria in 'Is It College Yet?',2002,"2,500+",2728,274,37,76,4.2,88.0,,3,3,0,3,,
6391,tt0133751,The Faculty,1998,"100,000+",187288,5066,3817,4165,3.4,57.0,,63,36,27,63,5.70,57.0
6392,tt0093418,Like Father Like Son,1987,"5,000+",8859,125,221,114,3,36.0,,4,2,2,4,,
6393,tt0068226,The Assassination of Trotsky,1972,100+,123,9,16,3,3,36.0,,2,1,1,2,,
6394,tt0109813,The Flintstones,1994,"250,000+",261245,1341,4097,3920,2.5,25.0,,48,11,37,48,4.00,23.0
6395,tt0806191,Together Again for the First Time,2008,100+,196,8,20,15,2.8,29.0,,0,0,0,0,,
6396,tt0061450,Carry on Doctor,1967,"5,000+",7643,187,83,110,3.7,69.0,,2,0,2,2,,
6397,tt0262995,Victoria & Albert,2001,50+,90,17,5,4,4,77.0,,0,0,0,0,,
6398,tt0963965,Dolan's Cadillac,2009,"1,000+",1181,145,320,173,2.8,31.0,,1,0,1,1,,
6399,tt0076161,The Hound of the Baskervilles,1978,"1,000+",1733,31,42,33,3.2,42.0,,7,0,7,7,1.80,0.0
6400,tt0328107,Man on Fire,2004,"250,000+",424110,44790,5363,18937,4.3,89.0,,168,65,103,168,5.30,39.0
6401,tt0085248,The Black Stallion Returns,1983,"5,000+",7167,179,69,102,3.9,72.0,,5,1,4,5,5.60,20.0
6402,tt1641385,96 Minutes,2011,"2,500+",3722,137,168,53,3.2,45.0,,17,9,8,17,5.40,53.0
6403,tt0090319,White Nights,1985,"5,000+",5440,424,148,239,3.9,74.0,,13,6,7,13,5.10,46.0
6404,tt0080846,Hawk the Slayer,1980,"2,500+",3714,218,167,231,3.4,57.0,,5,2,3,5,5.30,40.0
6405,tt3332304,Thirumalai,2003,50+,98,6,6,1,3.4,50.0,,0,0,0,0,,
6406,tt0111419,Thumbelina,1994,"50,000+",60105,2065,1050,1441,3.7,66.0,,13,5,8,13,5.20,38.0
6407,tt0080846,Hawk the Slayer,1980,"2,500+",3714,218,167,231,3.4,57.0,,5,2,3,5,5.30,40.0
6408,tt0280424,Amy's Orgasm,2001,"1,000+",1696,31,61,38,2.8,34.0,,31,8,23,31,4.60,26.0
6409,tt0072239,Symptoms,1974,50+,57,16,12,4,3.4,57.0,,5,5,0,5,7.00,100.0
6410,tt0055930,Dr. Vidya,1962,0,0,0,0,0,,,,0,0,0,0,,
6411,tt0067419,The Mephisto Waltz,1971,250+,374,41,56,42,3.1,42.0,,8,5,3,8,4.90,63.0
6412,tt0077687,The Hobbit,1977,"50,000+",69030,2083,1133,1342,3.6,65.0,,17,12,5,17,5.70,71.0
6413,tt1447508,Peepli [Live],2010,"2,500+",2803,412,159,202,3.7,72.0,,28,24,4,28,6.30,86.0
6414,tt0398963,Dorian Blues,2004,"1,000+",1928,127,66,72,3.6,65.0,,25,15,10,25,5.80,60.0
6415,tt0057380,Old Shatterhand,1964,Fewer than 50,9,2,2,1,,,,0,0,0,0,,
6416,tt0140447,The Passion of Ayn Rand,1999,500+,644,66,48,37,3.4,58.0,,6,5,1,6,6.80,83.0
6417,tt0242587,L.I.E.,2001,"5,000+",7500,875,248,371,3.8,78.0,,86,72,14,86,7.00,84.0
6418,tt0762148,Christmas Is Here Again,2007,100+,159,16,22,10,3.1,41.0,,2,1,1,2,,
6419,tt0117979,The Truth About Cats & Dogs,1996,"50,000+",52516,1602,1232,1108,3.4,57.0,,47,40,7,47,6.70,85.0
6420,tt1493243,The Fat Boy Chronicles,2010,250+,275,94,91,42,3.2,51.0,,1,0,1,1,,
6421,tt0090555,Crocodile Dundee,1986,"250,000+",254517,3407,2341,3579,3.5,59.0,,36,32,4,36,6.80,89.0
6422,tt0115783,Bulletproof,1996,"50,000+",75001,1513,1912,976,3.1,44.0,,38,3,35,38,3.70,8.0
6423,tt0120577,54,1998,"25,000+",29059,10,18,3,2.9,36.0,,66,10,56,66,4.10,15.0
6424,tt1186370,Spread,2009,"10,000+",23240,900,2270,866,2.6,28.0,,60,13,47,60,4.20,22.0
6425,tt0088286,Top Secret!,1984,"25,000+",41723,4036,1038,1830,3.9,80.0,,51,39,12,51,6.50,76.0
6426,tt1193631,Step Up 3D,2010,"100,000+",100628,6981,3934,2804,3.7,64.0,,124,58,66,124,5.10,47.0
6427,tt0102638,Paris Trout,1991,100+,223,19,14,11,3.4,58.0,,0,0,0,0,,
6428,tt0172704,Lal Baadshah,1999,50+,83,2,8,1,2.2,20.0,,0,0,0,0,,
6429,tt0098300,Shag,1988,"5,000+",8042,931,129,444,4.4,88.0,,17,11,6,17,6.10,65.0
6430,tt1195478,The Five-Year Engagement,2012,"250,000+",267132,13314,12605,2952,3.3,51.0,,179,114,65,179,6.20,64.0
6431,tt0337812,Air Bud: Spikes Back,2003,"50,000+",72193,182,190,404,3.1,49.0,,1,0,1,1,,
6432,tt0304711,The Order,2003,"10,000+",22604,800,1291,713,2.9,38.0,,61,6,55,61,3.10,10.0
6433,tt0108207,Splitting Heirs,1993,"2,500+",3081,91,153,68,2.9,37.0,,14,1,13,14,3.60,7.0
6434,tt0093378,La Bamba,1987,"50,000+",52314,2671,734,1237,4,78.0,,79,65,14,79,6.90,82.0
6435,tt0085933,"Merry Christmas, Mr. Lawrence",1983,"5,000+",6580,962,259,366,3.9,79.0,,28,24,4,28,6.60,86.0
6436,tt0056172,Lawrence of Arabia,1962,"50,000+",75428,18775,1456,5597,4.5,93.0,,133,125,8,133,9.30,94.0
6437,tt1206475,Adela,2008,50+,69,10,5,7,3.5,67.0,,3,3,0,3,,
6438,tt1728655,Magika,2010,Fewer than 50,1,1,0,0,,,,0,0,0,0,,
6439,tt0361240,Spartacus,2004,"5,000+",5898,240,112,103,3.7,68.0,,1,0,1,1,,
6440,tt0260162,The Mangler 2,2002,"1,000+",1072,9,93,51,1.7,9.0,,3,0,3,3,,
6441,tt0093779,The Princess Bride,1987,"250,000+",528367,84261,4970,37209,4.5,94.0,,83,81,2,83,8.50,98.0
6442,tt0214585,Chithram,1988,0,0,0,0,0,,,,0,0,0,0,,
6443,tt1522262,The Last Lovecraft: Relic of Cthulhu,2009,250+,486,75,128,82,2.9,37.0,,2,2,0,2,,
6444,tt0173974,Lansky,1999,100+,103,5,19,9,2.5,21.0,,5,2,3,5,4.70,40.0
6445,tt0118750,Booty Call,1997,"10,000+",21857,824,574,401,3.5,59.0,,13,4,9,13,4.60,31.0
6446,tt0316078,Kadhalukku Mariyadhai,1997,0,0,0,0,0,,,,0,0,0,0,,
6447,tt0062369,The Tiger Makes Out,1967,Fewer than 50,37,1,3,0,,,,3,1,2,3,,
6448,tt0456144,Lage Raho Munna Bhai,2006,"5,000+",7140,862,94,296,4.3,90.0,,2,1,1,2,,
6449,tt0112924,East Meets West,1995,Fewer than 50,5,3,0,2,,,,0,0,0,0,,
6450,tt0095719,The Nest,1987,250+,357,24,55,28,2.8,30.0,,4,2,2,4,,
6451,tt0112384,Apollo 13,1995,"250,000+",433304,22045,3336,9090,4.1,87.0,,97,93,4,97,8.20,96.0
6452,tt1396219,Outcast,2010,500+,613,75,176,90,2.8,30.0,,11,7,4,11,5.30,64.0
6453,tt0082377,The Final Conflict,1981,"10,000+",22094,535,1084,546,2.9,33.0,,21,6,15,21,4.30,29.0
6454,tt0090094,The Stuff,1985,"5,000+",7038,648,730,485,3.2,47.0,,15,11,4,15,6.40,73.0
6455,tt0109575,Death Machine,1994,500+,967,99,95,87,3.3,51.0,,2,0,2,2,,
6456,tt0092944,Eat the Rich,1987,"1,000+",1252,94,22,51,3.9,81.0,,11,4,7,11,6.00,36.0
6457,tt0116401,Generation X,1996,250+,344,21,62,27,2.6,25.0,,1,0,1,1,,
6458,tt0192255,The Little Vampire,2000,"50,000+",52369,712,576,767,3.5,55.0,,66,36,30,66,5.50,55.0
6459,tt0065462,Beneath the Planet of the Apes,1970,"10,000+",23931,1248,2032,849,3,38.0,,30,11,19,30,5.30,37.0
6460,tt0095303,High Season,1987,500+,825,2,14,3,2.4,12.0,,6,4,2,6,5.50,67.0
6461,tt0105162,Praying with Anger,1992,Fewer than 50,2,1,1,1,,,,0,0,0,0,,
6462,tt0085642,Hanna K.,1983,50+,59,9,4,0,4,69.0,,1,0,1,1,,
6463,tt0280760,Igby Goes Down,2002,"25,000+",44378,4215,1077,1630,3.9,80.0,,135,101,34,135,6.90,75.0
6464,tt0220099,The Tigger Movie,2000,"50,000+",57917,981,609,934,3.6,62.0,,73,45,28,73,5.90,62.0
6465,tt0258223,Stranger Inside,2001,500+,600,48,9,17,4.1,84.0,,1,1,0,1,,
6466,tt0457419,Mr. Magorium's Wonder Emporium,2007,"250,000+",328607,29261,23822,7867,3.4,55.0,,125,49,76,125,5.20,39.0
6467,tt1029172,The War on Democracy,2007,"1,000+",2389,371,56,232,4.1,87.0,,13,10,3,13,6.10,77.0
6468,tt0070679,Shaft in Africa,1973,"2,500+",3229,124,115,89,3.3,52.0,,14,9,5,14,5.30,64.0
6469,tt0061087,They're a Weird Mob,1966,250+,377,28,24,19,3.3,55.0,,1,1,0,1,,
6470,tt0454096,Caterpillar Wish,2006,500+,591,21,15,14,3.4,58.0,,3,1,2,3,,
6471,tt0093406,Les Patterson Saves the World,1987,50+,76,5,7,4,3,42.0,,0,0,0,0,,
6472,tt0100758,Teenage Mutant Ninja Turtles,1990,"50,000+",92187,2290,4556,2594,2.8,33.0,,32,6,26,32,4.10,19.0
6473,tt2087982,The Knife That Killed Me,2014,Fewer than 50,38,3,3,0,3.8,50.0,,4,3,1,4,,
6474,tt1029269,Beyond the Pole,2009,100+,190,18,25,16,3.4,42.0,,13,8,5,13,6.00,62.0
6475,tt0093780,The Principal,1987,"5,000+",7220,243,233,159,3.4,51.0,,9,4,5,9,5.10,44.0
6476,tt0091863,Rockabye,1986,Fewer than 50,15,1,2,2,,,,0,0,0,0,,
6477,tt0489007,Cow Belles,2006,"10,000+",19159,592,371,425,3.5,62.0,,4,2,2,4,,
6478,tt0118548,Absolute Power,1997,"25,000+",32420,1357,1272,557,3.3,52.0,,57,32,25,57,5.70,56.0
6479,tt0315431,Constellation,2005,"1,000+",2151,40,58,62,3,41.0,,19,0,19,19,3.40,0.0
6480,tt7238390,Charlie Chaplin,2002,0,0,0,0,0,,,,0,0,0,0,,
6481,tt0134033,Plunkett & Macleane,1999,"5,000+",7288,510,246,263,3.6,67.0,,29,7,22,29,4.60,24.0
6482,tt0207156,These Old Broads,2001,250+,292,19,24,11,3,44.0,,1,1,0,1,,
6483,tt0906727,Ball Don't Lie,2008,100+,171,7,4,1,3.5,64.0,,5,1,4,5,3.90,20.0
6484,tt1034303,Defiance,2008,"250,000+",251469,13751,5281,8015,3.7,72.0,,188,111,77,188,5.90,59.0
6485,tt0268695,The Time Machine,2002,"100,000+",171897,2333,3910,3623,2.9,37.0,,156,44,112,156,4.80,28.0
6486,tt0282108,Quo vadis,2001,500+,576,58,34,14,3.5,63.0,,3,3,0,3,,
6487,tt0367097,Straight-Jacket,2004,500+,916,28,35,31,3.2,44.0,,22,10,12,22,5.40,45.0
6488,tt0363768,Lightning Bug,2004,"1,000+",1247,95,52,59,3.6,65.0,,8,3,5,8,5.20,38.0
6489,tt2204379,The Devil's Carnival,2012,500+,958,310,130,96,3.7,70.0,,4,3,1,4,,
6490,tt0057168,I Could Go on Singing,1963,500+,976,71,24,51,3.9,75.0,,7,7,0,7,7.00,100.0
6491,tt0451803,Maine Pyaar Kyun Kiya,2005,500+,597,38,55,21,3,41.0,,1,0,1,1,,
6492,tt1014774,A Shine of Rainbows,2009,500+,662,166,70,64,3.8,70.0,,10,5,5,10,5.40,50.0
6493,tt0154143,Anand Aur Anand,1984,0,0,0,0,0,,,,0,0,0,0,,
6494,tt0118025,Uncle Sam,1996,"1,000+",2274,72,172,89,2.7,30.0,,10,6,4,10,5.10,60.0
6495,tt0102802,Rock-A-Doodle,1991,"25,000+",40096,853,692,1116,3.4,55.0,,15,3,12,15,4.00,20.0
6496,tt1355599,Stingray Sam,2009,100+,218,65,8,27,4.1,89.0,,3,3,0,3,,
6497,tt0244443,Buddha Mil Gaya,1971,0,0,0,0,0,,,,0,0,0,0,,
6498,tt0091051,A Fine Mess,1986,"1,000+",2083,19,35,27,2.9,35.0,,8,2,6,8,4.70,25.0
6499,tt0375880,Kaadhal Konden,2003,Fewer than 50,1,1,0,0,,,,0,0,0,0,,
6500,tt0321494,Bollywood Queen,2002,"1,000+",1343,30,44,38,2.8,41.0,,7,5,2,7,6.00,71.0
6501,tt0448157,Hancock,2008,"250,000+",557502,62986,43172,42308,3.5,59.0,,227,95,132,227,5.40,42.0
6502,tt1431181,Another Year,2010,"10,000+",20705,3008,1065,1223,3.7,74.0,,173,160,13,173,8.20,92.0
6503,tt0167247,The Land Before Time VI: The Secret of Saurus Rock,1998,"25,000+",37010,153,218,229,3.1,41.0,,1,0,1,1,,
6504,tt0314676,The Singing Detective,2003,"5,000+",7651,330,500,318,3,40.0,,108,42,66,108,5.10,39.0
6505,tt0096289,Torch Song Trilogy,1988,"5,000+",5717,671,66,291,4.3,91.0,,22,17,5,22,6.30,77.0
6506,tt0250440,Daria in 'Is It Fall Yet?',2000,250+,388,127,18,18,4.1,88.0,,0,0,0,0,,
6507,tt0101523,The Butcher's Wife,1991,"5,000+",7645,125,298,107,2.8,30.0,,17,4,13,17,4.50,24.0
6508,tt0102525,Never Forget,1991,Fewer than 50,39,4,5,2,3.2,44.0,,0,0,0,0,,
6509,tt0106488,Broken Promises: Taking Emily Back,1993,Fewer than 50,45,1,2,0,,,,0,0,0,0,,
6510,tt0247394,Gumnaam,1965,250+,375,24,12,15,3.6,67.0,,1,0,1,1,,
6511,tt0186151,Frequency,2000,"100,000+",136036,7370,1699,3413,3.9,81.0,,127,89,38,127,6.50,70.0
6512,tt0429493,The A-Team,2010,"100,000+",199553,28489,14987,12463,3.6,66.0,,220,107,113,220,5.40,49.0
6513,tt0107322,King of the Hill,1993,"5,000+",5266,489,96,120,3.9,84.0,,33,30,3,33,7.80,91.0
6514,tt1268799,A Very Harold & Kumar 3D Christmas,2011,"25,000+",44295,9290,6548,2442,3.5,59.0,,129,88,41,129,6.20,68.0
6515,tt0429153,Tara Road,2005,"1,000+",1926,114,159,131,3.1,42.0,,0,0,0,0,,
6516,tt1612774,Rubber,2010,"10,000+",14013,2483,2894,1619,3,46.0,,89,60,29,89,6.00,67.0
6517,tt0139668,True Crime,1999,"10,000+",15133,669,689,281,3.2,49.0,,41,23,18,41,6.00,56.0
6518,tt1295085,Gifted Hands: The Ben Carson Story,2009,"1,000+",1929,689,123,206,4.1,85.0,,1,1,0,1,,
6519,tt0070165,Heavy Traffic,1973,"1,000+",2009,234,81,114,3.9,74.0,,18,16,2,18,7.00,89.0
6520,tt1535467,Patiala House,2011,250+,444,116,114,62,3.3,50.0,,3,1,2,3,,
6521,tt0386741,Renaissance,2006,"25,000+",26027,1738,1184,1609,3.4,59.0,,78,39,39,78,5.50,50.0
6522,tt0218533,Pukar,2000,"1,000+",1163,36,28,15,3.5,56.0,,0,0,0,0,,
6523,tt0288040,Hatred of a Minute,2002,100+,101,0,7,7,1.6,0.0,,0,0,0,0,,
6524,tt0438097,Ice Age 2: The Meltdown,2006,"250,000+",854714,35258,14684,25748,3.7,71.0,,146,82,64,146,6.00,56.0
6525,tt0481370,Nuvvu Nenu,2001,0,0,0,0,0,,,,0,0,0,0,,
6526,tt0454065,La antena,2007,"1,000+",1955,389,68,165,4,85.0,,10,6,4,10,5.80,60.0
6527,tt0104187,Encino Man,1992,"100,000+",124900,2733,2170,2719,3.4,56.0,,35,5,30,35,3.40,14.0
6528,tt1239427,Brothers at War,2009,"1,000+",2163,79,37,38,3.7,68.0,,20,14,6,20,5.70,70.0
6529,tt1303829,Diverted,2009,50+,58,8,11,4,2.8,42.0,,0,0,0,0,,
6530,tt0914837,44 Inch Chest,2009,"10,000+",13576,544,968,631,2.8,36.0,,82,33,49,82,5.20,40.0
6531,tt0155530,Bandhan,1969,0,0,0,0,0,,,,0,0,0,0,,
6532,tt0087078,Conan the Destroyer,1984,"50,000+",60721,1941,3127,1552,3,38.0,,27,7,20,27,4.40,26.0
6533,tt1456915,Villa Estrella,2009,50+,68,5,6,7,3,45.0,,0,0,0,0,,
6534,tt0272118,Haathi Mere Saathi,1971,50+,51,8,3,0,4.1,73.0,,0,0,0,0,,
6535,tt0293662,The Transporter,2002,"250,000+",312290,24641,9024,10800,3.7,73.0,,128,69,59,128,5.70,54.0
6536,tt0061553,The Day the Fish Came Out,1967,50+,75,7,10,3,3.1,41.0,,0,0,0,0,,
6537,tt4971256,Anbudan,2000,0,0,0,0,0,,,,0,0,0,0,,
6538,tt0117099,Mr. Bechara,1996,0,0,0,0,0,,,,0,0,0,0,,
6539,tt1020885,Lesbian Vampire Killers,2009,"5,000+",6346,821,1727,1170,2.7,32.0,,25,7,18,25,4.10,28.0
6540,tt0056412,Ride the High Country,1962,"2,500+",4098,489,100,194,4,83.0,,19,17,2,19,8.20,89.0
6541,tt0069483,The War Between Men and Women,1972,50+,63,5,11,8,3.1,31.0,,2,2,0,2,,
6542,tt0365265,Ginger Snaps Back: The Beginning,2004,"10,000+",22892,778,648,682,3.4,55.0,,5,3,2,5,6.30,60.0
6543,tt0225573,The Dukes of Hazzard: Hazzard in Hollywood,2000,"1,000+",2420,107,17,40,4.3,86.0,,0,0,0,0,,
6544,tt0430217,Bearing Witness,2005,100+,192,3,0,1,,,,1,1,0,1,,
6545,tt0308347,Haan Maine Bhi Pyaar Kiya,2002,250+,321,9,16,5,2.6,36.0,,0,0,0,0,,
6546,tt0080120,The Warriors,1979,"50,000+",76383,15560,2069,5877,4.2,88.0,,50,44,6,50,7.40,88.0
6547,tt0118926,The Dancer Upstairs,2002,"2,500+",4851,456,143,181,3.8,76.0,,114,73,41,114,6.40,64.0
6548,tt0252235,Appula Appa Rao,1991,0,0,0,0,0,,,,0,0,0,0,,
6549,tt0783235,Booky Makes Her Mark,2006,250+,372,3,4,4,3.1,43.0,,0,0,0,0,,
6550,tt0098994,"After Dark, My Sweet",1990,"1,000+",1639,146,92,57,3.5,61.0,,20,16,4,20,6.50,80.0
6551,tt0113986,Nine Months,1995,"50,000+",60608,1383,2355,1080,3,37.0,,33,9,24,33,4.80,27.0
6552,tt0111080,Savate,1995,250+,269,9,15,13,3,38.0,,0,0,0,0,,
6553,tt0356159,Hellbent,2004,"1,000+",1926,114,158,131,3,42.0,,44,21,23,44,5.60,48.0
6554,tt0310851,The Case of the Whitechapel Vampire,2002,Fewer than 50,35,6,8,0,2.8,43.0,,0,0,0,0,,
6555,tt0061401,The Big Mouth,1967,50+,55,11,9,9,3.3,55.0,,5,2,3,5,4.70,40.0
6556,tt0063035,The Green Berets,1968,"5,000+",9649,656,414,365,3.5,61.0,,13,3,10,13,4.20,23.0
6557,tt0060862,The Professionals,1966,"2,500+",3994,469,105,187,3.8,82.0,,19,17,2,19,7.40,89.0
6558,tt0426459,Feast,2005,"10,000+",20808,2186,1485,1857,3.4,60.0,,56,31,25,56,5.80,55.0
6559,tt0784979,Cash and Curry,2008,0,0,0,0,0,,,,0,0,0,0,,
6560,tt0275575,Orukkam,1990,0,0,0,0,0,,,,0,0,0,0,,
6561,tt0071240,Born Innocent,1974,"1,000+",1778,35,28,24,3.6,56.0,,0,0,0,0,,
6562,tt0837791,The Devil's Chair,2007,500+,816,99,204,162,2.7,33.0,,5,3,2,5,5.50,60.0
6563,tt1537759,Dug's Special Mission,2009,100+,179,72,33,18,3.7,69.0,,0,0,0,0,,
6564,tt0067840,Tere Mere Sapne,1971,50+,62,1,1,0,,,,0,0,0,0,,
6565,tt0100530,The Russia House,1990,"5,000+",7988,355,366,163,3.3,49.0,,20,14,6,20,6.60,70.0
6566,tt4944374,Chanakya,2005,0,0,0,0,0,,,,0,0,0,0,,
6567,tt0117609,Sgt. Kabukiman N.Y.P.D.,1990,"1,000+",1064,158,120,110,3.5,57.0,,3,2,1,3,,
6568,tt1039614,Iron Cross,2009,50+,77,5,4,4,3.4,56.0,,3,2,1,3,,
6569,tt0356443,The Bridge of San Luis Rey,2004,"1,000+",1941,79,144,63,2.6,36.0,,24,1,23,24,3.00,4.0
6570,tt0093991,Slave Girls from Beyond Infinity,1987,"1,000+",1117,20,33,28,2.8,38.0,,1,0,1,1,,
6571,tt0078358,Take Down,1979,100+,198,6,4,4,3.6,60.0,,0,0,0,0,,
6572,tt0116448,The Great White Hype,1996,"5,000+",7850,256,483,165,2.9,35.0,,24,10,14,24,4.90,42.0
6573,tt0417001,Must Love Dogs,2005,"100,000+",197869,3103,3066,3267,3.3,50.0,,150,55,95,150,5.00,37.0
6574,tt0834927,Magic Flute Diaries,2008,50+,68,0,1,1,,,,0,0,0,0,,
6575,tt0059927,The Yellow Rolls-Royce,1964,500+,653,74,52,41,3.4,58.0,,0,0,0,0,,
6576,tt0250227,Ayirathil Oruvan,1965,100+,246,66,24,32,4,73.0,,1,1,0,1,,
6577,tt0053946,Inherit the Wind,1960,"5,000+",9681,1750,181,658,4.3,91.0,,27,25,2,27,8.10,93.0
6578,tt0090556,"'night, Mother",1986,"1,000+",2475,195,34,106,4.2,85.0,,5,4,1,5,7.00,80.0
6579,tt0270707,The Truth About Charlie,2002,"10,000+",10152,259,691,330,2.6,27.0,,135,46,89,135,4.80,34.0
6580,tt1740662,Benny and Babloo,2010,Fewer than 50,1,1,0,0,,,,0,0,0,0,,
6581,tt1325702,Journey from Zanskar,2010,50+,84,5,2,2,3.4,71.0,,10,9,1,10,7.40,90.0
6582,tt0208101,Don't Look Under the Bed,1999,500+,868,182,84,61,3.8,68.0,,2,2,0,2,,
6583,tt0065261,Ådalen 31,1969,Fewer than 50,2,2,0,0,,,,8,7,1,8,7.80,88.0
6584,tt0109254,Beverly Hills Cop III,1994,"10,000+",17083,1758,3238,2225,2.9,35.0,,56,6,50,56,3.90,11.0
6585,tt0832971,Vanaja,2006,"1,000+",1781,95,18,61,4,84.0,,28,24,4,28,7.00,86.0
6586,tt0451073,A Halfway House Christmas,2005,50+,65,1,3,3,,,,0,0,0,0,,
6587,tt0107969,Rising Sun,1993,"25,000+",35876,861,1313,502,3.1,40.0,,40,13,27,40,5.10,33.0
6588,tt0187078,Gone in Sixty Seconds,2000,"250,000+",955548,37519,11470,23818,3.9,77.0,,139,35,104,139,4.40,25.0
6589,tt0451197,The Sickhouse,2008,500+,525,34,125,99,2.4,21.0,,1,0,1,1,,
6590,tt0084110,I Was a Mail Order Bride,1982,0,0,0,0,0,,,,0,0,0,0,,
6591,tt0054873,A Fever in the Blood,1961,0,0,0,0,0,,,,0,0,0,0,,
6592,tt0112818,Dead Man Walking,1995,"50,000+",61979,7309,1239,1962,4,86.0,,61,58,3,61,8.20,95.0
6593,tt0445056,Sheesha,2005,50+,66,4,5,1,2.8,44.0,,0,0,0,0,,
6594,tt1049415,Garbage Dreams,2009,100+,107,24,7,9,3.8,77.0,,10,10,0,10,7.20,100.0
6595,tt0477392,Broken Bridges,2006,"10,000+",20346,1234,192,812,4.3,87.0,,21,1,20,21,3.60,5.0
6596,tt0382734,Harvie Krumpet,2003,"2,500+",3967,447,54,156,4.2,89.0,,1,1,0,1,,
6597,tt0096870,Going Overboard,1989,"10,000+",12480,92,747,419,1.5,11.0,,3,0,3,3,,
6598,tt0065797,The Great White Hope,1970,500+,603,75,37,54,3.6,67.0,,7,3,4,7,5.60,43.0
6599,tt0132000,Cannibal Hookers,1987,Fewer than 50,4,2,1,1,,,,0,0,0,0,,
6600,tt0123197,Northern Lights,1997,250+,377,67,68,34,3.1,50.0,,0,0,0,0,,
6601,tt0066811,The Barefoot Executive,1971,"1,000+",1631,61,66,29,3.4,48.0,,6,5,1,6,6.40,83.0
6602,tt0120390,Turbulence,1997,"2,500+",2866,118,494,135,2.4,19.0,,19,3,16,19,3.80,16.0
6603,tt0061587,Navajo Joe,1966,500+,824,112,97,79,3.3,54.0,,3,2,1,3,,
6604,tt0070304,Letters from Three Lovers,1973,0,0,0,0,0,,,,0,0,0,0,,
6605,tt0067491,Night of Dark Shadows,1971,500+,664,36,53,46,3.1,40.0,,2,0,2,2,,
6606,tt1598547,Ividam Swargamanu,2009,0,0,0,0,0,,,,0,0,0,0,,
6607,tt0201694,Longshot,2001,250+,313,16,16,8,3.1,50.0,,2,0,2,2,,
6608,tt0117998,Twister,1996,"250,000+",894590,16425,11976,21373,3.5,58.0,,71,45,26,71,6.10,63.0
6609,tt0117991,Twelfth Night or What You Will,1996,50+,59,1,0,0,,,,0,0,0,0,,
6610,tt0462346,How to Eat Fried Worms,2006,"25,000+",48522,765,879,905,3.2,47.0,,76,46,30,76,6.10,61.0
6611,tt0945513,Source Code,2011,"100,000+",125958,48106,10846,12318,3.9,82.0,,266,244,22,266,7.50,92.0
6612,tt0087004,The Brother from Another Planet,1984,"2,500+",4523,416,139,192,3.7,75.0,,28,25,3,28,7.10,89.0
6613,tt0066986,Desperate Characters,1971,50+,77,4,6,5,3.2,40.0,,3,3,0,3,,
6614,tt0057318,Mondo cane,1962,"1,000+",1217,136,121,93,3.3,52.0,,10,5,5,10,6.00,50.0
6615,tt1667852,Pokkiri Raja,2010,100+,122,4,2,2,3.2,67.0,,0,0,0,0,,
6616,tt0217107,Trois,2000,"1,000+",1284,83,35,37,3.9,70.0,,4,0,4,4,,
6617,tt0337610,Dot.Kill,2005,"1,000+",1210,8,38,15,2.2,17.0,,1,0,1,1,,
6618,tt0107321,King Uncle,1993,500+,829,28,43,18,2.9,39.0,,0,0,0,0,,
6619,tt0094898,Coming to America,1988,"250,000+",268635,21351,3852,9620,4.1,85.0,,56,41,15,56,6.20,73.0
6620,tt0100666,Spaced Invaders,1990,"5,000+",6590,208,197,216,3.3,51.0,,12,1,11,12,3.80,8.0
6621,tt0120202,State and Main,2000,"5,000+",8460,1055,450,395,3.6,70.0,,118,100,18,118,7.30,85.0
6622,tt0107057,Guilty as Sin,1993,"2,500+",2767,58,111,41,2.9,34.0,,16,6,10,16,5.30,38.0
6623,tt0109922,Gopi Kishan,1994,0,0,0,0,0,,,,0,0,0,0,,
6624,tt1606259,Knuckle,2011,"2,500+",2784,444,216,99,3.6,67.0,,44,41,3,44,6.60,93.0
