,imdb_id,movie_name,release_year,audience_banded_rating_count,audience_rating_count,audience_liked_count,audience_not_liked_count,audience_review_count,audience_avg_rating,audience_score,tomato_banded_rating_count,tomato_rating_count,tomato_liked_count,tomato_not_liked_count,tomato_review_count,tomato_avg_rating,tomato_score
0,tt0059729,The Slender Thread,1965,250+,367,46,16,21,3.8,74.0,,7,5,2,7,3.8,71.0
1,tt0094484,In the Heat of the Night,1967,"10,000+",23329,3645,306,1196,4.2,92.0,,90,86,4,90,4.2,96.0
2,tt0058886,The Agony and the Ecstasy,1965,"2,500+",3573,360,100,129,3.8,78.0,,7,6,1,7,3.8,86.0
3,tt0059573,A Patch of Blue,1965,"5,000+",5805,715,72,286,4.3,91.0,,9,8,1,9,4.3,89.0
4,tt0060934,The Sand Pebbles,1966,"5,000+",5669,668,94,264,4.1,88.0,,19,16,3,19,4.1,84.0
5,tt0061722,The Graduate,1967,"100,000+",183862,21821,2493,6996,4.2,90.0,,88,76,12,88,4.2,86.0
6,tt0059113,Doctor Zhivago,1965,"25,000+",45894,6217,864,2066,4.2,88.0,,50,41,9,50,4.2,82.0
7,tt0060665,A Man for All Seasons,1966,"5,000+",9813,1846,273,717,4.2,87.0,,82,73,9,82,4.2,89.0
8,tt0060921,The Russians Are Coming the Russians Are Coming,1966,"2,500+",4789,485,162,221,3.8,75.0,,22,19,3,22,3.8,86.0
9,tt0061184,Who's Afraid of Virginia Woolf?,1966,"10,000+",21785,4241,450,1455,4.3,90.0,,45,43,2,45,4.3,96.0
10,tt0060086,Alfie,1966,"10,000+",14703,1200,370,502,3.8,76.0,,29,28,1,29,3.8,97.0
11,tt0061418,Bonnie and Clyde,1967,"50,000+",56723,7501,1052,2374,4.1,88.0,,68,61,7,68,4.1,90.0
12,tt0061735,Guess Who's Coming to Dinner,1967,"25,000+",38363,3762,642,1489,4.1,85.0,,38,27,11,38,4.1,71.0
13,tt0064513,John and Mary,1969,500+,506,58,53,33,3.4,52.0,,13,5,8,13,3.4,38.0
14,tt0063462,The Producers,1968,"50,000+",56213,6362,1117,2618,4.1,85.0,,74,67,7,74,4.1,91.0
15,tt0064030,Anne of the Thousand Days,1969,"2,500+",3303,419,88,182,4,83.0,,14,6,8,14,4,43.0
16,tt0064471,"If It's Tuesday, This Must Be Belgium",1969,250+,492,44,31,26,3.5,59.0,,6,4,2,6,3.5,67.0
17,tt0063227,The Lion in Winter,1968,"10,000+",13156,2100,233,896,4.4,90.0,,43,39,4,43,4.4,91.0
18,tt0064115,Butch Cassidy and the Sundance Kid,1969,"50,000+",71375,13052,1105,3902,4.3,92.0,,58,52,6,58,4.3,90.0
19,tt1204507,The Fixer,1968,250+,290,18,11,9,3.7,62.0,,9,5,4,9,3.7,56.0
20,tt0062794,Charly,1968,"2,500+",3862,263,162,149,3.5,62.0,,20,11,9,20,3.5,55.0
21,tt0063522,Rosemary's Baby,1968,"50,000+",74232,14149,2148,4074,4.1,87.0,,84,81,3,84,4.1,96.0
22,tt0064665,Midnight Cowboy,1969,"25,000+",40162,7090,975,2298,4.2,88.0,,116,103,13,116,4.2,89.0
23,tt0066011,Love Story,1970,"25,000+",35361,2670,908,1386,3.9,75.0,,29,19,10,29,3.9,66.0
24,tt0044008,Scrooge,1970,"5,000+",9233,642,128,340,4.1,83.0,,20,15,5,20,4.1,75.0
25,tt0065724,Five Easy Pieces,1970,"10,000+",13237,2668,506,889,4,84.0,,55,49,6,55,4,89.0
26,tt0068098,M*A*S*H,1970,"50,000+",53253,5196,1098,1995,4,83.0,,58,49,9,58,4,84.0
27,tt0068240,Avanti!,1972,"2,500+",3319,320,100,108,3.8,76.0,,24,19,5,24,3.8,79.0
28,tt0068327,Cabaret,1972,"25,000+",36210,4661,720,1765,4.2,87.0,,48,44,4,48,4.2,92.0
29,tt0067217,The Hospital,1971,"1,000+",2131,320,114,152,3.7,74.0,,14,14,0,14,3.7,100.0
30,tt0068611,Frenzy,1972,"10,000+",12718,2227,644,820,3.8,78.0,,43,39,4,43,3.8,91.0
31,tt0068646,The Godfather,1972,"250,000+",735966,163916,3728,40976,4.8,98.0,,151,147,4,151,4.8,97.0
32,tt0067116,The French Connection,1971,"25,000+",44588,7637,1160,2333,4.1,87.0,,93,89,4,93,4.1,96.0
33,tt0408839,The Heartbreak Kid,1972,"1,000+",2068,229,84,98,3.7,73.0,,60,55,5,60,3.7,92.0
34,tt2328900,Mary Queen of Scots,1971,500+,656,93,76,70,3.4,55.0,,9,6,3,9,3.4,67.0
35,tt0067309,Klute,1971,"5,000+",6781,1160,296,398,3.8,80.0,,44,41,3,44,3.8,93.0
36,tt0067314,Kotch,1971,500+,971,57,27,42,3.5,68.0,,8,6,2,8,3.5,75.0
37,tt0069883,Cinderella Liberty,1973,"1,000+",1144,50,29,33,3.6,63.0,,9,5,4,9,3.6,56.0
38,tt0068473,Deliverance,1972,"25,000+",49561,6833,1522,2875,3.9,82.0,,66,59,7,66,3.9,89.0
39,tt0069947,The Day of the Jackal,1973,"5,000+",9026,1722,230,545,4.1,88.0,,31,28,3,31,4.1,90.0
40,tt0070735,The Sting,1973,"50,000+",61952,12218,652,3591,4.4,95.0,,108,100,8,108,4.4,93.0
41,tt0073486,One Flew Over the Cuckoo's Nest,1975,"250,000+",280364,61765,2478,14958,4.5,96.0,,120,112,8,120,4.5,93.0
42,tt0070819,A Touch of Class,1973,"1,000+",2043,88,49,44,3.5,65.0,,13,11,2,13,3.5,85.0
43,tt0071562,The Godfather Part II,1974,"250,000+",412718,85914,2451,18710,4.7,97.0,,125,120,5,125,4.7,96.0
44,tt0071315,Chinatown,1974,"50,000+",78347,22145,1730,5247,4.4,93.0,,79,78,1,79,4.4,99.0
45,tt0072890,Dog Day Afternoon,1975,"100,000+",110532,16385,1841,3865,4.2,90.0,,54,52,2,54,4.2,96.0
46,tt0072417,A Woman Under the Influence,1974,"5,000+",8270,1927,186,573,4.4,91.0,,35,31,4,35,4.4,89.0
47,tt0072308,The Towering Inferno,1974,"25,000+",28422,1989,783,990,3.7,72.0,,37,25,12,37,3.7,68.0
48,tt0073195,Jaws,1975,"250,000+",946650,57311,6037,35382,4.4,90.0,,101,98,3,101,4.4,97.0
49,tt0071360,The Conversation,1974,"25,000+",35379,7108,845,2024,4.2,89.0,,71,69,2,71,4.2,97.0
50,tt0074119,All the President's Men,1976,"50,000+",50500,8045,703,2255,4.3,92.0,,71,67,4,71,4.3,94.0
51,tt0073766,The Sunshine Boys,1975,"1,000+",2476,218,83,78,3.7,72.0,,38,27,11,38,3.7,71.0
52,tt0075148,Rocky,1976,"250,000+",33403994,74632,33408,1432746,3.2,69.0,,72,66,6,72,3.2,92.0
53,tt0074860,Marathon Man,1976,"10,000+",22690,3226,761,1127,3.8,81.0,,47,38,9,47,3.8,81.0
54,tt0076095,The Goodbye Girl,1977,"5,000+",7526,969,178,426,4,85.0,,25,20,5,25,4,80.0
55,tt0074958,Network,1976,"25,000+",36527,8996,676,3222,4.4,93.0,,75,69,6,75,4.4,92.0
56,tt0075314,Taxi Driver,1976,Fewer than 50,7,6,1,0,4.1,86.0,,0,0,0,0,4.1,
57,tt0075686,Annie Hall,1977,"100,000+",153991,23616,1974,6518,4.4,92.0,,127,123,4,127,4.4,97.0
58,tt0075406,Voyage of the Damned,1976,250+,496,62,55,33,3.3,53.0,,13,10,3,13,3.3,77.0
59,tt0075860,Close Encounters of the Third Kind,1977,"100,000+",142444,14421,2616,4861,4.1,85.0,,70,66,4,70,4.1,94.0
60,tt0077928,Midnight Express,1978,"25,000+",31219,4957,604,1416,4.2,89.0,,30,27,3,30,4.2,90.0
61,tt0076843,The Turning Point,1977,"2,500+",2880,231,113,114,3.6,67.0,,27,17,10,27,3.6,63.0
62,tt0077416,The Deer Hunter,1978,"100,000+",103845,21327,1995,5783,4.3,91.0,,132,114,18,132,4.3,86.0
63,tt0077578,Foul Play,1978,"5,000+",8186,809,374,389,3.7,68.0,,27,20,7,27,3.7,74.0
64,tt0078444,An Unmarried Woman,1978,"1,000+",1833,188,70,84,3.7,73.0,,28,25,3,28,3.7,89.0
65,tt0078841,Being There,1979,"25,000+",25219,5287,471,1745,4.3,92.0,,62,59,3,62,4.3,95.0
66,tt0078966,The China Syndrome,1979,"5,000+",8961,1281,309,448,3.8,81.0,,40,35,5,40,3.8,88.0
67,tt0077742,Interiors,1978,"5,000+",7693,1323,355,453,3.9,79.0,,17,13,4,17,3.9,76.0
68,tt0078902,Breaking Away,1979,"5,000+",9399,1934,266,640,4.2,88.0,,42,40,2,42,4.2,95.0
69,tt0079417,Kramer vs. Kramer,1979,"25,000+",43628,7104,879,1953,4.1,89.0,,101,90,11,101,4.1,89.0
70,tt0081237,The Ninth Configuration,1980,"2,500+",2619,397,130,220,3.9,75.0,,16,13,3,16,3.9,81.0
71,tt0081398,Raging Bull,1980,"100,000+",131880,26514,2044,7200,4.4,93.0,,149,137,12,149,4.4,92.0
72,tt0081568,The Stunt Man,1980,"2,500+",3920,461,170,222,3.8,73.0,,43,39,4,43,3.8,91.0
73,tt0079638,Norma Rae,1979,"5,000+",7213,656,173,221,3.8,79.0,,32,29,3,32,3.8,91.0
74,tt0082846,On Golden Pond,1981,"10,000+",20647,2431,377,936,4.1,87.0,,44,40,4,44,4.1,91.0
75,tt0080678,The Elephant Man,1980,Fewer than 50,48,14,2,1,3.9,88.0,,0,0,0,0,3.9,
76,tt0081283,Ordinary People,1980,"10,000+",23315,3745,494,1363,4.2,88.0,,104,93,11,104,4.2,89.0
77,tt0081974,Absence of Malice,1981,"2,500+",4621,416,243,170,3.5,63.0,,27,22,5,27,3.5,81.0
78,tt0082405,The Four Seasons,1981,"2,500+",2911,168,56,90,3.9,75.0,,17,13,4,17,3.9,76.0
79,tt0082979,Reds,1981,"5,000+",9043,1645,352,618,4,82.0,,49,44,5,49,4,90.0
80,tt0084805,Tootsie,1982,"50,000+",58673,6271,1443,2154,3.9,81.0,,53,48,5,53,3.9,91.0
81,tt0084855,The Verdict,1982,"10,000+",10475,2434,328,749,4.1,88.0,,37,33,4,37,4.1,89.0
82,tt0083866,E.T. the Extra-Terrestrial,1982,"250,000+",32314349,82689,32311,1318882,3.5,72.0,,145,143,2,145,3.5,99.0
83,tt0085478,Educating Rita,1983,"5,000+",7872,979,231,418,3.9,81.0,,17,14,3,17,3.9,82.0
84,tt0082416,The French Lieutenant's Woman,1981,"5,000+",6933,639,315,248,3.6,67.0,,29,24,5,29,3.6,83.0
85,tt0086425,Terms of Endearment,1983,"25,000+",36434,4179,834,1530,4,83.0,,109,89,20,109,4,82.0
86,tt0085244,The Big Chill,1983,"10,000+",22403,2643,789,1004,3.9,77.0,,41,29,12,41,3.9,71.0
87,tt0087553,The Killing Fields,1984,"10,000+",23190,3540,331,1093,4.2,91.0,,43,40,3,43,4.2,93.0
88,tt0086879,Amadeus,1984,"100,000+",180470,24046,1328,7757,4.5,95.0,,153,136,17,153,4.5,89.0
89,tt4247618,The Dresser,1983,"1,000+",1818,252,40,90,4,86.0,,15,15,0,15,4,100.0
90,tt0087892,A Passage to India,1984,"5,000+",6973,943,254,351,3.8,79.0,,28,22,6,28,3.8,79.0
91,tt0088763,Back to the Future,1985,"250,000+",1097197,106004,6169,39791,4.5,94.0,,110,102,8,110,4.5,93.0
92,tt0088146,A Soldier's Story,1984,"5,000+",6530,524,118,147,3.9,82.0,,22,20,2,22,3.9,91.0
93,tt0090329,Witness,1985,"25,000+",46965,4802,1198,1508,3.9,80.0,,45,42,3,45,3.9,93.0
94,tt0089841,Prizzi's Honor,1985,"5,000+",7954,822,501,323,3.4,62.0,,41,35,6,41,3.4,85.0
95,tt0087921,Places in the Heart,1984,"5,000+",6770,725,149,244,4,83.0,,38,34,4,38,4,89.0
96,tt0089755,Out of Africa,1985,"25,000+",40442,5959,1271,2101,4.1,82.0,,89,56,33,89,4.1,63.0
97,tt0089853,The Purple Rose of Cairo,1985,"10,000+",20423,3803,534,962,4.1,88.0,,41,38,3,41,4.1,93.0
98,tt0091167,Hannah and Her Sisters,1986,"25,000+",31172,5582,601,1335,4.2,90.0,,57,52,5,57,4.2,91.0
99,tt0091763,Platoon,1986,"100,000+",240410,36055,2723,9646,4.3,93.0,,123,110,13,123,4.3,89.0
100,tt0090756,Blue Velvet,1986,"50,000+",77324,18730,2493,5552,4.2,88.0,,83,79,4,83,4.2,95.0
101,tt28097834,The Mission,1986,"25,000+",38966,5179,775,1793,4.2,87.0,,29,19,10,29,4.2,66.0
102,tt0093565,Moonstruck,1987,"25,000+",44979,4807,1167,1949,4,80.0,,74,68,6,74,4,92.0
103,tt0092699,Broadcast News,1987,"10,000+",11092,1975,529,623,3.9,79.0,,57,56,1,57,3.9,98.0
104,tt0093389,The Last Emperor,1987,"25,000+",40075,4999,686,1380,4.1,88.0,,124,107,17,124,4.1,86.0
105,tt0093223,House of Games,1987,"5,000+",6540,1099,289,463,3.9,79.0,,29,28,1,29,3.9,97.0
106,tt0095953,Rain Man,1988,"250,000+",314537,30188,3177,9851,4.2,90.0,,137,121,16,137,4.2,88.0
107,tt0095647,Mississippi Burning,1988,"25,000+",39624,4715,523,1310,4.1,90.0,,28,22,6,28,4.1,79.0
108,tt0093209,Hope and Glory,1987,"5,000+",5833,670,147,241,4,82.0,,26,25,1,26,4,96.0
109,tt1666540,A Cry in the Dark,1988,"5,000+",8019,531,192,264,3.7,73.0,,32,30,2,32,3.7,94.0
110,tt0096018,Running on Empty,1988,"10,000+",10490,1925,874,449,3.7,69.0,,31,25,6,31,3.7,81.0
111,tt0097165,Dead Poets Society,1989,"250,000+",307794,45930,3883,13544,4.3,92.0,,63,53,10,63,4.3,84.0
112,tt0096969,Born on the Fourth of July,1989,"50,000+",59514,5357,1666,1697,3.8,76.0,,56,47,9,56,3.8,84.0
113,tt0096463,Working Girl,1988,"25,000+",33681,2629,1285,986,3.6,67.0,,47,39,8,47,3.6,83.0
114,tt0097216,Do the Right Thing,1989,"50,000+",73982,10328,1217,3384,4.3,89.0,,108,99,9,108,4.3,92.0
115,tt0098724,"Sex, Lies, and Videotape",1989,"25,000+",32696,3700,991,1071,3.9,79.0,,54,52,2,54,3.9,96.0
116,tt0099685,Goodfellas,1990,"250,000+",431307,117712,3434,29247,4.6,97.0,,161,152,9,161,4.6,94.0
117,tt0098635,When Harry Met Sally...,1989,"250,000+",396395,31608,4066,12285,4.2,89.0,,79,72,7,79,4.2,91.0
118,tt0103074,Thelma & Louise,1991,"100,000+",170526,10330,2255,3591,4,82.0,,153,132,21,153,4,86.0
119,tt13261268,Avalon,1990,"2,500+",3259,318,91,114,4,78.0,,28,24,4,28,4,86.0
120,tt0097441,Glory,1989,"50,000+",60467,11636,895,3618,4.3,93.0,,55,52,3,55,4.3,95.0
121,tt0099348,Dances with Wolves,1990,"100,000+",214037,18565,2843,7034,4.2,87.0,,131,114,17,131,4.2,87.0
122,tt0101516,Bugsy,1991,"10,000+",10285,1099,491,369,3.6,69.0,,64,54,10,64,3.6,84.0
123,tt0100486,Reversal of Fortune,1990,"5,000+",5494,717,205,228,3.8,78.0,,53,49,4,53,3.8,92.0
124,tt0099674,The Godfather Part III,1990,"250,000+",261914,434,220,100,3.5,66.0,,68,45,23,68,3.5,66.0
125,tt0102926,The Silence of the Lambs,1991,"250,000+",848625,85982,4183,29637,4.4,95.0,,153,145,8,153,4.4,95.0
126,tt0101969,Grand Canyon,1991,"5,000+",7638,789,334,293,3.7,70.0,,37,29,8,37,3.7,78.0
127,tt0107822,The Piano,1993,"25,000+",48590,8471,1395,2363,4.1,86.0,,71,64,7,71,4.1,90.0
128,tt0108052,Schindler's List,1993,"250,000+",413183,82246,2643,22968,4.6,97.0,,134,131,3,134,4.6,98.0
129,tt0104257,A Few Good Men,1992,"250,000+",325846,17938,2222,8917,4.1,89.0,,69,58,11,69,4.1,84.0
130,tt0105323,Scent of a Woman,1992,"100,000+",119641,17495,1475,5064,4.3,92.0,,48,41,7,48,4.3,85.0
131,tt0105151,The Player,1992,"10,000+",20712,3372,626,901,4,84.0,,68,66,2,68,4,97.0
132,tt0104454,Howards End,1992,"10,000+",13748,1884,431,537,4,81.0,,69,65,4,69,4,94.0
133,tt0105695,Unforgiven,1992,"100,000+",123281,22112,1567,6491,4.4,93.0,,110,106,4,110,4.4,96.0
134,tt0102138,JFK,1991,"50,000+",62793,10165,1345,3464,4.2,88.0,,70,59,11,70,4.2,84.0
135,tt0109830,Forrest Gump,1994,"250,000+",1244237,170818,8770,92568,4.1,95.0,,108,77,31,108,4.1,71.0
136,tt0110912,Pulp Fiction,1994,"250,000+",1130319,228493,9056,62525,4.6,96.0,,116,107,9,116,4.6,92.0
137,tt0107943,The Remains of the Day,1993,"10,000+",24488,4102,482,1128,4.2,89.0,,47,45,2,47,4.2,96.0
138,tt0108122,Short Cuts,1993,"10,000+",22777,3510,461,966,4.2,88.0,,60,57,3,60,4.2,95.0
139,tt0111161,The Shawshank Redemption,1994,"250,000+",889823,176662,2776,53482,4.7,98.0,,82,75,7,82,4.7,91.0
140,tt0109831,Four Weddings and a Funeral,1994,"100,000+",185233,8230,2919,3642,3.8,74.0,,73,70,3,73,3.8,96.0
141,tt0113161,Get Shorty,1995,"50,000+",62205,4192,1818,1415,3.6,70.0,,57,50,7,57,3.6,88.0
142,tt0114388,Sense and Sensibility,1995,"100,000+",131025,18837,2127,6608,4.2,90.0,,68,66,2,68,4.2,97.0
143,tt2802850,Fargo,1996,"100,000+",235005,48292,3923,12439,4.3,92.0,,106,100,6,106,4.3,94.0
144,tt0112573,Braveheart,1995,"250,000+",32708456,126902,22193,1198232,3.8,85.0,,127,96,31,127,3.8,76.0
145,tt0110932,Quiz Show,1994,"25,000+",31681,4204,645,1053,4,87.0,,59,57,2,59,4,97.0
146,tt0112818,Dead Man Walking,1995,"50,000+",61979,7309,1239,1962,4,86.0,,61,58,3,61,4,95.0
147,tt0112346,The American President,1995,"50,000+",55172,4400,1313,1901,3.9,77.0,,56,51,5,56,3.9,91.0
148,tt0113862,Mr. Holland's Opus,1995,"50,000+",54793,4598,910,2212,4.1,84.0,,28,21,7,28,4.1,75.0
149,tt0117318,The People vs. Larry Flynt,1996,"25,000+",44544,4217,1076,1205,3.8,80.0,,58,51,7,58,3.8,88.0
150,tt0116209,The English Patient,1996,"50,000+",81874,13989,2905,4511,4.1,83.0,,94,81,13,94,4.1,86.0
151,tt0119217,Good Will Hunting,1997,"250,000+",365875,63244,3698,15764,4.4,94.0,,91,88,3,91,4.4,97.0
152,tt0119822,As Good as It Gets,1997,"250,000+",378952,19511,3054,9108,4.1,86.0,,85,73,12,85,4.1,86.0
153,tt0117631,Shine,1996,"25,000+",30934,4152,471,1101,4.2,90.0,,44,40,4,44,4.2,91.0
154,tt0120815,Saving Private Ryan,1998,"250,000+",994594,113250,5928,41365,4.5,95.0,,148,139,9,148,4.5,94.0
155,tt0119488,L.A. Confidential,1997,"100,000+",151391,25044,1582,6439,4.4,94.0,,165,164,1,165,4.4,99.0
156,tt0120382,The Truman Show,1998,"250,000+",585107,52493,6586,19738,4.1,89.0,,162,153,9,162,4.1,94.0
157,tt0138097,Shakespeare in Love,1998,"100,000+",227207,17611,4522,6929,3.9,80.0,,147,135,12,147,3.9,92.0
158,tt0120338,Titanic,1997,"250,000+",35797635,295888,130124,2889107,3.3,69.0,,254,223,31,254,3.3,88.0
159,tt0120885,Wag the Dog,1997,"25,000+",44694,4519,1407,1508,3.8,76.0,,78,67,11,78,3.8,86.0
160,tt0124315,The Cider House Rules,1999,"50,000+",53600,5390,1593,1787,3.8,77.0,,111,79,32,111,3.8,71.0
161,tt0167404,The Sixth Sense,1999,"250,000+",1037520,70547,8157,39158,4.2,90.0,,162,139,23,162,4.2,86.0
162,tt0120601,Being John Malkovich,1999,"250,000+",262977,38797,5867,11373,4.1,87.0,,135,127,8,135,4.1,94.0
163,tt0169547,American Beauty,1999,"250,000+",661369,97659,7418,29042,4.4,93.0,,192,167,25,192,4.4,87.0
164,tt0181865,Traffic,2000,"100,000+",190654,17711,3228,4677,4,85.0,,223,208,15,223,4,93.0
165,tt0118798,Bulworth,1998,"10,000+",20656,1432,683,572,3.6,68.0,,68,52,16,68,3.6,76.0
166,tt0140352,The Insider,1999,0,0,0,0,0,,,,0,0,0,0,,
167,tt0181875,Almost Famous,2000,"250,000+",325433,47287,4278,14940,4.3,92.0,,177,158,19,177,4.3,89.0
168,tt0203230,You Can Count on Me,2000,"10,000+",10709,2260,311,687,4.1,88.0,,105,100,5,105,4.1,95.0
169,tt0180073,Quills,2000,"25,000+",45607,4925,1037,2067,4,83.0,,126,95,31,126,4,75.0
170,tt0185014,Wonder Boys,2000,"25,000+",40336,4608,954,1558,4,83.0,,127,103,24,127,4,81.0
171,tt0268978,A Beautiful Mind,2001,"250,000+",491450,81611,6576,20882,4.3,93.0,,214,159,55,214,4.3,74.0
172,tt0243133,The Man Who Wasn't There,2001,"25,000+",41324,6549,1192,1756,3.9,85.0,,159,129,30,159,3.9,81.0
173,tt0209144,Memento,2001,"250,000+",382236,96121,5700,27555,4.4,94.0,,185,173,12,185,4.4,94.0
174,tt0268126,Adaptation.,2002,"100,000+",188978,26840,4667,8495,4,85.0,,210,190,20,210,4,90.0
175,tt0257360,About Schmidt,2002,"50,000+",90788,6690,2327,2741,3.7,74.0,,205,175,30,205,3.7,85.0
176,tt0280707,Gosford Park,2001,"25,000+",48630,6161,1742,2471,3.8,78.0,,165,144,21,165,3.8,87.0
177,tt0166924,Mulholland Dr.,2001,"100,000+",189705,30876,4455,10328,4.2,87.0,,262,219,43,262,4.2,84.0
178,tt0335266,Lost in Translation,2003,"250,000+",338129,69526,11826,22313,4.1,85.0,,235,224,11,235,4.1,95.0
179,tt0297884,Far from Heaven,2002,"10,000+",23317,3209,835,1103,3.9,79.0,,222,194,28,222,3.9,87.0
180,tt0314331,Love Actually,2003,"250,000+",31626919,86596,32925,927665,3.1,72.0,,226,144,82,226,3.1,64.0
181,tt0274558,The Hours,2002,"50,000+",86056,14835,2736,4501,4.1,84.0,,195,155,40,195,4.1,79.0
182,tt0318997,Angels in America,2003,Fewer than 50,15,13,2,5,4.3,87.0,,0,0,0,0,4.3,
183,tt0327056,Mystic River,2003,"100,000+",204004,24609,2995,7594,4.1,89.0,,204,181,23,204,4.1,89.0
184,tt0308644,Finding Neverland,2004,"250,000+",465560,40370,6137,19216,4.1,87.0,,206,170,36,206,4.1,83.0
185,tt0159365,Cold Mountain,2003,"100,000+",210054,11980,3657,5997,3.8,77.0,,231,162,69,231,3.8,70.0
186,tt0375063,Sideways,2004,"100,000+",197951,26465,7227,10822,3.8,79.0,,231,223,8,231,3.8,97.0
187,tt0338013,Eternal Sunshine of the Spotless Mind,2004,"250,000+",572817,152999,9510,46631,4.5,94.0,,256,236,20,256,4.5,92.0
188,tt0388795,Brokeback Mountain,2005,"250,000+",520390,41156,8824,27157,4,82.0,,251,221,30,251,4,88.0
189,tt0338751,The Aviator,2004,"100,000+",207945,21497,5640,8025,3.8,79.0,,226,195,31,226,3.8,86.0
190,tt0433383,"Good Night, and Good Luck.",2005,"100,000+",142797,11298,2305,4976,3.9,83.0,,225,210,15,225,3.9,93.0
191,tt0376541,Closer,2004,"100,000+",242667,33970,8154,13308,4,81.0,,210,142,68,210,4,68.0
192,tt0416320,Match Point,2005,"250,000+",250875,22706,5347,8658,3.9,81.0,,216,166,50,216,3.9,77.0
193,tt0404203,Little Children,2006,"50,000+",95569,15184,3388,7484,3.9,82.0,,162,129,33,162,3.9,80.0
194,tt0465551,Notes on a Scandal,2006,"50,000+",77866,12099,2527,6640,3.9,83.0,,176,154,22,176,3.9,88.0
195,tt0477348,No Country for Old Men,2007,"250,000+",400568,123254,19634,60240,4.2,86.0,,289,270,19,289,4.2,93.0
196,tt0375679,Crash,2005,"250,000+",442573,70429,9411,29796,4.2,88.0,,242,178,64,242,4.2,74.0
197,tt0408306,Munich,2005,"250,000+",330482,20783,4224,10608,3.9,83.0,,208,163,45,208,3.9,78.0
198,tt1010048,Slumdog Millionaire,2008,"250,000+",1156126,79698,8783,50341,4.3,90.0,,290,265,25,290,4.3,91.0
199,tt0449467,Babel,2006,"250,000+",377495,46725,13945,19816,3.8,77.0,,207,143,64,207,3.8,69.0
200,tt0407887,The Departed,2006,"250,000+",739210,163638,11058,58090,4.4,94.0,,287,260,27,287,4.4,91.0
201,tt0918927,Doubt,2008,"100,000+",162643,17977,5010,10481,3.8,78.0,,219,173,46,219,3.8,79.0
202,tt0472062,Charlie Wilson's War,2007,"100,000+",226570,27531,9959,15004,3.7,73.0,,207,170,37,207,3.7,82.0
203,tt0783233,Atonement,2007,"100,000+",227451,59833,15221,31939,3.9,80.0,,220,183,37,220,3.9,83.0
204,tt0421715,The Curious Case of Benjamin Button,2008,"250,000+",691235,67750,16953,37517,3.9,80.0,,256,183,73,256,3.9,71.0
205,tt0870111,Frost/Nixon,2008,"100,000+",109937,16446,2272,7750,4,88.0,,258,239,19,258,4,93.0
206,tt1285016,The Social Network,2010,"100,000+",205117,81606,12683,19874,4.1,87.0,,333,319,14,333,4.1,96.0
207,tt1542344,127 Hours,2010,"50,000+",96184,36239,6511,10441,4,85.0,,239,222,17,239,4,93.0
208,tt0361748,Inglourious Basterds,2009,"250,000+",777568,98332,13693,36687,4.2,88.0,,335,298,37,335,4.2,89.0
209,tt1230414,It's Complicated,2009,"100,000+",225361,13785,9340,7974,3.5,60.0,,185,109,76,185,3.5,59.0
210,tt1136608,District 9,2009,"250,000+",1179095,82577,17541,39457,4,82.0,,314,282,32,314,4,90.0
211,tt1193138,Up in the Air,2009,"100,000+",228692,37267,9750,14118,3.8,79.0,,288,260,28,288,3.8,90.0
212,tt0887912,The Hurt Locker,2009,"50,000+",96474,40150,7753,13867,4,84.0,,291,281,10,291,4,97.0
213,tt0842926,The Kids Are All Right,2010,"50,000+",63683,15019,5407,4672,3.7,74.0,,228,210,18,228,3.7,92.0
214,tt0976051,The Reader,2008,"100,000+",207082,20014,5250,10255,3.8,79.0,,203,128,75,203,3.8,63.0
215,tt1504320,The King's Speech,2010,"100,000+",144906,60568,5444,14934,4.3,92.0,,305,288,17,305,4.3,94.0
216,tt1790885,Zero Dark Thirty,2012,"100,000+",197618,53982,13178,7335,4,80.0,,308,281,27,308,4,91.0
217,tt1605783,Midnight in Paris,2011,"50,000+",82995,34989,7334,8100,4,83.0,,229,213,16,229,4,93.0
218,tt1375666,Inception,2010,"250,000+",573980,166126,15660,41718,4.4,91.0,,371,322,49,371,4.4,87.0
219,tt1798709,Her,2013,"100,000+",102532,40459,8712,5992,4,82.0,,293,276,17,293,4,94.0
220,tt1210166,Moneyball,2011,"50,000+",92503,43753,6880,7886,4,86.0,,275,259,16,275,4,94.0
221,tt1655442,The Artist,2011,"50,000+",58779,27302,3942,6656,4.2,87.0,,329,313,16,329,4.2,95.0
222,tt1124035,The Ides of March,2011,"50,000+",63386,21102,7987,4959,3.6,73.0,,253,211,42,253,3.6,83.0
223,tt1853728,Django Unchained,2012,"250,000+",431092,123551,11426,16121,4.3,92.0,,298,258,40,298,4.3,87.0
224,tt1045658,Silver Linings Playbook,2012,"250,000+",261141,84041,13606,10599,4.1,86.0,,263,241,22,263,4.1,92.0
225,tt0443272,Lincoln,2012,"100,000+",246125,48406,11719,8736,4,81.0,,288,258,30,288,4,90.0
226,tt1033575,The Descendants,2011,"50,000+",70150,28031,7615,6406,3.8,79.0,,271,236,35,271,3.8,87.0
227,tt1024648,Argo,2012,"100,000+",209393,80129,9226,11005,4.2,90.0,,365,349,16,365,4.2,96.0
228,tt2024544,12 Years a Slave,2013,"100,000+",140958,49605,5768,6219,4.3,90.0,,379,360,19,379,4.3,95.0
229,tt1800241,American Hustle,2013,"100,000+",176510,54552,18890,7853,3.8,74.0,,298,274,24,298,3.8,92.0
230,tt2431286,Philomena,2013,"50,000+",52553,15480,1982,2200,4.1,89.0,,202,183,19,202,4.1,91.0
231,tt1821549,Nebraska,2013,"25,000+",44937,14758,3035,2163,4,83.0,,255,231,24,255,4,91.0
232,tt2267998,Gone Girl,2014,"100,000+",129591,63410,9473,8367,4.1,87.0,,376,329,47,376,4.1,88.0
233,tt1065073,Boyhood,2014,"50,000+",90148,30701,7451,5128,4,80.0,,336,325,11,336,4,97.0
234,tt0071715,Kazablan,1973,50+,50,4,0,2,,,,0,0,0,0,,
235,tt0070086,The Pedestrian,1973,50+,63,1,5,4,2.8,17.0,,1,0,1,1,2.8,
236,tt2084970,The Imitation Game,2014,"100,000+",104682,46029,4377,4803,4.2,91.0,,287,258,29,287,4.2,90.0
237,tt2562232,Birdman or (The Unexpected Virtue of Ignorance),2014,"50,000+",94015,36969,10690,5891,3.9,78.0,,362,329,33,362,3.9,91.0
238,tt2278388,The Grand Budapest Hotel,2014,"50,000+",98987,44471,6953,5609,4.1,86.0,,318,292,26,318,4.1,92.0
239,tt12682218,Scenes from a Marriage,1974,"5,000+",8439,1783,99,478,4.5,95.0,,24,21,3,24,4.5,88.0
240,tt0071733,Lacombe Lucien,1974,"1,000+",1869,307,53,87,4,85.0,,10,10,0,10,4,100.0
241,tt0073293,Lies My Father Told Me,1975,100+,170,17,3,5,4,85.0,,3,2,1,3,4,
242,tt0071155,The Apprenticeship of Duddy Kravitz,1974,500+,771,79,30,30,3.6,72.0,,14,13,1,14,3.6,93.0
243,tt0071129,Amarcord,1974,"10,000+",18243,3498,374,780,4.3,90.0,,47,41,6,47,4.3,87.0
244,tt8206398,The Magic Flute,1975,0,0,0,0,0,,,,0,0,0,0,,
245,tt0072826,Cousin cousine,1976,250+,350,36,18,12,3.6,67.0,,5,5,0,5,3.6,100.0
246,tt20429550,Get Out Your Handkerchiefs,1978,"1,000+",1181,110,37,31,3.7,75.0,,18,15,3,18,3.7,83.0
247,tt0079118,Eskimo Limon,1978,0,0,0,0,0,,,,1,0,1,1,,
248,tt7657566,Death on the Nile,1978,"5,000+",8628,902,242,343,3.8,79.0,,18,14,4,18,3.8,78.0
249,tt0077288,La Cage aux folles,1979,"5,000+",6418,839,149,244,4,85.0,,24,23,1,24,4,96.0
250,tt0080310,'Breaker' Morant,1980,"2,500+",4969,713,72,272,4.2,91.0,,24,24,0,24,4.2,100.0
251,tt0080979,Kagemusha,1980,"10,000+",12456,2719,247,716,4.2,92.0,,26,23,3,26,4.2,88.0
252,tt0079123,The Europeans,1979,500+,678,24,39,21,3.2,38.0,,20,16,4,20,3.2,80.0
253,tt5830254,Das Boot,1981,"25,000+",47571,9044,426,2948,4.5,96.0,,58,57,1,58,4.5,98.0
254,tt0080009,Tess,1980,"5,000+",6365,901,259,245,3.8,78.0,,77,62,15,77,3.8,81.0
255,tt0082432,Gallipoli,1981,"10,000+",23185,2170,448,849,4,83.0,,46,42,4,46,4,91.0
256,tt0079596,My Brilliant Career,1980,500+,500,120,60,49,3.6,66.0,,21,18,3,21,3.6,86.0
257,tt0080388,Atlantic City,1981,"5,000+",5264,654,190,204,3.8,77.0,,38,38,0,38,3.8,100.0
258,tt0082158,Chariots of Fire,1981,"25,000+",37275,4107,1038,1671,4,80.0,,115,96,19,115,4,83.0
259,tt0083946,Fitzcarraldo,1982,"10,000+",12859,2837,239,852,4.3,92.0,,32,24,8,32,4.3,75.0
260,tt0085478,Educating Rita,1983,"5,000+",7872,979,231,418,3.9,81.0,,17,14,3,17,3.9,82.0
261,tt0084296,The Man from Snowy River,1982,"25,000+",26364,1661,207,801,4.3,89.0,,13,11,2,13,4.3,85.0
262,tt4247618,The Dresser,1983,"1,000+",1818,252,40,90,4,86.0,,15,15,0,15,4,100.0
263,tt0083987,Gandhi,1982,"25,000+",49947,8374,731,2481,4.3,92.0,,110,98,12,110,4.3,89.0
264,tt0084821,La traviata,1982,Fewer than 50,11,6,0,1,4.7,100.0,,1,1,0,1,4.7,
265,tt0087892,A Passage to India,1984,"5,000+",6973,943,254,351,3.8,79.0,,28,22,6,28,3.8,79.0
266,tt0083922,Fanny och Alexander,1983,"10,000+",21460,4076,274,1027,4.5,94.0,,45,45,0,45,4.5,100.0
267,tt0084934,Yol,1982,"2,500+",2613,453,28,47,4.4,94.0,,13,10,3,13,4.4,77.0
268,tt0085622,The Grey Fox,1983,500+,777,58,18,21,4.1,76.0,,29,29,0,29,4.1,100.0
269,tt0087884,"Paris, Texas",1984,"10,000+",24508,5805,419,1249,4.4,93.0,,53,50,3,53,4.4,94.0
270,tt0087034,Carmen,1984,500+,566,131,27,28,4.1,83.0,,2,1,1,2,4.1,
271,tt0091288,Jean de Florette,1987,"10,000+",14164,2748,139,782,4.5,95.0,,23,21,2,23,4.5,91.0
272,tt0092593,Au revoir les enfants,1987,"10,000+",11836,2783,209,743,4.3,93.0,,37,36,1,37,4.3,97.0
273,tt0089881,Ran,1985,"25,000+",38496,7362,421,2188,4.5,95.0,,91,87,4,91,4.5,96.0
274,tt0118408,My Life as a Dog,1987,"5,000+",8998,1991,210,537,4.3,90.0,,34,34,0,34,4.3,100.0
275,tt0048455,Otello,1986,500+,677,13,14,6,3.4,48.0,,4,2,2,4,3.4,
276,tt3660850,The Assault,1986,250+,468,41,11,16,3.9,79.0,,1,1,0,1,3.9,
277,tt15738092,Repentance,1987,250+,408,91,10,17,4.3,90.0,,13,9,4,13,4.3,69.0
278,tt0096028,Salaam Bombay!,1988,"5,000+",5719,770,59,220,4.3,93.0,,30,28,2,30,4.3,93.0
279,tt17157680,Women on the Verge of a Nervous Breakdown,1988,"10,000+",22662,3926,504,888,4.1,89.0,,36,33,3,36,4.1,92.0
280,tt0094828,Camille Claudel,1989,"5,000+",5089,679,92,194,4.2,88.0,,12,11,1,12,4.2,92.0
281,tt0095276,Hanussen,1988,250+,263,34,3,8,4,92.0,,1,1,0,1,4,
282,tt0099334,Cyrano de Bergerac,1990,"10,000+",16295,2283,245,714,4.3,90.0,,30,30,0,30,4.3,100.0
283,tt0100476,Requiem For Dominic,1990,Fewer than 50,38,2,0,0,,,,2,1,1,2,,
284,tt2334733,Madame Bovary,1991,"1,000+",2109,137,92,63,3.4,60.0,,16,10,6,16,3.4,63.0
285,tt0108394,Three Colours: Blue,1993,"25,000+",38754,9393,734,1927,4.4,93.0,,55,54,1,55,4.4,98.0
286,tt0104507,Indochine,1992,"5,000+",6778,1095,208,301,4.1,84.0,,20,15,5,20,4.1,75.0
287,tt30325192,Like Water for Chocolate,1992,"25,000+",27168,3352,634,1301,4.1,84.0,,48,42,6,48,4.1,88.0
288,tt0105483,A Stranger Among Us,1992,"5,000+",7180,64,102,57,2.9,39.0,,41,9,32,41,2.9,22.0
289,tt0107296,Justiz,1993,Fewer than 50,33,3,0,2,,,,0,0,0,0,,
290,tt1707386,Les Misérables,1995,"25,000+",38311,4149,847,1635,4,83.0,,44,33,11,44,4,75.0
291,tt0880966,The Prisoner of the Mountains,1996,"1,000+",1043,204,31,70,4,87.0,,25,22,3,25,4,88.0
292,tt0116940,Luna e l'altra,1996,0,0,0,0,0,,,,0,0,0,0,,
293,tt0119657,Men with Guns,1998,"1,000+",1465,151,16,47,4.2,90.0,,27,24,3,27,4.2,89.0
294,tt0123385,Artemisia,1997,"1,000+",1272,93,52,52,3.5,64.0,,21,14,7,21,3.5,67.0
295,tt0117477,Ridicule,1996,"2,500+",4283,559,110,166,4,84.0,,20,16,4,20,4,80.0
296,tt0168501,The Best Man,1997,"2,500+",3018,2288,362,786,4.2,86.0,,71,51,20,71,4.2,72.0
297,tt0130444,Aimée & Jaguar,1999,500+,656,583,73,179,4.2,89.0,,49,44,5,49,4.2,90.0
298,tt3981658,"New Crouching Tiger, Hidden Dragon",2000,"250,000+",427893,29181,4725,13700,4.1,86.0,,170,166,4,170,4.1,98.0
299,tt11015978,The Girl on the Bridge,1999,"5,000+",7203,1435,151,379,4.2,91.0,,42,37,5,42,4.2,88.0
300,tt0245712,Amores perros,2000,"100,000+",104433,25055,1524,5220,4.4,94.0,,123,114,9,123,4.4,93.0
301,tt0245574,Y tu mamá también,2001,"50,000+",69920,16471,2202,4343,4.1,88.0,,192,174,18,192,4.1,91.0
302,tt0213847,Malèna,2000,"25,000+",29700,4557,838,1318,4,84.0,,78,42,36,78,4,54.0
303,tt0265343,Monsoon Wedding,2001,"25,000+",27618,3496,523,1157,4.1,87.0,,132,125,7,132,4.1,95.0
304,tt0329388,Monsieur Ibrahim et les fleurs du Coran,2003,"5,000+",6375,1073,169,309,4.1,86.0,,80,68,12,80,4.1,85.0
305,tt0167260,The Lord of the Rings: The Return of the King,2003,"250,000+",34679773,193983,30876,2050091,3.6,86.0,,278,261,17,278,3.6,94.0
306,tt0301357,Good Bye Lenin!,2003,"50,000+",55960,12404,1006,2988,4.2,92.0,,110,100,10,110,4.2,91.0
307,tt0441909,Volver,2006,"50,000+",72125,19721,2505,6102,4.1,89.0,,172,157,15,172,4.1,91.0
308,tt0468565,Tsotsi,2005,"25,000+",39222,4045,640,1683,4,86.0,,131,108,23,131,4,82.0
309,tt9130566,The Lives Of Others,2006,"100,000+",121856,32751,1387,11167,4.5,96.0,,163,150,13,163,4.5,92.0
310,tt0498380,Letters from Iwo Jima,2006,"250,000+",341234,24403,3844,10128,4.1,86.0,,204,186,18,204,4.1,91.0
311,tt0445620,Paradise Now,2005,"25,000+",27402,3229,485,1193,4.1,87.0,,104,93,11,104,4.1,89.0
312,tt0472043,Apocalypto,2006,"250,000+",443013,50697,13552,26586,3.9,79.0,,202,132,70,202,3.9,65.0
313,tt0419887,The Kite Runner,2007,"100,000+",240005,17511,3242,10030,4,84.0,,178,116,62,178,4,65.0
314,tt0808417,Persepolis,2007,"50,000+",50528,19976,1648,7585,4.3,92.0,,164,157,7,164,4.3,96.0
315,tt1185616,Waltz with Bashir,2008,"25,000+",44020,6930,725,2625,4.2,91.0,,155,150,5,155,4.2,97.0
316,tt0765432,Der Baader Meinhof Komplex,2008,"10,000+",16158,2382,592,1014,3.8,80.0,,99,84,15,99,3.8,85.0
317,tt1348059,I've Loved You So Long,2008,"10,000+",22523,3252,557,1558,4,85.0,,128,113,15,128,4,88.0
318,tt1081935,Baarìa,2009,"1,000+",1227,209,208,110,3.3,50.0,,11,6,5,11,3.3,55.0
319,tt1164999,Biutiful,2010,"10,000+",21457,5246,1788,1700,3.7,75.0,,155,103,52,155,3.7,66.0
320,tt1602620,Amour,2012,"10,000+",21008,7068,1548,1494,4,82.0,,223,207,16,223,4,93.0
321,tt1675434,Intouchables,2012,0,0,0,0,0,,,,0,0,0,0,,
322,tt12887846,The skin I live in,2011,"25,000+",27210,8690,1694,2029,3.9,84.0,,178,144,34,178,3.9,81.0
323,tt1613750,Kon-Tiki,2012,"10,000+",13218,2631,791,398,3.7,77.0,,82,67,15,82,3.7,82.0
324,tt1714209,In the Land of Blood and Honey,2011,"5,000+",5724,792,877,294,3,47.0,,81,47,34,81,3,58.0
325,tt0097737,Leviathan,2014,"10,000+",17378,2228,563,328,3.9,80.0,,150,146,4,150,3.9,97.0
326,tt0832280,Ballad of a Soldier,1960,"2,500+",3020,509,40,163,4.3,93.0,,15,14,1,15,4.3,93.0
327,tt0052893,Hiroshima mon amour,1960,"10,000+",10066,2511,305,634,4.3,89.0,,47,45,2,47,4.3,96.0
328,tt1874756,The Good Soldier Schweik,1961,50+,54,8,3,0,3.8,73.0,,0,0,0,0,3.8,
329,tt8359848,Climax,1967,Fewer than 50,1,0,1,1,,,,0,0,0,0,,
330,tt0061620,Elvira Madigan,1967,"1,000+",1062,88,28,31,3.9,76.0,,7,4,3,7,3.9,57.0
331,tt0065261,Ådalen 31,1969,Fewer than 50,2,2,0,0,,,,8,7,1,8,,88.0
332,tt1723811,Shame,1968,"2,500+",4803,638,82,160,4.1,89.0,,26,17,9,26,4.1,65.0
333,tt0507622,The Bride Wore Black,1968,"2,500+",4275,484,118,162,3.8,80.0,,20,17,3,20,3.8,85.0
334,tt0065486,Borsalino,1970,250+,362,47,20,7,3.6,70.0,,1,1,0,1,3.6,
335,tt8867238,Investigation of a Citizen Above Suspicion,1970,"1,000+",1709,453,28,81,4.3,94.0,,15,15,0,15,4.3,100.0
336,tt7504656,To die of love,1971,50+,57,3,0,1,,,,0,0,0,0,,
337,tt0065127,Tchaikovsky,1971,50+,94,4,0,1,,,,0,0,0,0,,
338,tt0057239,The L-Shaped Room,1963,250+,333,57,12,15,4,83.0,,9,6,3,9,4,67.0
339,tt0054412,Tunes of Glory,1960,"1,000+",1097,141,39,50,4,78.0,,11,8,3,11,4,73.0
340,tt0053602,The Angry Silence,1960,100+,145,23,6,10,3.8,79.0,,5,4,1,5,3.8,80.0
341,tt0060086,Alfie,1966,"10,000+",14703,1200,370,502,3.8,76.0,,29,28,1,29,3.8,97.0
342,tt0054403,The Trials Of Oscar Wilde,1960,100+,116,11,12,7,3.2,48.0,,5,5,0,5,3.2,100.0
343,tt0058142,Girl with Green Eyes,1964,100+,181,19,12,13,3.6,60.0,,6,5,1,6,3.6,83.0
344,tt0057578,This Sporting Life,1963,"1,000+",1911,364,58,175,4.1,86.0,,24,23,1,24,4.1,96.0
345,tt0059362,The Knack ...and How to Get It,1965,"1,000+",1192,154,70,108,3.6,69.0,,18,13,5,18,3.6,72.0
346,tt0057244,The Leather Boys,1965,100+,173,24,8,11,3.7,75.0,,13,10,3,13,3.7,77.0
347,tt0114057,Othello,1965,500+,506,57,33,29,3.5,63.0,,12,10,2,12,3.5,83.0
348,tt15398980,Tom Jones,1963,"5,000+",5525,399,289,239,3.4,58.0,,43,35,8,43,3.4,81.0
349,tt0061022,The Spy with a Cold Nose,1966,Fewer than 50,44,1,3,2,,,,0,0,0,0,,
350,tt0060176,Blow-Up,1966,"25,000+",28741,4928,935,1454,4.1,84.0,,53,46,7,53,4.1,87.0
351,tt0060453,Georgy Girl,1966,"1,000+",2166,167,69,101,3.7,71.0,,12,10,2,12,3.7,83.0
352,tt0062281,Smashing Time,1967,100+,112,10,10,8,3.2,50.0,,8,7,1,8,3.2,88.0
353,tt0062767,"Buona Sera, Mrs. Campbell",1968,100+,119,21,10,4,3.7,68.0,,3,2,1,3,3.7,
354,tt0317740,The Italian Job,1969,"50,000+",71225,5203,899,2633,4.1,85.0,,32,26,6,32,4.1,81.0
355,tt0061180,The Whisperers,1967,100+,227,23,16,16,3.3,59.0,,6,4,2,6,3.3,67.0
356,tt0064045,The Assassination Bureau,1969,"1,000+",1275,60,27,43,3.7,69.0,,9,7,2,9,3.7,78.0
357,tt0062141,Poor Cow,1968,250+,297,50,13,18,3.8,79.0,,16,8,8,16,3.8,50.0
358,tt0065370,Act of the Heart,1970,100+,118,2,1,1,,,,4,2,2,4,,
359,tt0064754,Oh! What a Lovely War,1969,500+,815,110,42,57,3.9,72.0,,15,12,3,15,3.9,80.0
360,tt0064645,Mayerling,1969,100+,165,11,18,4,3,38.0,,4,1,3,4,3,
361,tt0066528,The Virgin and the Gypsy,1970,50+,60,3,8,3,2.9,27.0,,2,1,1,2,2.9,
362,tt0066579,Women in Love,1970,"2,500+",2793,302,105,149,3.8,74.0,,23,19,4,23,3.8,83.0
363,tt0067805,Sunday Bloody Sunday,1971,"2,500+",2680,258,108,105,3.7,70.0,,30,26,4,30,3.7,87.0
364,tt0067144,The Go-Between,1971,500+,799,167,48,72,3.8,78.0,,11,11,0,11,3.8,100.0
365,tt0141517,The African Elephant,1971,Fewer than 50,43,1,0,0,,,,0,0,0,0,,
366,tt3068894,The Red Tent,1971,"1,000+",1607,49,25,17,3.7,66.0,,9,8,1,9,3.7,89.0
367,tt0054412,Tunes of Glory,1960,"1,000+",1097,141,39,50,4,78.0,,11,8,3,11,4,73.0
368,tt0069528,Young Winston,1972,250+,299,41,38,24,3.2,52.0,,11,6,5,11,3.2,55.0
369,tt0069198,The Ruling Class,1972,"2,500+",4044,505,85,251,4.1,86.0,,13,10,3,13,4.1,77.0
370,tt0068866,Living Free,1972,"1,000+",1248,21,18,19,3.7,54.0,,0,0,0,0,3.7,
371,tt0053602,The Angry Silence,1960,100+,145,23,6,10,3.8,79.0,,5,4,1,5,3.8,80.0
372,tt0054353,The Sundowners,1960,500+,601,92,52,40,3.5,64.0,,14,11,3,14,3.5,79.0
373,tt0052893,Hiroshima mon amour,1960,"10,000+",10066,2511,305,634,4.3,89.0,,47,45,2,47,4.3,96.0
374,tt0068732,Images,1972,"1,000+",1726,197,86,86,3.6,70.0,,15,11,4,15,3.6,73.0
375,tt0053793,Elmer Gantry,1960,"2,500+",3422,439,68,193,4,87.0,,32,30,2,32,4,94.0
376,tt0053946,Inherit the Wind,1960,"5,000+",9681,1750,181,658,4.3,91.0,,27,25,2,27,4.3,93.0
377,tt0054326,Sons and Lovers,1960,250+,406,29,30,19,3.5,49.0,,9,6,3,9,3.5,67.0
378,tt0053604,The Apartment,1960,"25,000+",38387,8311,536,2375,4.4,94.0,,107,100,7,107,4.4,93.0
379,tt0078610,The Facts of Life,1960,500+,518,47,29,29,3.5,61.0,,2,1,1,2,3.5,
380,tt0832280,Ballad of a Soldier,1961,"2,500+",3020,509,40,163,4.3,93.0,,15,14,1,15,4.3,93.0
381,tt0054997,The Hustler,1961,"25,000+",31310,4612,373,1357,4.3,93.0,,50,47,3,50,4.3,94.0
382,tt0054953,The Guns of Navarone,1961,"10,000+",20813,2220,360,705,4,86.0,,26,24,2,26,4,92.0
383,tt0055031,Judgment at Nuremberg,1961,"5,000+",8732,1674,123,501,4.3,93.0,,26,24,2,26,4.3,92.0
384,tt0054698,Breakfast at Tiffany's,1961,"100,000+",243036,42226,4330,13638,4.3,91.0,,56,49,7,56,4.3,88.0
385,tt3581652,West Side Story,1961,"100,000+",169299,10828,2032,5807,4.1,84.0,,116,107,9,116,4.1,92.0
386,tt0055100,Lover Come Back,1961,"5,000+",5748,428,127,180,3.9,77.0,,12,11,1,12,3.9,92.0
387,tt0056172,Lawrence of Arabia,1962,"50,000+",75428,18775,1456,5597,4.5,93.0,,133,125,8,133,4.5,94.0
388,tt0055471,Splendor in the Grass,1961,"5,000+",8552,1626,186,591,4.2,90.0,,26,19,7,26,4.2,73.0
389,tt0056592,To Kill a Mockingbird,1962,"100,000+",179352,18004,1461,7723,4.4,93.0,,68,63,5,68,4.4,93.0
390,tt0119558,Lolita,1962,"25,000+",46147,7223,1385,1864,4,84.0,,45,41,4,45,4,91.0
391,tt0053779,La dolce vita,1961,"25,000+",34228,6317,701,1554,4.4,90.0,,80,76,4,80,4.4,95.0
392,tt0056241,The Miracle Worker,1962,"5,000+",8874,1048,139,403,4.2,88.0,,26,25,1,26,4.2,96.0
393,tt0055892,David and Lisa,1962,"1,000+",1061,145,38,67,3.9,79.0,,13,11,2,13,3.9,85.0
394,tt15398980,Tom Jones,1963,"5,000+",5525,399,289,239,3.4,58.0,,43,35,8,43,3.4,81.0
395,tt0056575,That Touch of Mink,1962,"5,000+",7688,585,249,248,3.8,70.0,,9,7,2,9,3.8,78.0
396,tt8667956,Freud,1962,500+,647,68,28,25,3.7,70.0,,9,7,2,9,3.7,78.0
397,tt4476604,"Through a Glass, Darkly",1962,"5,000+",8213,1891,169,494,4.3,92.0,,29,29,0,29,4.3,100.0
398,tt0056903,"Captain Newman, M.D.",1963,250+,377,50,27,26,3.6,65.0,,5,3,2,5,3.6,60.0
399,tt0057251,Lilies of the Field,1963,"5,000+",6184,772,126,268,4.1,86.0,,25,23,2,25,4.1,92.0
400,tt0057163,Hud,1963,"5,000+",8485,1338,169,463,4.1,89.0,,33,28,5,33,4.1,85.0
401,tt0056085,How the West Was Won,1963,"5,000+",9847,897,314,387,3.8,74.0,,23,20,3,23,3.8,87.0
402,tt0057012,Dr. Strangelove or: How I Learned to Stop Worrying and Love the Bomb,1964,"100,000+",209921,36832,2525,10911,4.5,94.0,,96,94,2,96,4.5,98.0
403,tt0057263,Love with the Proper Stranger,1963,"1,000+",1464,277,44,106,4.1,86.0,,11,9,2,11,4.1,82.0
404,tt0059113,Doctor Zhivago,1965,"25,000+",45894,6217,864,2066,4.2,88.0,,50,41,9,50,4.2,82.0
405,tt0057877,Becket,1964,"5,000+",5634,933,138,392,4.1,87.0,,28,21,7,28,4.1,75.0
406,tt0058385,My Fair Lady,1964,"100,000+",187222,14889,1731,6418,4.3,90.0,,91,86,5,91,4.3,95.0
407,tt0058092,Father Goose,1964,"5,000+",9305,1062,178,394,4.1,86.0,,15,12,3,15,4.1,80.0
408,tt0058429,"One Potato, Two Potato",1964,50+,64,15,8,12,3.7,65.0,,6,6,0,6,3.7,100.0
409,tt0058182,A Hard Day's Night,1964,"50,000+",50526,6823,836,2435,4.3,89.0,,108,106,2,108,4.3,98.0
410,tt0059017,Cat Ballou,1965,"5,000+",9195,793,279,389,3.8,74.0,,30,27,3,30,3.8,90.0
411,tt0058331,Mary Poppins,1964,"250,000+",682796,25519,4116,19491,4.2,86.0,,56,54,2,56,4.2,96.0
412,tt0059712,Ship of Fools,1965,"1,000+",1191,164,49,71,3.8,77.0,,23,14,9,23,3.8,61.0
413,tt0060665,A Man for All Seasons,1966,"5,000+",9813,1846,273,717,4.2,87.0,,82,73,9,82,4.2,89.0
414,tt0061184,Who's Afraid of Virginia Woolf?,1966,"10,000+",21785,4241,450,1455,4.3,90.0,,45,43,2,45,4.3,96.0
415,tt0059015,Casanova '70,1965,50+,82,17,12,5,3.6,59.0,,2,1,1,2,3.6,
416,tt0060921,The Russians Are Coming the Russians Are Coming,1966,"2,500+",4789,485,162,221,3.8,75.0,,22,19,3,22,3.8,86.0
417,tt0060176,Blow-Up,1966,"25,000+",28741,4928,935,1454,4.1,84.0,,53,46,7,53,4.1,87.0
418,tt0059798,A Thousand Clowns,1965,"1,000+",1080,235,31,99,4.3,88.0,,18,13,5,18,4.3,72.0
419,tt0061722,The Graduate,1967,"100,000+",183862,21821,2493,6996,4.2,90.0,,88,76,12,88,4.2,86.0
420,tt0094484,In the Heat of the Night,1967,"10,000+",23329,3645,306,1196,4.2,92.0,,90,86,4,90,4.2,96.0
421,tt0061418,Bonnie and Clyde,1967,"50,000+",56723,7501,1052,2374,4.1,88.0,,68,61,7,68,4.1,90.0
422,tt0060424,The Fortune Cookie,1966,"2,500+",4709,506,128,205,3.8,80.0,,28,27,1,28,3.8,96.0
423,tt0060736,The Naked Prey,1966,"1,000+",1656,257,68,119,3.9,79.0,,14,12,2,14,3.9,86.0
424,tt0061512,Cool Hand Luke,1967,"50,000+",63917,13019,721,4212,4.4,95.0,,56,56,0,56,4.4,100.0
425,tt0060588,Khartoum,1966,"1,000+",2254,191,100,89,3.6,66.0,,10,10,0,10,3.6,100.0
426,tt0060862,The Professionals,1966,"2,500+",3994,469,105,187,3.8,82.0,,19,17,2,19,3.8,89.0
427,tt0061735,Guess Who's Coming to Dinner,1967,"25,000+",38363,3762,642,1489,4.1,85.0,,38,27,11,38,4.1,71.0
428,tt0063227,The Lion in Winter,1968,"10,000+",13156,2100,233,896,4.4,90.0,,43,39,4,43,4.4,91.0
429,tt0061581,Divorce American Style,1967,"1,000+",1352,58,42,33,3.5,58.0,,8,8,0,8,3.5,100.0
430,tt0060481,La guerre est finie,1967,50+,67,53,14,13,3.9,79.0,,15,13,2,15,3.9,87.0
431,tt0061809,In Cold Blood,1967,"5,000+",8675,1235,170,412,4.1,88.0,,43,35,8,43,4.1,81.0
432,tt0063522,Rosemary's Baby,1968,"50,000+",74232,14149,2148,4074,4.1,87.0,,84,81,3,84,4.1,96.0
433,tt0062407,Two for the Road,1967,"5,000+",7976,1067,207,405,4.1,84.0,,24,20,4,24,4.1,83.0
434,tt0063385,Oliver!,1968,"50,000+",56162,2413,568,1376,4,81.0,,78,70,8,78,4,90.0
435,tt3595776,The Odd Couple,1968,"25,000+",31463,2881,356,962,4.2,89.0,,40,39,1,40,4.2,98.0
436,tt0395251,The Producers,1968,"50,000+",56213,6362,1117,2618,4.1,85.0,,74,67,7,74,4.1,91.0
437,tt0062622,2001: A Space Odyssey,1968,"250,000+",300414,45455,5878,17090,4.4,89.0,,118,108,10,118,4.4,92.0
438,tt0064030,Anne of the Thousand Days,1969,"2,500+",3303,419,88,182,4,83.0,,14,6,8,14,4,43.0
439,tt0064665,Midnight Cowboy,1969,"25,000+",40162,7090,975,2298,4.2,88.0,,116,103,13,116,4.2,89.0
440,tt0064115,Butch Cassidy and the Sundance Kid,1969,"50,000+",71375,13052,1105,3902,4.3,92.0,,58,52,6,58,4.3,90.0
441,tt0063094,Hot Millions,1968,250+,427,59,21,31,3.8,74.0,,6,4,2,6,3.8,67.0
442,tt0064381,"Goodbye, Columbus",1969,"1,000+",1119,42,42,28,3.3,50.0,,12,11,1,12,3.3,92.0
443,tt0066579,Women in Love,1970,"2,500+",2793,302,105,149,3.8,74.0,,23,19,4,23,3.8,83.0
444,tt0068098,M*A*S*H,1970,"50,000+",53253,5196,1098,1995,4,83.0,,58,49,9,58,4,84.0
445,tt0065088,"They Shoot Horses, Don't They?",1969,"5,000+",5596,984,124,320,4.1,89.0,,34,28,6,34,4.1,82.0
446,tt0065724,Five Easy Pieces,1970,"10,000+",13237,2668,506,889,4,84.0,,55,49,6,55,4,89.0
447,tt0065214,The Wild Bunch,1969,"25,000+",34339,5340,565,1773,4.3,90.0,,66,60,6,66,4.3,91.0
448,tt0064100,Bob & Carol & Ted & Alice,1969,"1,000+",1703,245,127,120,3.5,66.0,,61,50,11,61,3.5,82.0
449,tt0066011,Love Story,1970,"25,000+",35361,2670,908,1386,3.9,75.0,,29,19,10,29,3.9,66.0
450,tt0065377,Airport,1970,"10,000+",11300,538,468,327,3.3,53.0,,16,12,4,16,3.3,75.0
451,tt0065872,I Never Sang for My Father,1970,250+,437,84,18,34,4.1,82.0,,10,10,0,10,4.1,100.0
452,tt0064276,Easy Rider,1969,"50,000+",58883,8525,1874,3084,4,82.0,,56,47,9,56,4,84.0
453,tt0066016,Lovers and Other Strangers,1970,500+,787,38,13,22,3.7,75.0,,7,7,0,7,3.7,100.0
454,tt0067116,The French Connection,1971,"25,000+",44588,7637,1160,2333,4.1,87.0,,93,89,4,93,4.1,96.0
455,tt0067217,The Hospital,1971,"1,000+",2131,320,114,152,3.7,74.0,,14,14,0,14,3.7,100.0
456,tt8867238,Investigation of a Citizen Above Suspicion,1971,"1,000+",1709,453,28,81,4.3,94.0,,15,15,0,15,4.3,100.0
457,tt0067309,Klute,1971,"5,000+",6781,1160,296,398,3.8,80.0,,44,41,3,44,3.8,93.0
458,tt0066921,A Clockwork Orange,1971,"250,000+",437739,101123,7896,29750,4.4,93.0,,82,71,11,82,4.4,87.0
459,tt0067805,Sunday Bloody Sunday,1971,"2,500+",2680,258,108,105,3.7,70.0,,30,26,4,30,3.7,87.0
460,tt0068327,Cabaret,1972,"25,000+",36210,4661,720,1765,4.2,87.0,,48,44,4,48,4.2,92.0
461,tt4895994,The Garden of the Finzi-Continis,1971,"1,000+",1457,249,71,72,3.9,78.0,,16,15,1,16,3.9,94.0
462,tt0068646,The Godfather,1972,"250,000+",735966,163916,3728,40976,4.8,98.0,,151,147,4,151,4.8,97.0
463,tt0067328,The Last Picture Show,1971,"10,000+",14279,3292,389,959,4.2,89.0,,115,113,2,115,4.2,98.0
464,tt0067803,Summer of '42,1971,"2,500+",2789,244,91,121,3.8,73.0,,24,19,5,24,3.8,79.0
465,tt0069528,Young Winston,1972,250+,299,41,38,24,3.2,52.0,,11,6,5,11,3.2,55.0
466,tt0069080,Pete 'n' Tillie,1972,100+,197,20,8,3,3.5,71.0,,6,4,2,6,3.5,67.0
467,tt0070290,The Last Detail,1973,"5,000+",7421,1422,214,453,4,87.0,,38,33,5,38,4,87.0
468,tt0070735,The Sting,1973,"50,000+",61952,12218,652,3591,4.4,95.0,,108,100,8,108,4.4,93.0
469,tt0070819,A Touch of Class,1973,"1,000+",2043,88,49,44,3.5,65.0,,13,11,2,13,3.5,85.0
470,tt0070510,Paper Moon,1973,"10,000+",11482,2630,156,820,4.4,94.0,,47,43,4,47,4.4,91.0
471,tt0068828,Lady Sings the Blues,1972,"5,000+",8018,516,88,282,4.2,86.0,,19,13,6,19,4.2,68.0
472,tt0069303,Sounder,1972,"1,000+",1954,185,56,70,3.9,77.0,,22,20,2,22,3.9,91.0
473,tt0068334,The Candidate,1972,"5,000+",5010,604,216,229,3.7,74.0,,36,32,4,36,3.7,89.0
474,tt0070666,Serpico,1973,"50,000+",53907,7869,1054,1996,4.1,88.0,,55,51,4,55,4.1,93.0
475,tt0071315,Chinatown,1974,"50,000+",78347,22145,1730,5247,4.4,93.0,,79,78,1,79,4.4,99.0
476,tt0070509,The Paper Chase,1973,"2,500+",4528,493,193,218,3.7,72.0,,31,25,6,31,3.7,81.0
477,tt0071360,The Conversation,1974,"25,000+",35379,7108,845,2024,4.2,89.0,,71,69,2,71,4.2,97.0
478,tt0071155,The Apprenticeship of Duddy Kravitz,1974,500+,771,79,30,30,3.6,72.0,,14,13,1,14,3.6,93.0
479,tt0071562,The Godfather Part II,1974,"250,000+",412718,85914,2451,18710,4.7,97.0,,125,120,5,125,4.7,96.0
480,tt0071115,Alice Doesn't Live Here Anymore,1974,"5,000+",9903,1656,374,537,3.8,82.0,,82,75,7,82,3.8,91.0
481,tt0069704,American Graffiti,1973,"50,000+",64846,7444,1452,2641,4,84.0,,62,59,3,62,4,95.0
482,tt0070640,Save the Tiger,1973,"1,000+",2316,217,76,123,3.7,74.0,,28,24,4,28,3.7,86.0
483,tt0072890,Dog Day Afternoon,1975,"100,000+",110532,16385,1841,3865,4.2,90.0,,54,52,2,54,4.2,96.0
484,tt0071129,Amarcord,1975,"10,000+",18243,3498,374,780,4.3,90.0,,47,41,6,47,4.3,87.0
485,tt0073293,Lies My Father Told Me,1975,100+,170,17,3,5,4,85.0,,3,2,1,3,4,
486,tt0071598,Harry and Tonto,1974,"1,000+",1781,286,68,130,3.9,81.0,,32,28,4,32,3.9,88.0
487,tt0073486,One Flew Over the Cuckoo's Nest,1975,"250,000+",280364,61765,2478,14958,4.5,96.0,,120,112,8,120,4.5,93.0
488,tt3402236,Murder on the Orient Express,1974,"10,000+",20983,2447,676,832,3.8,78.0,,42,38,4,42,3.8,90.0
489,tt0072431,Young Frankenstein,1974,"100,000+",209625,31011,2561,10678,4.4,92.0,,72,68,4,72,4.4,94.0
490,tt0074119,All the President's Men,1976,"50,000+",50500,8045,703,2255,4.3,92.0,,71,67,4,71,4.3,94.0
491,tt0073766,The Sunshine Boys,1975,"1,000+",2476,218,83,78,3.7,72.0,,38,27,11,38,3.7,71.0
492,tt0073692,Shampoo,1975,"5,000+",6528,466,414,288,3.3,53.0,,39,26,13,39,3.3,67.0
493,tt0072826,Cousin cousine,1976,250+,350,36,18,12,3.6,67.0,,5,5,0,5,3.6,100.0
494,tt0075406,Voyage of the Damned,1976,250+,496,62,55,33,3.3,53.0,,13,10,3,13,3.3,77.0
495,tt0105323,Scent of a Woman,1975,500+,510,114,22,20,4,84.0,,4,4,0,4,4,
496,tt0074235,Bound for Glory,1976,"1,000+",1401,217,67,98,3.8,76.0,,25,21,4,25,3.8,84.0
497,tt0073341,The Man Who Would Be King,1975,"10,000+",16112,2752,289,912,4.3,90.0,,34,33,1,34,4.3,97.0
498,tt0072684,Barry Lyndon,1975,"25,000+",45306,9954,897,2594,4.4,92.0,,84,73,11,84,4.4,87.0
499,tt0075148,Rocky,1976,"250,000+",33403994,74632,33408,1432746,3.2,69.0,,72,66,6,72,3.2,92.0
500,tt0074958,Network,1976,"25,000+",36527,8996,676,3222,4.4,93.0,,75,69,6,75,4.4,92.0
501,tt0075194,The Seven-Per-Cent Solution,1976,500+,651,111,53,50,3.6,68.0,,17,12,5,17,3.6,71.0
502,tt0075686,Annie Hall,1977,"100,000+",153991,23616,1974,6518,4.4,92.0,,127,123,4,127,4.4,97.0
503,tt0076095,The Goodbye Girl,1977,"5,000+",7526,969,178,426,4,85.0,,25,20,5,25,4,80.0
504,tt0076843,The Turning Point,1977,"2,500+",2880,231,113,114,3.6,67.0,,27,17,10,27,3.6,63.0
505,tt0076489,"Oh, God!",1977,"5,000+",8284,341,232,217,3.5,59.0,,28,21,7,28,3.5,75.0
506,tt0076172,I Never Promised You a Rose Garden,1977,"1,000+",1067,33,27,28,3.3,55.0,,5,2,3,5,3.3,40.0
507,tt0077928,Midnight Express,1978,"25,000+",31219,4957,604,1416,4.2,89.0,,30,27,3,30,4.2,90.0
508,tt0075995,Equus,1977,"2,500+",3842,440,128,219,3.8,78.0,,22,15,7,22,3.8,68.0
509,tt0078878,Bloodbrothers,1978,100+,118,8,9,3,3.2,47.0,,2,1,1,2,3.2,
510,tt0077416,The Deer Hunter,1978,"100,000+",103845,21327,1995,5783,4.3,91.0,,132,114,18,132,4.3,86.0
511,tt0078444,An Unmarried Woman,1978,"1,000+",1833,188,70,84,3.7,73.0,,28,25,3,28,3.7,89.0
512,tt0077742,Interiors,1978,"5,000+",7693,1323,355,453,3.9,79.0,,17,13,4,17,3.9,76.0
513,tt0079417,Kramer vs. Kramer,1979,"25,000+",43628,7104,879,1953,4.1,89.0,,101,90,11,101,4.1,89.0
514,tt0077288,La Cage aux folles,1979,"5,000+",6418,839,149,244,4,85.0,,24,23,1,24,4,96.0
515,tt0077289,California Suite,1978,"2,500+",2760,137,160,80,3.2,46.0,,26,13,13,26,3.2,50.0
516,tt0077663,Heaven Can Wait,1978,"10,000+",13300,1093,504,387,3.6,68.0,,48,41,7,48,3.6,85.0
517,tt0079638,Norma Rae,1979,"5,000+",7213,656,173,221,3.8,79.0,,32,29,3,32,3.8,91.0
518,tt0078199,"Same Time, Next Year",1978,"2,500+",4460,408,73,196,4.1,85.0,,5,2,3,5,4.1,40.0
519,tt0078902,Breaking Away,1979,"5,000+",9399,1934,266,640,4.2,88.0,,42,40,2,42,4.2,95.0
520,tt0078966,The China Syndrome,1979,"5,000+",8961,1281,309,448,3.8,81.0,,40,35,5,40,3.8,88.0
521,tt0080310,'Breaker' Morant,1980,"2,500+",4969,713,72,272,4.2,91.0,,24,24,0,24,4.2,100.0
522,tt0078718,...And Justice for All,1979,"10,000+",19122,1803,437,575,3.9,80.0,,33,27,6,33,3.9,82.0
523,tt0081283,Ordinary People,1980,"10,000+",23315,3745,494,1363,4.2,88.0,,104,93,11,104,4.2,89.0
524,tt0080678,The Elephant Man,1980,Fewer than 50,48,14,2,1,3.9,88.0,,0,0,0,0,3.9,
525,tt0081568,The Stunt Man,1980,"2,500+",3920,461,170,222,3.8,73.0,,43,39,4,43,3.8,91.0
526,tt0078788,Apocalypse Now,1979,"250,000+",286833,63408,4043,16517,4.5,94.0,,95,93,2,95,4.5,98.0
527,tt0079477,A Little Romance,1979,"5,000+",5227,374,68,151,4.1,85.0,,29,21,8,29,4.1,72.0
528,tt3231564,Manhattan,1979,"50,000+",51933,12146,1114,2780,4.3,92.0,,70,66,4,70,4.3,94.0
529,tt0078754,All That Jazz,1979,"10,000+",11835,2111,358,759,4.1,86.0,,46,40,6,46,4.1,87.0
530,tt0080549,Coal Miner's Daughter,1980,"25,000+",36344,2131,350,893,4.2,86.0,,63,54,9,63,4.2,86.0
531,tt0082416,The French Lieutenant's Woman,1981,"5,000+",6933,639,315,248,3.6,67.0,,29,24,5,29,3.6,83.0
532,tt0082846,On Golden Pond,1981,"10,000+",20647,2431,377,936,4.1,87.0,,44,40,4,44,4.1,91.0
533,tt0081974,Absence of Malice,1981,"2,500+",4621,416,243,170,3.5,63.0,,27,22,5,27,3.5,81.0
534,tt0080474,Brubaker,1980,"5,000+",6690,675,244,195,3.7,73.0,,24,18,6,24,3.7,75.0
535,tt0081176,Mon oncle d'Amérique,1980,"1,000+",1941,303,47,71,4.1,87.0,,14,12,2,14,4.1,86.0
536,tt0081150,Melvin and Howard,1980,"1,000+",1674,157,103,83,3.5,60.0,,24,22,2,24,3.5,92.0
537,tt0080388,Atlantic City,1981,"5,000+",5264,654,190,204,3.8,77.0,,38,38,0,38,3.8,100.0
538,tt0082158,Chariots of Fire,1981,"25,000+",37275,4107,1038,1671,4,80.0,,115,96,19,115,4,83.0
539,tt0083412,Fame,1980,"25,000+",40470,1846,842,1118,3.7,69.0,,34,27,7,34,3.7,79.0
540,tt0082979,Reds,1981,"5,000+",9043,1645,352,618,4,82.0,,49,44,5,49,4,90.0
541,tt0081375,Private Benjamin,1980,"25,000+",35969,943,625,576,3.5,60.0,,35,29,6,35,3.5,83.0
542,tt0028092,Pennies from Heaven,1981,"2,500+",3717,272,149,168,3.5,65.0,,29,24,5,29,3.5,83.0
543,tt0082945,Prince of the City,1981,"1,000+",1329,331,75,125,3.9,81.0,,26,24,2,26,3.9,92.0
544,tt0082970,Ragtime,1981,"2,500+",2983,297,92,119,3.8,76.0,,18,15,3,18,3.8,83.0
545,tt5830254,Das Boot,1982,"25,000+",47571,9044,426,2948,4.5,96.0,,58,57,1,58,4.5,98.0
546,tt0084855,The Verdict,1982,"10,000+",10475,2434,328,749,4.1,88.0,,37,33,4,37,4.1,89.0
547,tt0083866,E.T. the Extra-Terrestrial,1982,"250,000+",32314349,82689,32311,1318882,3.5,72.0,,145,143,2,145,3.5,99.0
548,tt0083987,Gandhi,1982,"25,000+",49947,8374,731,2481,4.3,92.0,,110,98,12,110,4.3,89.0
549,tt0084805,Tootsie,1982,"50,000+",58673,6271,1443,2154,3.9,81.0,,53,48,5,53,3.9,91.0
550,tt4247618,The Dresser,1983,"1,000+",1818,252,40,90,4,86.0,,15,15,0,15,4,100.0
551,tt0085478,Educating Rita,1983,"5,000+",7872,979,231,418,3.9,81.0,,17,14,3,17,3.9,82.0
552,tt0084707,Sophie's Choice,1982,"10,000+",21616,3541,637,1230,4.1,85.0,,42,32,10,42,4.1,76.0
553,tt0086425,Terms of Endearment,1983,"25,000+",36434,4179,834,1530,4,83.0,,109,89,20,109,4,82.0
554,tt0085244,The Big Chill,1983,"10,000+",22403,2643,789,1004,3.9,77.0,,41,29,12,41,3.9,71.0
555,tt0083922,Fanny och Alexander,1983,"10,000+",21460,4076,274,1027,4.5,94.0,,45,45,0,45,4.5,100.0
556,tt0084865,Victor/Victoria,1982,"10,000+",16541,1850,312,699,4.1,86.0,,36,35,1,36,4.1,97.0
557,tt0086879,Amadeus,1984,"100,000+",180470,24046,1328,7757,4.5,95.0,,153,136,17,153,4.5,89.0
558,tt0087553,The Killing Fields,1984,"10,000+",23190,3540,331,1093,4.2,91.0,,43,40,3,43,4.2,93.0
559,tt0084434,An Officer and a Gentleman,1982,"50,000+",51215,4004,967,1669,4,81.0,,33,26,7,33,4,79.0
560,tt0083833,Diner,1982,"5,000+",9550,1455,424,486,3.8,77.0,,49,45,4,49,3.8,92.0
561,tt0087892,A Passage to India,1984,"5,000+",6973,943,254,351,3.8,79.0,,28,22,6,28,3.8,79.0
562,tt0088146,A Soldier's Story,1984,"5,000+",6530,524,118,147,3.9,82.0,,22,20,2,22,3.9,91.0
563,tt0086567,WarGames,1983,"50,000+",52826,4858,1552,1985,3.8,76.0,,47,44,3,47,3.8,94.0
564,tt0086423,Tender Mercies,1983,"2,500+",3644,602,139,215,4,81.0,,28,23,5,28,4,82.0
565,tt0087921,Places in the Heart,1984,"5,000+",6770,725,149,244,4,83.0,,38,34,4,38,4,89.0
566,tt0086312,Silkwood,1983,"10,000+",10023,1118,309,359,3.8,78.0,,37,28,9,37,3.8,76.0
567,tt0089841,Prizzi's Honor,1985,"5,000+",7954,822,501,323,3.4,62.0,,41,35,6,41,3.4,85.0
568,tt0089755,Out of Africa,1985,"25,000+",40442,5959,1271,2101,4.1,82.0,,89,56,33,89,4.1,63.0
569,tt0087365,"Greystoke: The Legend of Tarzan, Lord of the Apes",1984,"10,000+",15049,519,341,276,3.5,60.0,,15,11,4,15,3.5,73.0
570,tt0088763,Back to the Future,1985,"250,000+",1097197,106004,6169,39791,4.5,94.0,,110,102,8,110,4.5,93.0
571,tt0087003,Broadway Danny Rose,1984,"5,000+",9549,1880,351,452,4,84.0,,29,29,0,29,4,100.0
572,tt0085482,El Norte,1984,"1,000+",2390,426,93,158,4,82.0,,61,56,5,61,4,92.0
573,tt1200263,The Color Purple,1985,"100,000+",181096,19923,1347,7806,4.5,94.0,,123,89,34,123,4.5,72.0
574,tt0088161,Splash,1984,"100,000+",120219,66,42,15,3.5,61.0,,44,40,4,44,3.5,91.0
575,tt0089853,The Purple Rose of Cairo,1985,"10,000+",20423,3803,534,962,4.1,88.0,,41,38,3,41,4.1,93.0
576,tt0088846,Brazil,1985,"100,000+",103269,24366,2676,7429,4.3,90.0,,54,53,1,54,4.3,98.0
577,tt0090329,Witness,1985,"25,000+",46965,4802,1198,1508,3.9,80.0,,45,42,3,45,3.9,93.0
578,tt0089424,Kiss of the Spider Woman,1985,"5,000+",7215,913,221,301,3.9,80.0,,35,30,5,35,3.9,86.0
579,tt0090203,The Trip to Bountiful,1985,"1,000+",1551,241,41,98,4.1,85.0,,10,10,0,10,4.1,100.0
580,tt0091167,Hannah and Her Sisters,1986,"25,000+",31172,5582,601,1335,4.2,90.0,,57,52,5,57,4.2,91.0
581,tt0090863,The Color of Money,1986,"25,000+",46235,4321,1566,1284,3.7,73.0,,49,43,6,49,3.7,88.0
582,tt0091763,Platoon,1986,"100,000+",240410,36055,2723,9646,4.3,93.0,,123,110,13,123,4.3,89.0
583,tt0092005,Stand by Me,1986,"250,000+",270872,38014,2235,13380,4.4,94.0,,63,58,5,63,4.4,92.0
584,tt0090830,Children of a Lesser God,1986,"5,000+",8584,1006,280,375,3.9,78.0,,35,28,7,35,3.9,80.0
585,tt0091578,My Beautiful Laundrette,1986,"5,000+",7207,1039,365,379,3.8,74.0,,45,44,1,45,3.8,98.0
586,tt0090555,Crocodile Dundee,1986,"250,000+",254517,3407,2341,3579,3.5,59.0,,36,32,4,36,3.5,89.0
587,tt0091867,A Room with a View,1986,"25,000+",25533,4293,743,1352,4.2,85.0,,34,34,0,34,4.2,100.0
588,tt0090886,Crimes of the Heart,1986,"2,500+",2760,170,93,70,3.7,65.0,,22,18,4,22,3.7,82.0
589,tt0093389,The Last Emperor,1987,"25,000+",40075,4999,686,1380,4.1,88.0,,124,107,17,124,4.1,86.0
590,tt0118408,My Life as a Dog,1987,"5,000+",8998,1991,210,537,4.3,90.0,,34,34,0,34,4.3,100.0
591,tt0093058,Full Metal Jacket,1987,"250,000+",325334,67122,4300,18547,4.4,94.0,,86,77,9,86,4.4,90.0
592,tt0092593,Au revoir les enfants,1987,"10,000+",11836,2783,209,743,4.3,93.0,,37,36,1,37,4.3,97.0
593,tt0092699,Broadcast News,1987,"10,000+",11092,1975,529,623,3.9,79.0,,57,56,1,57,3.9,98.0
594,tt0093209,Hope and Glory,1987,"5,000+",5833,670,147,241,4,82.0,,26,25,1,26,4,96.0
595,tt0093565,Moonstruck,1987,"25,000+",44979,4807,1167,1949,4,80.0,,74,68,6,74,4,92.0
596,tt0091886,Salvador,1986,"5,000+",8574,1296,220,415,4,86.0,,29,26,3,29,4,90.0
597,tt0093010,Fatal Attraction,1987,"50,000+",53178,3958,1557,1914,3.7,72.0,,61,45,16,61,3.7,74.0
598,tt0094606,The Accidental Tourist,1988,"5,000+",6240,610,402,274,3.5,60.0,,34,28,6,34,3.5,82.0
599,tt0095953,Rain Man,1988,"250,000+",314537,30188,3177,9851,4.2,90.0,,137,121,16,137,4.2,88.0
600,tt0096018,Running on Empty,1988,"10,000+",10490,1925,874,449,3.7,69.0,,31,25,6,31,3.7,81.0
601,tt0096969,Born on the Fourth of July,1989,"50,000+",59514,5357,1666,1697,3.8,76.0,,56,47,9,56,3.8,84.0
602,tt0094947,Dangerous Liaisons,1988,"25,000+",46692,6609,1390,1780,4,83.0,,34,32,2,34,4,94.0
603,tt0093818,Radio Days,1987,"10,000+",11409,2160,408,524,4,84.0,,38,35,3,38,4,92.0
604,tt0096332,The Unbearable Lightness of Being,1988,"10,000+",19506,3215,599,955,4.1,84.0,,29,25,4,29,4.1,86.0
605,tt0094812,Bull Durham,1988,"50,000+",51253,5411,1191,1820,4,82.0,,72,70,2,72,4,97.0
606,tt0095159,A Fish Called Wanda,1988,"100,000+",181413,9163,1715,3934,4,84.0,,68,65,3,68,4,96.0
607,tt0097239,Driving Miss Daisy,1989,"50,000+",53840,4934,1156,1640,3.9,81.0,,105,89,16,105,3.9,85.0
608,tt0097165,Dead Poets Society,1989,"250,000+",307794,45930,3883,13544,4.3,92.0,,63,53,10,63,4.3,84.0
609,tt0097216,Do the Right Thing,1989,"50,000+",73982,10328,1217,3384,4.3,89.0,,108,99,9,108,4.3,92.0
610,tt0098635,When Harry Met Sally...,1989,"250,000+",396395,31608,4066,12285,4.2,89.0,,79,72,7,79,4.2,91.0
611,tt0097276,Enemies: A Love Story,1989,"1,000+",1295,46,39,24,3.4,54.0,,28,25,3,28,3.4,89.0
612,tt0098724,"Sex, Lies, and Videotape",1989,"25,000+",32696,3700,991,1071,3.9,79.0,,54,52,2,54,3.9,96.0
613,tt0099348,Dances with Wolves,1990,"100,000+",214037,18565,2843,7034,4.2,87.0,,131,114,17,131,4.2,87.0
614,tt0099685,Goodfellas,1990,"250,000+",431307,117712,3434,29247,4.6,97.0,,161,152,9,161,4.6,94.0
615,tt0097123,Crimes and Misdemeanors,1989,"10,000+",23757,4666,488,1184,4.2,91.0,,51,47,4,51,4.2,92.0
616,tt0100486,Reversal of Fortune,1990,"5,000+",5494,717,205,228,3.8,78.0,,53,49,4,53,3.8,92.0
617,tt0097351,Field of Dreams,1989,"100,000+",193224,13910,2261,6181,4.2,86.0,,65,57,8,65,4.2,88.0
618,tt13261268,Avalon,1990,"2,500+",3259,318,91,114,4,78.0,,28,24,4,28,4,86.0
619,tt0099703,The Grifters,1990,"10,000+",11070,1462,638,515,3.6,70.0,,47,43,4,47,3.6,91.0
620,tt0102138,JFK,1991,"50,000+",62793,10165,1345,3464,4.2,88.0,,70,59,11,70,4.2,84.0
621,tt0099077,Awakenings,1990,"50,000+",55374,7060,857,2024,4.1,89.0,,37,31,6,37,4.1,84.0
622,tt0101516,Bugsy,1991,"10,000+",10285,1099,491,369,3.6,69.0,,64,54,10,64,3.6,84.0
623,tt0102926,The Silence of the Lambs,1991,"250,000+",848625,85982,4183,29637,4.4,95.0,,153,145,8,153,4.4,95.0
624,tt0103074,Thelma & Louise,1991,"100,000+",170526,10330,2255,3591,4,82.0,,153,132,21,153,4,86.0
625,tt0101969,Grand Canyon,1991,"5,000+",7638,789,334,293,3.7,70.0,,37,29,8,37,3.7,78.0
626,tt0100142,Metropolitan,1990,"5,000+",5346,969,178,340,4,84.0,,43,40,3,43,4,93.0
627,tt0104454,Howards End,1992,"10,000+",13748,1884,431,537,4,81.0,,69,65,4,69,4,94.0
628,tt0101507,Boyz n the Hood,1991,"100,000+",144507,13797,1094,3891,4.4,93.0,,71,68,3,71,4.4,96.0
629,tt0102713,The Prince of Tides,1991,"5,000+",9265,922,388,403,3.7,70.0,,34,23,11,34,3.7,68.0
630,tt0101921,Fried Green Tomatoes,1991,"100,000+",120435,102,17,23,4.2,86.0,,45,34,11,45,4.2,76.0
631,tt0099699,Green Card,1990,"25,000+",26308,869,860,460,3.3,50.0,,32,19,13,32,3.3,59.0
632,tt0105151,The Player,1992,"10,000+",20712,3372,626,901,4,84.0,,68,66,2,68,4,97.0
633,tt0104036,The Crying Game,1992,"25,000+",31941,4032,1116,1288,3.8,78.0,,72,68,4,72,3.8,94.0
634,tt0105323,Scent of a Woman,1992,"100,000+",119641,17495,1475,5064,4.3,92.0,,48,41,7,48,4.3,85.0
635,tt0101889,The Fisher King,1991,"25,000+",45912,6256,1060,1826,4,85.0,,65,55,10,65,4,85.0
636,tt0105695,Unforgiven,1992,"100,000+",123281,22112,1567,6491,4.4,93.0,,110,106,4,110,4.4,96.0
637,tt0105265,A River Runs Through It,1992,"50,000+",67964,6582,1323,2070,4,83.0,,45,36,9,45,4,80.0
638,tt0101811,Enchanted April,1992,"5,000+",7657,643,127,261,4.1,83.0,,33,28,5,33,4.1,85.0
639,tt0104756,Lorenzo's Oil,1992,"10,000+",15288,1633,417,591,3.9,80.0,,40,37,3,40,3.9,93.0
640,tt0107207,In the Name of the Father,1993,"25,000+",41458,7706,396,1873,4.4,95.0,,50,47,3,50,4.4,94.0
641,tt0106226,The Age of Innocence,1993,"10,000+",24057,3286,1076,1019,3.8,75.0,,65,57,8,65,3.8,88.0
642,tt0107943,The Remains of the Day,1993,"10,000+",24488,4102,482,1128,4.2,89.0,,47,45,2,47,4.2,96.0
643,tt0107822,The Piano,1993,"25,000+",48590,8471,1395,2363,4.1,86.0,,71,64,7,71,4.1,90.0
644,tt0104466,Husbands and Wives,1992,"10,000+",14208,2591,398,559,4,87.0,,43,40,3,43,4,93.0
645,tt0105107,Passion Fish,1992,"2,500+",2883,288,62,98,4,82.0,,26,26,0,26,4,100.0
646,tt0108052,Schindler's List,1993,"250,000+",413183,82246,2643,22968,4.6,97.0,,134,131,3,134,4.6,98.0
647,tt0109830,Forrest Gump,1994,"250,000+",1244237,170818,8770,92568,4.1,95.0,,108,77,31,108,4.1,71.0
648,tt0110932,Quiz Show,1994,"25,000+",31681,4204,645,1053,4,87.0,,59,57,2,59,4,97.0
649,tt0108101,Shadowlands,1993,"10,000+",10086,1651,204,658,4.3,89.0,,30,29,1,30,4.3,97.0
650,tt0111161,The Shawshank Redemption,1994,"250,000+",889823,176662,2776,53482,4.7,98.0,,82,75,7,82,4.7,91.0
651,tt0109831,Four Weddings and a Funeral,1994,"100,000+",185233,8230,2919,3642,3.8,74.0,,73,70,3,73,3.8,96.0
652,tt0107206,In the Line of Fire,1993,"50,000+",55232,4414,1172,1260,3.8,79.0,,73,70,3,73,3.8,96.0
653,tt0108160,Sleepless in Seattle,1993,"250,000+",297563,16679,5640,7936,3.8,75.0,,61,46,15,61,3.8,75.0
654,tt0110428,The Madness of King George,1994,"5,000+",8409,993,246,347,3.9,80.0,,47,44,3,47,3.9,94.0
655,tt0110912,Pulp Fiction,1994,"250,000+",1130319,228493,9056,62525,4.6,96.0,,116,107,9,116,4.6,92.0
656,tt0110005,Heavenly Creatures,1994,"25,000+",40197,5167,1078,1857,4,83.0,,108,103,5,108,4,95.0
657,tt0110684,Nobody's Fool,1994,"5,000+",8573,1016,230,330,4,82.0,,57,52,5,57,4,91.0
658,tt0109348,Bullets Over Broadway,1994,"10,000+",17063,2404,485,636,3.9,83.0,,60,57,3,60,3.9,95.0
659,tt0114388,Sense and Sensibility,1995,"100,000+",131025,18837,2127,6608,4.2,90.0,,68,66,2,68,4.2,97.0
660,tt0112573,Braveheart,1995,"250,000+",32708456,126902,22193,1198232,3.8,85.0,,127,96,31,127,3.8,76.0
661,tt0112384,Apollo 13,1995,"250,000+",433304,22045,3336,9090,4.1,87.0,,97,93,4,97,4.1,96.0
662,tt0113627,Leaving Las Vegas,1995,"50,000+",56708,7987,1410,2679,4.1,85.0,,53,48,5,53,4.1,91.0
663,tt0116209,The English Patient,1996,"50,000+",81874,13989,2905,4511,4.1,83.0,,94,81,13,94,4.1,86.0
664,tt0113819,Mighty Aphrodite,1995,"10,000+",21136,2138,797,618,3.6,73.0,,37,29,8,37,3.6,78.0
665,tt0114814,The Usual Suspects,1995,"250,000+",435681,92887,4000,25647,4.5,96.0,,81,71,10,81,4.5,88.0
666,tt2802850,Fargo,1996,"100,000+",235005,48292,3923,12439,4.3,92.0,,106,100,6,106,4.3,94.0
667,tt0112431,Babe,1995,"250,000+",508991,8702,4227,10142,3.7,67.0,,71,69,2,71,3.7,97.0
668,tt0114709,Toy Story,1995,"250,000+",1109209,74823,6454,49719,3.8,92.0,,97,97,0,97,3.8,100.0
669,tt0117951,Trainspotting,1996,"250,000+",314082,70363,5046,16445,4.3,93.0,,89,80,9,89,4.3,90.0
670,tt0117631,Shine,1996,"25,000+",30934,4152,471,1101,4.2,90.0,,44,40,4,44,4.2,91.0
671,tt0116477,Hamlet,1996,"25,000+",32662,3962,468,1680,4.3,89.0,,57,54,3,57,4.3,95.0
672,tt0117666,Sling Blade,1996,"50,000+",56205,7811,639,2749,4.3,92.0,,58,56,2,58,4.3,97.0
673,tt0119488,L.A. Confidential,1997,"100,000+",151391,25044,1582,6439,4.4,94.0,,165,164,1,165,4.4,99.0
674,tt0120885,Wag the Dog,1997,"25,000+",44694,4519,1407,1508,3.8,76.0,,78,67,11,78,3.8,86.0
675,tt0115988,The Crucible,1996,"25,000+",32019,2667,1384,1298,3.6,66.0,,64,45,19,64,3.6,70.0
676,tt0117589,Secrets & Lies,1996,"10,000+",11360,2399,225,649,4.3,91.0,,45,43,2,45,4.3,96.0
677,tt0119822,As Good as It Gets,1997,"250,000+",378952,19511,3054,9108,4.1,86.0,,85,73,12,85,4.1,86.0
678,tt0119008,Donnie Brasco,1997,"100,000+",204597,23010,2875,5884,4.1,89.0,,57,50,7,57,4.1,88.0
679,tt0116695,Jerry Maguire,1996,"250,000+",442799,17608,4708,11179,3.9,79.0,,90,76,14,90,3.9,84.0
680,tt0120255,The Sweet Hereafter,1997,"10,000+",11689,2364,392,729,4.1,86.0,,60,59,1,60,4.1,98.0
681,tt0119217,Good Will Hunting,1997,"250,000+",365875,63244,3698,15764,4.4,94.0,,91,88,3,91,4.4,97.0
682,tt0120520,The Wings of the Dove,1997,"5,000+",5615,637,178,199,3.9,78.0,,34,29,5,34,3.9,85.0
683,tt0118749,Boogie Nights,1997,"100,000+",189978,21282,2516,6390,4.2,89.0,,77,72,5,77,4.2,94.0
684,tt0118798,Bulworth,1998,"10,000+",20656,1432,683,572,3.6,68.0,,68,52,16,68,3.6,76.0
685,tt0138097,Shakespeare in Love,1998,"100,000+",227207,17611,4522,6929,3.9,80.0,,147,135,12,147,3.9,92.0
686,tt0120815,Saving Private Ryan,1998,"250,000+",994594,113250,5928,41365,4.5,95.0,,148,139,9,148,4.5,94.0
687,tt0120382,The Truman Show,1998,"250,000+",585107,52493,6586,19738,4.1,89.0,,162,153,9,162,4.1,94.0
688,tt0118954,Deconstructing Harry,1997,"10,000+",22277,3050,668,709,3.9,82.0,,37,27,10,37,3.9,73.0
689,tt0119942,Primary Colors,1998,"10,000+",19994,1243,693,546,3.5,64.0,,79,63,16,79,3.5,80.0
690,tt0120324,A Simple Plan,1998,"25,000+",39480,3761,886,1231,3.8,81.0,,73,66,7,73,3.8,90.0
691,tt0119164,The Full Monty,1997,"100,000+",180256,6408,1691,3092,3.9,79.0,,54,52,2,54,3.9,96.0
692,tt0120780,Out of Sight,1998,"50,000+",59958,5163,1791,1871,3.8,74.0,,106,100,6,106,3.8,94.0
693,tt0124315,The Cider House Rules,1999,"50,000+",53600,5390,1593,1787,3.8,77.0,,111,79,32,111,3.8,71.0
694,tt0120863,The Thin Red Line,1998,"100,000+",148945,14589,3660,5236,4,80.0,,107,86,21,107,4,80.0
695,tt0120684,Gods and Monsters,1998,"10,000+",13168,1768,376,607,3.9,83.0,,71,68,3,71,3.9,96.0
696,tt0169547,American Beauty,1999,"250,000+",661369,97659,7418,29042,4.4,93.0,,192,167,25,192,4.4,87.0
697,tt0140352,The Insider,1999,0,0,0,0,0,,,,0,0,0,0,,
698,tt0120601,Being John Malkovich,1999,"250,000+",262977,38797,5867,11373,4.1,87.0,,135,127,8,135,4.1,94.0
699,tt0126886,Election,1999,"50,000+",61974,7304,1925,2587,3.8,79.0,,115,106,9,115,3.8,92.0
700,tt0120689,The Green Mile,1999,"250,000+",815012,93120,5759,31687,4.4,94.0,,136,107,29,136,4.4,79.0
701,tt0167404,The Sixth Sense,1999,"250,000+",1037520,70547,8157,39158,4.2,90.0,,162,139,23,162,4.2,86.0
702,tt3981658,"New Crouching Tiger, Hidden Dragon",2000,"250,000+",427893,29181,4725,13700,4.1,86.0,,170,166,4,170,4.1,98.0
703,tt0185014,Wonder Boys,2000,"25,000+",40336,4608,954,1558,4,83.0,,127,103,24,127,4,81.0
704,tt0181865,Traffic,2000,"100,000+",190654,17711,3228,4677,4,85.0,,223,208,15,223,4,93.0
705,tt0134119,The Talented Mr. Ripley,1999,"100,000+",132036,12090,3032,4000,3.8,80.0,,138,117,21,138,3.8,85.0
706,tt0181875,Almost Famous,2000,"250,000+",325433,47287,4278,14940,4.3,92.0,,177,158,19,177,4.3,89.0
707,tt0151568,Topsy-Turvy,1999,"5,000+",5654,621,166,231,3.9,79.0,,89,80,9,89,3.9,90.0
708,tt0175880,Magnolia,1999,"100,000+",193281,31173,3673,10092,4.3,89.0,,216,177,39,216,4.3,82.0
709,tt0268978,A Beautiful Mind,2001,"250,000+",491450,81611,6576,20882,4.3,93.0,,214,159,55,214,4.3,74.0
710,tt0203230,You Can Count on Me,2000,"10,000+",10709,2260,311,687,4.1,88.0,,105,100,5,105,4.1,95.0
711,tt0190590,"O Brother, Where Art Thou?",2000,"250,000+",257029,28570,3642,11525,4.1,89.0,,156,122,34,156,4.1,78.0
712,tt0241303,Chocolat,2000,"250,000+",329147,35773,7232,13003,4,83.0,,119,75,44,119,4,63.0
713,tt0195685,Erin Brockovich,2000,"250,000+",418943,13393,3174,8239,3.9,81.0,,150,127,23,150,3.9,85.0
714,tt0249462,Billy Elliot,2000,"250,000+",280750,12295,1553,5390,4.2,89.0,,119,101,18,119,4.2,85.0
715,tt0280707,Gosford Park,2001,"25,000+",48630,6161,1742,2471,3.8,78.0,,165,144,21,165,3.8,87.0
716,tt0209144,Memento,2001,"250,000+",382236,96121,5700,27555,4.4,94.0,,185,173,12,185,4.4,94.0
717,tt0120737,The Lord of the Rings: The Fellowship of the Ring,2001,"250,000+",1355751,167643,8379,80557,4.1,95.0,,235,215,20,235,4.1,91.0
718,tt0162346,Ghost World,2001,"50,000+",73651,12698,2448,4245,4,84.0,,165,153,12,165,4,93.0
719,tt0268126,Adaptation.,2002,"100,000+",188978,26840,4667,8495,4,85.0,,210,190,20,210,4,90.0
720,tt0247425,In the Bedroom,2001,"10,000+",20189,2815,649,1073,3.9,81.0,,141,131,10,141,3.9,93.0
721,tt0274558,The Hours,2002,"50,000+",86056,14835,2736,4501,4.1,84.0,,195,155,40,195,4.1,79.0
722,tt0172495,Gladiator,2000,"250,000+",34128168,170538,24401,1652336,3.8,87.0,,257,205,52,257,3.8,80.0
723,tt0297884,Far from Heaven,2002,"10,000+",23317,3209,835,1103,3.9,79.0,,222,194,28,222,3.9,87.0
724,tt0126029,Shrek,2001,"250,000+",1378744,90504,10347,84689,3.9,90.0,,211,185,26,211,3.9,88.0
725,tt0276751,About a Boy,2002,"250,000+",31164074,37601,31257,792589,2.8,55.0,,184,171,13,184,2.8,93.0
726,tt0245574,Y tu mamá también,2002,"50,000+",69920,16471,2202,4343,4.1,88.0,,192,174,18,192,4.1,91.0
727,tt0265666,The Royal Tenenbaums,2001,"250,000+",256441,49091,6244,14421,4.2,89.0,,217,176,41,217,4.2,81.0
728,tt0285742,Monster's Ball,2001,"50,000+",57834,4784,2323,2266,3.6,67.0,,142,121,21,142,3.6,85.0
729,tt0327056,Mystic River,2003,"100,000+",204004,24609,2995,7594,4.1,89.0,,204,181,23,204,4.1,89.0
730,tt0167260,The Lord of the Rings: The Return of the King,2003,"250,000+",34679773,193983,30876,2050091,3.6,86.0,,278,261,17,278,3.6,94.0
731,tt0217505,Gangs of New York,2002,"250,000+",294825,28820,6722,11175,3.9,81.0,,215,156,59,215,3.9,73.0
732,tt0335266,Lost in Translation,2003,"250,000+",338129,69526,11826,22313,4.1,85.0,,235,224,11,235,4.1,95.0
733,tt0318997,Angels in America,2003,Fewer than 50,15,13,2,5,4.3,87.0,,0,0,0,0,4.3,
734,tt0266543,Finding Nemo,2003,"250,000+",33356856,276267,43291,1434748,3.8,86.0,,270,268,2,270,3.8,99.0
735,tt0308644,Finding Neverland,2004,"250,000+",465560,40370,6137,19216,4.1,87.0,,206,170,36,206,4.1,83.0
736,tt0329575,Seabiscuit,2003,"100,000+",118520,5952,1912,2838,3.8,76.0,,208,162,46,208,3.8,78.0
737,tt0375063,Sideways,2004,"100,000+",197951,26465,7227,10822,3.8,79.0,,231,223,8,231,3.8,97.0
738,tt0305206,American Splendor,2003,"25,000+",44613,6070,972,2166,4,86.0,,186,174,12,186,4,94.0
739,tt0405159,Million Dollar Baby,2004,"250,000+",405500,42848,4895,15873,4.2,90.0,,270,244,26,270,4.2,90.0
740,tt0338751,The Aviator,2004,"100,000+",207945,21497,5640,8025,3.8,79.0,,226,195,31,226,3.8,86.0
741,tt0253474,The Pianist,2002,"250,000+",253877,47794,2234,10831,4.4,96.0,,189,179,10,189,4.4,95.0
742,tt0301199,Dirty Pretty Things,2003,"25,000+",31459,3863,835,1231,3.9,82.0,,142,134,8,142,3.9,94.0
743,tt0338013,Eternal Sunshine of the Spotless Mind,2004,"250,000+",572817,152999,9510,46631,4.5,94.0,,256,236,20,256,4.5,92.0
744,tt0388795,Brokeback Mountain,2005,"250,000+",520390,41156,8824,27157,4,82.0,,251,221,30,251,4,88.0
745,tt0408306,Munich,2005,"250,000+",330482,20783,4224,10608,3.9,83.0,,208,163,45,208,3.9,78.0
746,tt0381681,Before Sunset,2004,"50,000+",71393,19246,1784,5148,4.3,91.0,,179,169,10,179,4.3,94.0
747,tt0395169,Hotel Rwanda,2004,"100,000+",241649,39922,2583,12296,4.3,94.0,,191,173,18,191,4.3,91.0
748,tt0433383,"Good Night, and Good Luck.",2005,"100,000+",142797,11298,2305,4976,3.9,83.0,,225,210,15,225,3.9,93.0
749,tt0416320,Match Point,2005,"250,000+",250875,22706,5347,8658,3.9,81.0,,216,166,50,216,3.9,77.0
750,tt0375679,Crash,2005,"250,000+",442573,70429,9411,29796,4.2,88.0,,242,178,64,242,4.2,74.0
751,tt0383694,Vera Drake,2004,"10,000+",11650,1997,385,750,3.9,84.0,,161,149,12,161,3.9,93.0
752,tt0379725,Capote,2005,"100,000+",116073,11960,2705,5270,3.9,82.0,,196,175,21,196,3.9,89.0
753,tt0317705,The Incredibles,2004,"250,000+",32604129,110921,36914,1099153,3.4,75.0,,250,243,7,250,3.4,97.0
754,tt0387131,The Constant Gardener,2005,"100,000+",217727,19169,4208,7508,3.9,82.0,,192,160,32,192,3.9,83.0
755,tt0443453,Borat: Cultural Learnings of America for Make Benefit Glorious Nation of Kazakhstan,2006,"250,000+",1205529,66751,17821,43540,3.9,79.0,,222,201,21,222,3.9,91.0
756,tt0399146,A History of Violence,2005,"250,000+",280290,18602,5833,11056,3.7,76.0,,216,189,27,216,3.7,88.0
757,tt0407887,The Departed,2006,"250,000+",739210,163638,11058,58090,4.4,94.0,,287,260,27,287,4.4,91.0
758,tt0367089,The Squid and the Whale,2005,"50,000+",79192,13580,3147,4847,3.9,81.0,,153,140,13,153,3.9,92.0
759,tt0365737,Syriana,2005,"100,000+",226965,13694,6620,7355,3.5,67.0,,198,144,54,198,3.5,73.0
760,tt0449467,Babel,2006,"250,000+",377495,46725,13945,19816,3.8,77.0,,207,143,64,207,3.8,69.0
761,tt0404203,Little Children,2006,"50,000+",95569,15184,3388,7484,3.9,82.0,,162,129,33,162,3.9,80.0
762,tt0465551,Notes on a Scandal,2006,"50,000+",77866,12099,2527,6640,3.9,83.0,,176,154,22,176,3.9,88.0
763,tt0498380,Letters from Iwo Jima,2006,"250,000+",341234,24403,3844,10128,4.1,86.0,,204,186,18,204,4.1,91.0
764,tt0206634,Children of Men,2006,"250,000+",531607,77826,14091,39158,4.1,85.0,,256,236,20,256,4.1,92.0
765,tt0449059,Little Miss Sunshine,2006,"250,000+",427835,120314,11299,45164,4.3,91.0,,219,199,20,219,4.3,91.0
766,tt0783233,Atonement,2007,"100,000+",227451,59833,15221,31939,3.9,80.0,,220,183,37,220,3.9,83.0
767,tt0477348,No Country for Old Men,2007,"250,000+",400568,123254,19634,60240,4.2,86.0,,289,270,19,289,4.2,93.0
768,tt0469494,There Will Be Blood,2007,"250,000+",256078,73079,11850,36744,4.2,86.0,,247,226,21,247,4.2,91.0
769,tt0421715,The Curious Case of Benjamin Button,2008,"250,000+",691235,67750,16953,37517,3.9,80.0,,256,183,73,256,3.9,71.0
770,tt1010048,Slumdog Millionaire,2008,"250,000+",1156126,79698,8783,50341,4.3,90.0,,290,265,25,290,4.3,91.0
771,tt0976051,The Reader,2008,"100,000+",207082,20014,5250,10255,3.8,79.0,,203,128,75,203,3.8,63.0
772,tt0465538,Michael Clayton,2007,"250,000+",300164,47833,21171,21726,3.6,69.0,,206,186,20,206,3.6,90.0
773,tt0491747,Away from Her,2007,"100,000+",114793,5927,1366,3590,3.9,81.0,,144,136,8,144,3.9,94.0
774,tt0870111,Frost/Nixon,2008,"100,000+",109937,16446,2272,7750,4,88.0,,258,239,19,258,4,93.0
775,tt0805564,Lars and the Real Girl,2007,"100,000+",105884,25497,4827,13332,4,84.0,,140,114,26,140,4,81.0
776,tt0918927,Doubt,2008,"100,000+",162643,17977,5010,10481,3.8,78.0,,219,173,46,219,3.8,79.0
777,tt0382932,Ratatouille,2007,"250,000+",1073590,155944,23103,79183,4.1,87.0,,253,242,11,253,4.1,96.0
778,tt0978759,Frozen River,2008,"50,000+",85897,2821,970,1666,3.7,74.0,,139,123,16,139,3.7,88.0
779,tt0775529,The Savages,2007,"100,000+",135364,8029,2744,4975,3.7,75.0,,174,156,18,174,3.7,90.0
780,tt0780536,In Bruges,2008,"100,000+",113341,34197,5254,16059,4,87.0,,213,180,33,213,4,85.0
781,tt1136608,District 9,2009,"250,000+",1179095,82577,17541,39457,4,82.0,,314,282,32,314,4,90.0
782,tt0887912,The Hurt Locker,2009,"50,000+",96474,40150,7753,13867,4,84.0,,291,281,10,291,4,97.0
783,tt0361748,Inglourious Basterds,2009,"250,000+",777568,98332,13693,36687,4.2,88.0,,335,298,37,335,4.2,89.0
784,tt1193138,Up in the Air,2009,"100,000+",228692,37267,9750,14118,3.8,79.0,,288,260,28,288,3.8,90.0
785,tt1045670,Happy-Go-Lucky,2008,"25,000+",34793,5429,2711,3511,3.5,67.0,,163,151,12,163,3.5,93.0
786,tt1013753,Milk,2008,"100,000+",178203,27875,3481,11668,4.1,89.0,,245,227,18,245,4.1,93.0
787,tt1542344,127 Hours,2010,"50,000+",96184,36239,6511,10441,4,85.0,,239,222,17,239,4,93.0
788,tt1285016,The Social Network,2010,"100,000+",205117,81606,12683,19874,4.1,87.0,,333,319,14,333,4.1,96.0
789,tt1174732,An Education,2009,"50,000+",55054,13897,3477,4725,3.8,80.0,,198,185,13,198,3.8,93.0
790,tt1226774,In the Loop,2009,"100,000+",227084,6574,1489,2672,3.9,82.0,,179,168,11,179,3.9,94.0
791,tt1019452,A Serious Man,2009,"50,000+",63265,11209,5284,5035,3.6,68.0,,224,200,24,224,3.6,89.0
792,tt1375666,Inception,2010,"250,000+",573980,166126,15660,41718,4.4,91.0,,371,322,49,371,4.4,87.0
793,tt1049413,Up,2009,"250,000+",1205145,112611,12739,42280,4.3,90.0,,297,290,7,297,4.3,98.0
794,tt0842926,The Kids Are All Right,2010,"50,000+",63683,15019,5407,4672,3.7,74.0,,228,210,18,228,3.7,92.0
795,tt0790712,The Messenger,2009,"10,000+",21624,4199,1396,1586,3.7,75.0,,162,145,17,162,3.7,90.0
796,tt0435761,Toy Story 3,2010,"250,000+",608603,158570,18549,26248,4.4,90.0,,313,308,5,313,4.4,98.0
797,tt1504320,The King's Speech,2010,"100,000+",144906,60568,5444,14934,4.3,92.0,,305,288,17,305,4.3,94.0
798,tt1403865,True Grit,2010,"100,000+",158753,61206,10451,15413,4.1,85.0,,279,266,13,279,4.1,95.0
799,tt1033575,The Descendants,2011,"50,000+",70150,28031,7615,6406,3.8,79.0,,271,236,35,271,3.8,87.0
800,tt0964517,The Fighter,2010,"100,000+",121792,43521,5277,11223,4.1,89.0,,256,233,23,256,4.1,91.0
801,tt1124035,The Ides of March,2011,"50,000+",63386,21102,7987,4959,3.6,73.0,,253,211,42,253,3.6,83.0
802,tt1431181,Another Year,2010,"10,000+",20705,3008,1065,1223,3.7,74.0,,173,160,13,173,3.7,92.0
803,tt1399683,Winter's Bone,2010,"50,000+",51898,14347,4648,4503,3.8,76.0,,178,167,11,178,3.8,94.0
804,tt0970179,Hugo,2011,"50,000+",83221,36118,10040,8506,3.9,78.0,,236,219,17,236,3.9,93.0
805,tt1210166,Moneyball,2011,"50,000+",92503,43753,6880,7886,4,86.0,,275,259,16,275,4,94.0
806,tt1655442,The Artist,2011,"50,000+",58779,27302,3942,6656,4.2,87.0,,329,313,16,329,4.2,95.0
807,tt1605783,Midnight in Paris,2011,"50,000+",82995,34989,7334,8100,4,83.0,,229,213,16,229,4,93.0
808,tt1024648,Argo,2012,"100,000+",209393,80129,9226,11005,4.2,90.0,,365,349,16,365,4.2,96.0
809,tt0443272,Lincoln,2012,"100,000+",246125,48406,11719,8736,4,81.0,,288,258,30,288,4,90.0
810,tt1340800,Tinker Tailor Soldier Spy,2011,"50,000+",54530,15822,8511,5182,3.5,65.0,,234,196,38,234,3.5,84.0
811,tt1045658,Silver Linings Playbook,2012,"250,000+",261141,84041,13606,10599,4.1,86.0,,263,241,22,263,4.1,92.0
812,tt1853728,Django Unchained,2012,"250,000+",431092,123551,11426,16121,4.3,92.0,,298,258,40,298,4.3,87.0
813,tt1602620,Amour,2012,"10,000+",21008,7068,1548,1494,4,82.0,,223,207,16,223,4,93.0
814,tt1790885,Zero Dark Thirty,2012,"100,000+",197618,53982,13178,7335,4,80.0,,308,281,27,308,4,91.0
815,tt2125435,Beasts of the Southern Wild,2012,"25,000+",39420,11168,3581,2793,3.8,76.0,,210,182,28,210,3.8,87.0
816,tt1748122,Moonrise Kingdom,2012,"100,000+",140142,37847,6053,6793,4.1,86.0,,270,252,18,270,4.1,93.0
817,tt2431286,Philomena,2013,"50,000+",52553,15480,1982,2200,4.1,89.0,,202,183,19,202,4.1,91.0
818,tt0454876,Life of Pi,2012,"100,000+",169628,56799,10589,9306,4.1,84.0,,255,220,35,255,4.1,86.0
819,tt1478338,Bridesmaids,2011,"100,000+",162166,79279,25434,11799,3.9,76.0,,295,264,31,295,3.9,89.0
820,tt1800241,American Hustle,2013,"100,000+",176510,54552,18890,7853,3.8,74.0,,298,274,24,298,3.8,92.0
821,tt1615147,Margin Call,2011,"10,000+",20269,8007,2804,2030,3.7,74.0,,174,152,22,174,3.7,87.0
822,tt2024544,12 Years a Slave,2013,"100,000+",140958,49605,5768,6219,4.3,90.0,,379,360,19,379,4.3,95.0
823,tt0993846,The Wolf of Wall Street,2013,"100,000+",182456,69203,14505,9463,4,83.0,,289,230,59,289,4,80.0
824,tt1821549,Nebraska,2013,"25,000+",44937,14758,3035,2163,4,83.0,,255,231,24,255,4,91.0
825,tt1798709,Her,2013,"100,000+",102532,40459,8712,5992,4,82.0,,293,276,17,293,4,94.0
826,tt1907668,Flight,2012,"100,000+",153606,39005,13290,6750,3.8,75.0,,242,187,55,242,3.8,77.0
827,tt2334873,Blue Jasmine,2013,"25,000+",49330,16610,4998,3009,3.8,77.0,,233,211,22,233,3.8,91.0
828,tt2209418,Before Midnight,2013,"25,000+",37712,9810,2104,1679,4,82.0,,207,202,5,207,4,98.0
829,tt0790636,Dallas Buyers Club,2013,"50,000+",93289,39759,4141,4215,4.2,91.0,,266,245,21,266,4.2,92.0
830,tt2084970,The Imitation Game,2014,"100,000+",104682,46029,4377,4803,4.2,91.0,,287,258,29,287,4.2,90.0
831,tt1535109,Captain Phillips,2013,"100,000+",153020,58006,7046,6886,4.2,89.0,,281,262,19,281,4.2,93.0
832,tt1065073,Boyhood,2014,"50,000+",90148,30701,7451,5128,4,80.0,,336,325,11,336,4,97.0
833,tt2562232,Birdman or (The Unexpected Virtue of Ignorance),2014,"50,000+",94015,36969,10690,5891,3.9,78.0,,362,329,33,362,3.9,91.0
834,tt2278388,The Grand Budapest Hotel,2014,"50,000+",98987,44471,6953,5609,4.1,86.0,,318,292,26,318,4.1,92.0
835,tt2179136,American Sniper,2014,"100,000+",154143,56952,10638,7274,4.1,84.0,,303,217,86,303,4.1,72.0
836,tt2582802,Whiplash,2014,"50,000+",72265,38333,2292,5009,4.5,94.0,,308,289,19,308,4.5,94.0
837,tt2980516,The Theory of Everything,2014,"50,000+",76290,26176,5145,3139,4,84.0,,273,218,55,273,4,80.0
838,tt1791528,Inherent Vice,2014,"25,000+",32537,4854,4375,1384,3.2,53.0,,258,190,68,258,3.2,74.0
839,tt1100089,Foxcatcher,2014,"50,000+",57568,13218,6784,2339,3.5,66.0,,253,221,32,253,3.5,87.0
840,tt0092666,Blind Date,1959,Fewer than 50,16,10,1,2,4.3,91.0,,2,2,0,2,4.3,
841,tt0052911,I'm All Right Jack,1959,"1,000+",1409,157,51,62,3.8,75.0,,8,7,1,8,3.8,88.0
842,tt2872718,Nightcrawler,2014,"50,000+",87464,39790,6667,5034,4,86.0,,279,265,14,279,4,95.0
843,tt0051739,The Horse's Mouth,1959,"1,000+",1189,154,48,65,3.9,76.0,,19,17,2,19,3.9,89.0
844,tt0053806,Expresso Bongo,1959,100+,178,8,11,8,3.2,42.0,,5,2,3,5,3.2,40.0
845,tt0051879,Look Back in Anger,1959,"1,000+",1302,143,43,66,3.8,77.0,,13,12,1,13,3.8,92.0
846,tt0052006,No Trees in the Street,1959,100+,188,2,1,1,,,,0,0,0,0,,
847,tt0053361,Tiger Bay,1959,250+,419,83,16,32,4,84.0,,9,7,2,9,4,78.0
848,tt0052618,Ben-Hur,1959,"100,000+",106417,10821,1282,3859,4.3,89.0,,54,46,8,54,4.3,85.0
849,tt0052561,Anatomy of a Murder,1959,"10,000+",12486,2928,306,824,4.2,91.0,,52,52,0,52,4.2,100.0
850,tt0051879,Look Back in Anger,1959,"1,000+",1302,143,43,66,3.8,77.0,,13,12,1,13,3.8,92.0
851,tt0051411,The Big Country,1959,"5,000+",5581,795,83,297,4.2,91.0,,13,13,0,13,4.2,100.0
852,tt0053361,Tiger Bay,1959,250+,419,83,16,32,4,84.0,,9,7,2,9,4,78.0
853,tt0053291,Some Like It Hot,1959,"50,000+",82560,17822,1068,5935,4.4,94.0,,71,67,4,71,4.4,94.0
854,tt0053602,The Angry Silence,1960,100+,145,23,6,10,3.8,79.0,,5,4,1,5,3.8,80.0
855,tt0053131,The Nun's Story,1959,"5,000+",5581,593,137,215,3.9,81.0,,19,16,3,19,3.9,84.0
856,tt0053458,Yesterday's Enemy,1959,Fewer than 50,11,8,2,3,3.6,80.0,,1,1,0,1,3.6,
857,tt0053131,The Nun's Story,1959,"5,000+",5581,593,137,215,3.9,81.0,,19,16,3,19,3.9,84.0
858,tt0053752,The Day They Robbed the Bank of England,1960,Fewer than 50,15,9,1,2,3.9,90.0,,0,0,0,0,3.9,
859,tt0053137,On the Beach,1959,"2,500+",4394,459,210,262,3.6,69.0,,23,18,5,23,3.6,78.0
860,tt0054412,Tunes of Glory,1960,"1,000+",1097,141,39,50,4,78.0,,11,8,3,11,4,73.0
861,tt0053604,The Apartment,1960,"25,000+",38387,8311,536,2375,4.4,94.0,,107,100,7,107,4.4,93.0
862,tt0053900,Hell Is a City,1960,50+,94,15,4,6,3.9,79.0,,4,2,2,4,3.9,
863,tt0054403,The Trials of Oscar Wilde,1960,100+,116,11,12,7,3.2,48.0,,5,5,0,5,3.2,100.0
864,tt0053602,The Angry Silence,1960,100+,145,23,6,10,3.8,79.0,,5,4,1,5,3.8,80.0
865,tt0054269,Saturday Night and Sunday Morning,1960,"2,500+",3582,524,79,205,4.1,87.0,,15,13,2,15,4.1,87.0
866,tt0053793,Elmer Gantry,1960,"2,500+",3422,439,68,193,4,87.0,,32,30,2,32,4,94.0
867,tt0053779,La dolce vita,1960,"25,000+",34228,6317,701,1554,4.4,90.0,,80,76,4,80,4.4,95.0
868,tt0052893,Hiroshima mon amour,1960,"10,000+",10066,2511,305,634,4.3,89.0,,47,45,2,47,4.3,96.0
869,tt0054086,The Millionairess,1960,250+,456,38,61,34,3,38.0,,5,1,4,5,3,20.0
870,tt0053371,A Touch of Larceny,1960,Fewer than 50,41,2,6,3,2.8,25.0,,2,2,0,2,2.8,
871,tt0053946,Inherit the Wind,1960,"5,000+",9681,1750,181,658,4.3,91.0,,27,25,2,27,4.3,93.0
872,tt0054269,Saturday Night and Sunday Morning,1960,"2,500+",3582,524,79,205,4.1,87.0,,15,13,2,15,4.1,87.0
873,tt0054403,The Trials of Oscar Wilde,1960,100+,116,11,12,7,3.2,48.0,,5,5,0,5,3.2,100.0
874,tt0054412,Tunes of Glory,1960,"1,000+",1097,141,39,50,4,78.0,,11,8,3,11,4,73.0
875,tt0052893,Hiroshima mon amour,1960,"10,000+",10066,2511,305,634,4.3,89.0,,47,45,2,47,4.3,96.0
876,tt0053146,Black Orpheus,1960,"5,000+",6304,956,153,361,4.1,86.0,,72,63,9,72,4.1,88.0
877,tt0054953,The Guns of Navarone,1961,"10,000+",20813,2220,360,705,4,86.0,,26,24,2,26,4,92.0
878,tt0054022,Let's Make Love,1960,"5,000+",5487,298,200,138,3.6,60.0,,16,11,5,16,3.6,69.0
879,tt0054997,The Hustler,1961,"25,000+",31310,4612,373,1357,4.3,93.0,,50,47,3,50,4.3,94.0
880,tt0055031,Judgment at Nuremberg,1961,"5,000+",8732,1674,123,501,4.3,93.0,,26,24,2,26,4.3,92.0
881,tt0054790,The Day the Earth Caught Fire,1961,"2,500+",2727,196,35,113,4,85.0,,13,11,2,13,4,85.0
882,tt0054353,The Sundowners,1961,500+,601,92,52,40,3.5,64.0,,14,11,3,14,3.5,79.0
883,tt0054879,Flame in the Streets,1961,50+,81,3,3,2,3.2,50.0,,1,0,1,1,3.2,
884,tt0055506,A Taste of Honey,1961,"1,000+",2460,325,51,130,4.1,86.0,,20,17,3,20,4.1,85.0
885,tt0055506,A Taste of Honey,1961,"1,000+",2460,325,51,130,4.1,86.0,,20,17,3,20,4.1,85.0
886,tt0055618,Whistle Down the Wind,1961,"1,000+",1595,256,26,113,4.3,91.0,,11,11,0,11,4.3,100.0
887,tt0055618,Whistle Down the Wind,1961,"1,000+",1595,256,26,113,4.3,91.0,,11,11,0,11,4.3,100.0
888,tt0056172,Lawrence of Arabia,1962,"50,000+",75428,18775,1456,5597,4.5,93.0,,133,125,8,133,4.5,94.0
889,tt0056172,Lawrence of Arabia,1962,"50,000+",75428,18775,1456,5597,4.5,93.0,,133,125,8,133,4.5,94.0
890,tt0053331,Take a Giant Step,1961,100+,246,13,2,4,4,87.0,,1,1,0,1,4,
891,tt0056583,Tiara Tahiti,1962,Fewer than 50,7,0,4,1,,,,1,1,0,1,,
892,tt4807408,The Best of Enemies,1961,100+,161,12,4,6,3.7,75.0,,1,0,1,1,3.7,
893,tt0056308,Only Two Can Play,1962,100+,174,18,12,6,3.4,60.0,,5,4,1,5,3.4,80.0
894,tt0056141,A Kind of Loving,1962,250+,435,72,11,24,4,87.0,,14,13,1,14,4,93.0
895,tt0055796,Billy Budd,1962,Fewer than 50,13,11,2,8,4,85.0,,12,11,1,12,4,92.0
896,tt0055796,Billy Budd,1962,Fewer than 50,13,11,2,8,4,85.0,,12,11,1,12,4,92.0
897,tt0056673,Waltz of the Toreadors,1962,100+,139,7,9,5,2.9,44.0,,2,1,1,2,2.9,
898,tt0056141,A Kind of Loving,1962,250+,435,72,11,24,4,87.0,,14,13,1,14,4,93.0
899,tt0056308,Only Two Can Play,1962,100+,174,18,12,6,3.4,60.0,,5,4,1,5,3.4,80.0
900,tt0057239,The L-Shaped Room,1962,250+,333,57,12,15,4,83.0,,9,6,3,9,4,67.0
901,tt0056241,The Miracle Worker,1962,"5,000+",8874,1048,139,403,4.2,88.0,,26,25,1,26,4.2,96.0
902,tt3581652,West Side Story,1962,"100,000+",169299,10828,2032,5807,4.1,84.0,,116,107,9,116,4.1,92.0
903,tt0055499,Through A Glass Darkly,1962,"5,000+",8213,1891,169,494,4.3,92.0,,29,29,0,29,4.3,100.0
904,tt15398980,Tom Jones,1963,"5,000+",5525,399,289,239,3.4,58.0,,43,35,8,43,3.4,81.0
905,tt0368008,The Manchurian Candidate,1962,"25,000+",31474,4191,461,1507,4.2,90.0,,64,62,2,64,4.2,97.0
906,tt0057578,This Sporting Life,1963,"1,000+",1911,364,58,175,4.1,86.0,,24,23,1,24,4.1,96.0
907,tt0055244,Thou Shalt Not Kill ,1962,250+,353,38,13,21,3.9,75.0,,0,0,0,0,3.9,
908,tt0055244,Thou Shalt Not Kill ,1962,250+,353,38,13,21,3.9,75.0,,0,0,0,0,3.9,
909,tt0056346,Phaedra,1962,100+,126,16,27,16,3.2,37.0,,5,1,4,5,3.2,20.0
910,tt0055892,David and Lisa,1963,"1,000+",1061,145,38,67,3.9,79.0,,13,11,2,13,3.9,85.0
911,tt15398980,Tom Jones,1963,"5,000+",5525,399,289,239,3.4,58.0,,43,35,8,43,3.4,81.0
912,tt0056868,Billy Liar,1963,"2,500+",2709,441,87,173,4.1,84.0,,19,18,1,19,4.1,95.0
913,tt0057163,Hud,1963,"5,000+",8485,1338,169,463,4.1,89.0,,33,28,5,33,4.1,85.0
914,tt0056868,Billy Liar,1963,"2,500+",2709,441,87,173,4.1,84.0,,19,18,1,19,4.1,95.0
915,tt0056592,To Kill a Mockingbird,1963,"100,000+",179352,18004,1461,7723,4.4,93.0,,68,63,5,68,4.4,93.0
916,tt0057578,This Sporting Life,1963,"1,000+",1911,364,58,175,4.1,86.0,,24,23,1,24,4.1,96.0
917,tt0057490,The Servant,1963,"2,500+",3412,580,69,166,4.2,89.0,,50,45,5,50,4.2,90.0
918,tt0057490,The Servant,1963,"2,500+",3412,580,69,166,4.2,89.0,,50,45,5,50,4.2,90.0
919,tt0055895,Days of Wine and Roses,1963,"2,500+",2591,651,84,207,4.1,89.0,,14,14,0,14,4.1,100.0
920,tt0056389,The Four Days Of Naples,1963,50+,66,10,2,4,4.2,83.0,,5,4,1,5,4.2,80.0
921,tt0057877,Becket,1964,"5,000+",5634,933,138,392,4.1,87.0,,28,21,7,28,4.1,75.0
922,tt0057012,Dr. Strangelove or: How I Learned to Stop Worrying and Love the Bomb,1964,"100,000+",209921,36832,2525,10911,4.5,94.0,,96,94,2,96,4.5,98.0
923,tt0057012,Dr. Strangelove or: How I Learned to Stop Worrying and Love the Bomb,1964,"100,000+",209921,36832,2525,10911,4.5,94.0,,96,94,2,96,4.5,98.0
924,tt0057877,Becket,1964,"5,000+",5634,933,138,392,4.1,87.0,,28,21,7,28,4.1,75.0
925,tt0057012,Dr. Strangelove or: How I Learned to Stop Worrying and Love the Bomb,1964,"100,000+",209921,36832,2525,10911,4.5,94.0,,96,94,2,96,4.5,98.0
926,tt0057251,Lilies of the Field,1964,"5,000+",6184,772,126,268,4.1,86.0,,25,23,2,25,4.1,92.0
927,tt0058500,The Pumpkin Eater,1964,250+,489,75,29,41,3.7,72.0,,15,10,5,15,3.7,67.0
928,tt0058500,The Pumpkin Eater,1964,250+,489,75,29,41,3.7,72.0,,15,10,5,15,3.7,67.0
929,tt0058019,A Distant Trumpet,1964,Fewer than 50,29,4,6,1,3.3,40.0,,8,4,4,8,3.3,50.0
930,tt0058385,My Fair Lady,1965,"100,000+",187222,14889,1731,6418,4.3,90.0,,91,86,5,91,4.3,95.0
931,tt0058557,Seance on a Wet Afternoon,1964,"1,000+",1268,173,37,88,3.9,82.0,,18,14,4,18,3.9,78.0
932,tt0059362,The Knack ...and How to Get It,1965,"1,000+",1192,154,70,108,3.6,69.0,,18,13,5,18,3.6,72.0
933,tt0059362,The Knack ...and How to Get It,1965,"1,000+",1192,154,70,108,3.6,69.0,,18,13,5,18,3.6,72.0
934,tt13636038,The Ipcress File,1965,"5,000+",6526,915,157,357,4.1,85.0,,31,30,1,31,4.1,97.0
935,tt0061184,Who's Afraid of Virginia Woolf?,1966,"10,000+",21785,4241,450,1455,4.3,90.0,,45,43,2,45,4.3,96.0
936,tt0059113,Doctor Zhivago,1966,"25,000+",45894,6217,864,2066,4.2,88.0,,50,41,9,50,4.2,82.0
937,tt0058083,Fail Safe,1965,"5,000+",7195,930,90,359,4.2,91.0,,29,27,2,29,4.2,93.0
938,tt0060921,The Russians Are Coming the Russians Are Coming,1966,"2,500+",4789,485,162,221,3.8,75.0,,22,19,3,22,3.8,86.0
939,tt0060880,The Quiller Memorandum,1966,"1,000+",1024,74,49,53,3.4,60.0,,14,8,6,14,3.4,57.0
940,tt0055024,It Happened Here,1966,Fewer than 50,3,2,1,0,,,,7,5,2,7,,71.0
941,tt0059358,King Rat,1965,"1,000+",1453,157,30,68,4,84.0,,5,5,0,5,4,100.0
942,tt0062407,Two for the Road,1967,"5,000+",7976,1067,207,405,4.1,84.0,,24,20,4,24,4.1,83.0
943,tt0059749,The Spy Who Came in from the Cold,1966,"5,000+",5467,732,164,286,3.9,82.0,,21,18,3,21,3.9,86.0
944,tt0060665,A Man for All Seasons,1967,"5,000+",9813,1846,273,717,4.2,87.0,,82,73,9,82,4.2,89.0
945,tt0060665,A Man for All Seasons,1967,"5,000+",9813,1846,273,717,4.2,87.0,,82,73,9,82,4.2,89.0
946,tt0059575,The Pawnbroker,1966,"1,000+",2415,449,67,150,4,87.0,,22,19,3,22,4,86.0
947,tt0061418,Bonnie and Clyde,1967,"50,000+",56723,7501,1052,2374,4.1,88.0,,68,61,7,68,4.1,90.0
948,tt0061556,The Deadly Affair,1967,250+,307,45,25,21,3.4,64.0,,2,1,1,2,3.4,
949,tt0059894,The War Game,1966,"1,000+",1354,286,34,109,4.1,89.0,,14,13,1,14,4.1,93.0
950,tt0094484,In the Heat of the Night,1967,"10,000+",23329,3645,306,1196,4.2,92.0,,90,86,4,90,4.2,96.0
951,tt0094484,In the Heat of the Night,1967,"10,000+",23329,3645,306,1196,4.2,92.0,,90,86,4,90,4.2,96.0
952,tt0063385,Oliver!,1968,"50,000+",56162,2413,568,1376,4,81.0,,78,70,8,78,4,90.0
953,tt0061722,The Graduate,1968,"100,000+",183862,21821,2493,6996,4.2,90.0,,88,76,12,88,4.2,86.0
954,tt0062622,2001: A Space Odyssey,1968,"250,000+",300414,45455,5878,17090,4.4,89.0,,118,108,10,118,4.4,92.0
955,tt0061722,The Graduate,1968,"100,000+",183862,21821,2493,6996,4.2,90.0,,88,76,12,88,4.2,86.0
956,tt0061735,Guess Who's Coming to Dinner,1968,"25,000+",38363,3762,642,1489,4.1,85.0,,38,27,11,38,4.1,71.0
957,tt0061735,Guess Who's Coming to Dinner,1968,"25,000+",38363,3762,642,1489,4.1,85.0,,38,27,11,38,4.1,71.0
958,tt0062622,2001: A Space Odyssey,1968,"250,000+",300414,45455,5878,17090,4.4,89.0,,118,108,10,118,4.4,92.0
959,tt0063227,The Lion in Winter,1968,"10,000+",13156,2100,233,896,4.4,90.0,,43,39,4,43,4.4,91.0
960,tt0063227,The Lion in Winter,1968,"10,000+",13156,2100,233,896,4.4,90.0,,43,39,4,43,4.4,91.0
961,tt0064754,Oh! What a Lovely War,1969,500+,815,110,42,57,3.9,72.0,,15,12,3,15,3.9,80.0
962,tt0064665,Midnight Cowboy,1969,"25,000+",40162,7090,975,2298,4.2,88.0,,116,103,13,116,4.2,89.0
963,tt0066579,Women in Love,1969,"2,500+",2793,302,105,149,3.8,74.0,,23,19,4,23,3.8,83.0
964,tt0064665,Midnight Cowboy,1969,"25,000+",40162,7090,975,2298,4.2,88.0,,116,103,13,116,4.2,89.0
965,tt0064381,"Goodbye, Columbus",1969,"1,000+",1119,42,42,28,3.3,50.0,,12,11,1,12,3.3,92.0
966,tt0066579,Women in Love,1969,"2,500+",2793,302,105,149,3.8,74.0,,23,19,4,23,3.8,83.0
967,tt0065261,Ådalen 31,1969,Fewer than 50,2,2,0,0,,,,8,7,1,8,,88.0
968,tt0064754,Oh! What a Lovely War,1969,500+,815,110,42,57,3.9,72.0,,15,12,3,15,3.9,80.0
969,tt0064665,Midnight Cowboy,1969,"25,000+",40162,7090,975,2298,4.2,88.0,,116,103,13,116,4.2,89.0
970,tt0064115,Butch Cassidy and the Sundance Kid,1970,"50,000+",71375,13052,1105,3902,4.3,92.0,,58,52,6,58,4.3,90.0
971,tt0064115,Butch Cassidy and the Sundance Kid,1970,"50,000+",71375,13052,1105,3902,4.3,92.0,,58,52,6,58,4.3,90.0
972,tt0064100,Bob & Carol & Ted & Alice,1970,"1,000+",1703,245,127,120,3.5,66.0,,61,50,11,61,3.5,82.0
973,tt0065088,"They Shoot Horses, Don't They?",1970,"5,000+",5596,984,124,320,4.1,89.0,,34,28,6,34,4.1,82.0
974,tt0068098,M*A*S*H,1970,"50,000+",53253,5196,1098,1995,4,83.0,,58,49,9,58,4,84.0
975,tt0068098,M*A*S*H,1970,"50,000+",53253,5196,1098,1995,4,83.0,,58,49,9,58,4,84.0
976,tt0067805,Sunday Bloody Sunday,1971,"2,500+",2680,258,108,105,3.7,70.0,,30,26,4,30,3.7,87.0
977,tt0067144,The Go-Between,1971,500+,799,167,48,72,3.8,78.0,,11,11,0,11,3.8,100.0
978,tt0064541,Kes,1970,"5,000+",9200,1959,193,626,4.3,91.0,,33,33,0,33,4.3,100.0
979,tt0064541,Kes,1970,"5,000+",9200,1959,193,626,4.3,91.0,,33,33,0,33,4.3,100.0
980,tt0067144,The Go-Between,1971,500+,799,167,48,72,3.8,78.0,,11,11,0,11,3.8,100.0
981,tt0067805,Sunday Bloody Sunday,1971,"2,500+",2680,258,108,105,3.7,70.0,,30,26,4,30,3.7,87.0
982,tt0064541,Kes,1970,"5,000+",9200,1959,193,626,4.3,91.0,,33,33,0,33,4.3,100.0
983,tt5056196,Catch-22,1970,"10,000+",10586,1475,474,663,3.8,76.0,,32,26,6,32,3.8,81.0
984,tt0066319,Ryan's Daughter,1970,"2,500+",2782,410,152,185,3.9,73.0,,17,8,9,17,3.9,47.0
985,tt0068669,Gumshoe,1971,250+,308,31,26,29,3.3,54.0,,8,7,1,8,3.3,88.0
986,tt0066921,A Clockwork Orange,1972,"250,000+",437739,101123,7896,29750,4.4,93.0,,82,71,11,82,4.4,87.0
987,tt0067328,The Last Picture Show,1972,"10,000+",14279,3292,389,959,4.2,89.0,,115,113,2,115,4.2,98.0
988,tt0067820,Taking Off,1971,500+,728,159,30,34,4,84.0,,12,12,0,12,4,100.0
989,tt0067820,Taking Off,1971,500+,728,159,30,34,4,84.0,,12,12,0,12,4,100.0
990,tt0067116,The French Connection,1972,"25,000+",44588,7637,1160,2333,4.1,87.0,,93,89,4,93,4.1,96.0
991,tt0067328,The Last Picture Show,1972,"10,000+",14279,3292,389,959,4.2,89.0,,115,113,2,115,4.2,98.0
992,tt0067217,The Hospital,1972,"1,000+",2131,320,114,152,3.7,74.0,,14,14,0,14,3.7,100.0
993,tt0066921,A Clockwork Orange,1972,"250,000+",437739,101123,7896,29750,4.4,93.0,,82,71,11,82,4.4,87.0
994,tt0068327,Cabaret,1972,"25,000+",36210,4661,720,1765,4.2,87.0,,48,44,4,48,4.2,92.0
995,tt0068327,Cabaret,1972,"25,000+",36210,4661,720,1765,4.2,87.0,,48,44,4,48,4.2,92.0
996,tt0065988,Little Big Man,1971,"10,000+",17504,2235,339,704,4.1,87.0,,79,72,7,79,4.1,91.0
997,tt0069947,The Day of the Jackal,1973,"5,000+",9026,1722,230,545,4.1,88.0,,31,28,3,31,4.1,90.0
998,tt0069947,The Day of the Jackal,1973,"5,000+",9026,1722,230,545,4.1,88.0,,31,28,3,31,4.1,90.0
999,tt0069303,Sounder,1973,"1,000+",1954,185,56,70,3.9,77.0,,22,20,2,22,3.9,91.0
1000,tt0068450,A Day in the Death of Joe Egg,1972,Fewer than 50,38,7,3,3,3.6,70.0,,4,4,0,4,3.6,
1001,tt0070290,The Last Detail,1974,"5,000+",7421,1422,214,453,4,87.0,,38,33,5,38,4,87.0
1002,tt0070819,A Touch of Class,1973,"1,000+",2043,88,49,44,3.5,65.0,,13,11,2,13,3.5,85.0
1003,tt0071733,Lacombe Lucien,1974,"1,000+",1869,307,53,87,4,85.0,,10,10,0,10,4,100.0
1004,tt3402236,Murder on the Orient Express,1974,"10,000+",20983,2447,676,832,3.8,78.0,,42,38,4,42,3.8,90.0
1005,tt0069995,Don't Look Now,1973,"10,000+",18948,3268,1034,1361,3.8,76.0,,85,79,6,85,3.8,93.0
1006,tt0067530,One Day in the Life of Ivan Denisovich,1972,50+,79,10,1,2,4,91.0,,6,1,5,6,4,17.0
1007,tt0070239,Jesus Christ Superstar,1973,"25,000+",36451,2440,762,1574,3.9,76.0,,29,14,15,29,3.9,48.0
1008,tt0071315,Chinatown,1974,"50,000+",78347,22145,1730,5247,4.4,93.0,,79,78,1,79,4.4,99.0
1009,tt0069281,Sleuth,1973,"5,000+",9490,2118,224,709,4.2,90.0,,28,25,3,28,4.2,89.0
1010,tt0071733,Lacombe Lucien,1974,"1,000+",1869,307,53,87,4,85.0,,10,10,0,10,4,100.0
1011,tt1615065,Savages,1973,Fewer than 50,14,2,1,2,,,,0,0,0,0,,
1012,tt0071360,The Conversation,1974,"25,000+",35379,7108,845,2024,4.2,89.0,,71,69,2,71,4.2,97.0
1013,tt0072684,Barry Lyndon,1975,"25,000+",45306,9954,897,2594,4.4,92.0,,84,73,11,84,4.4,87.0
1014,tt0071733,Lacombe Lucien,1974,"1,000+",1869,307,53,87,4,85.0,,10,10,0,10,4,100.0
1015,tt0071115,Alice Doesn't Live Here Anymore,1975,"5,000+",9903,1656,374,537,3.8,82.0,,82,75,7,82,3.8,91.0
1016,tt0071230,Blazing Saddles,1974,"100,000+",218752,32137,3358,11995,4.3,91.0,,68,60,8,68,4.3,88.0
1017,tt0072890,Dog Day Afternoon,1975,"100,000+",110532,16385,1841,3865,4.2,90.0,,54,52,2,54,4.2,96.0
1018,tt0071115,Alice Doesn't Live Here Anymore,1975,"5,000+",9903,1656,374,537,3.8,82.0,,82,75,7,82,3.8,91.0
1019,tt0072890,Dog Day Afternoon,1975,"100,000+",110532,16385,1841,3865,4.2,90.0,,54,52,2,54,4.2,96.0
1020,tt0073195,Jaws,1975,"250,000+",946650,57311,6037,35382,4.4,90.0,,101,98,3,101,4.4,97.0
1021,tt0073195,Jaws,1975,"250,000+",946650,57311,6037,35382,4.4,90.0,,101,98,3,101,4.4,97.0
1022,tt0071175,The Autobiography of Miss Jane Pittman,1974,"1,000+",1268,92,15,53,4.2,86.0,,10,9,1,10,4.2,90.0
1023,tt0075314,Taxi Driver,1976,Fewer than 50,7,6,1,0,4.1,86.0,,0,0,0,0,4.1,
1024,tt0073486,One Flew Over the Cuckoo's Nest,1976,"250,000+",280364,61765,2478,14958,4.5,96.0,,120,112,8,120,4.5,93.0
1025,tt0074119,All the President's Men,1976,"50,000+",50500,8045,703,2255,4.3,92.0,,71,67,4,71,4.3,94.0
1026,tt0074119,All the President's Men,1976,"50,000+",50500,8045,703,2255,4.3,92.0,,71,67,4,71,4.3,94.0
1027,tt0073486,One Flew Over the Cuckoo's Nest,1976,"250,000+",280364,61765,2478,14958,4.5,96.0,,120,112,8,120,4.5,93.0
1028,tt0073766,The Sunshine Boys,1976,"1,000+",2476,218,83,78,3.7,72.0,,38,27,11,38,3.7,71.0
1029,tt2281375,Nashville,1975,"10,000+",10149,2098,410,783,4.2,84.0,,75,68,7,75,4.2,91.0
1030,tt0075686,Annie Hall,1977,"100,000+",153991,23616,1974,6518,4.4,92.0,,127,123,4,127,4.4,97.0
1031,tt0071358,Conrack,1975,250+,300,69,19,30,3.9,78.0,,13,9,4,13,3.9,69.0
1032,tt0074256,Bugsy Malone,1976,"10,000+",21682,1587,393,928,4,80.0,,28,22,6,28,4,79.0
1033,tt0074256,Bugsy Malone,1976,"10,000+",21682,1587,393,928,4,80.0,,28,22,6,28,4,79.0
1034,tt0075686,Annie Hall,1977,"100,000+",153991,23616,1974,6518,4.4,92.0,,127,123,4,127,4.4,97.0
1035,tt0074958,Network,1977,"25,000+",36527,8996,676,3222,4.4,93.0,,75,69,6,75,4.4,92.0
1036,tt0075148,Rocky,1977,"250,000+",33403994,74632,33408,1432746,3.2,69.0,,72,66,6,72,3.2,92.0
1037,tt0075995,Equus,1977,"2,500+",3842,440,128,219,3.8,78.0,,22,15,7,22,3.8,68.0
1038,tt0074958,Network,1977,"25,000+",36527,8996,676,3222,4.4,93.0,,75,69,6,75,4.4,92.0
1039,tt0075148,Rocky,1977,"250,000+",33403994,74632,33408,1432746,3.2,69.0,,72,66,6,72,3.2,92.0
1040,tt0075784,A Bridge Too Far,1977,"25,000+",43350,3418,579,1286,4.1,86.0,,29,17,12,29,4.1,59.0
1041,tt0075860,Close Encounters of the Third Kind,1978,"100,000+",142444,14421,2616,4861,4.1,85.0,,70,66,4,70,4.1,94.0
1042,tt0075860,Close Encounters of the Third Kind,1978,"100,000+",142444,14421,2616,4861,4.1,85.0,,70,66,4,70,4.1,94.0
1043,tt3231564,Manhattan,1979,"50,000+",51933,12146,1114,2780,4.3,92.0,,70,66,4,70,4.3,94.0
1044,tt0078788,Apocalypse Now,1979,"250,000+",286833,63408,4043,16517,4.5,94.0,,95,93,2,95,4.5,98.0
1045,tt3231564,Manhattan,1979,"50,000+",51933,12146,1114,2780,4.3,92.0,,70,66,4,70,4.3,94.0
1046,tt0076095,The Goodbye Girl,1978,"5,000+",7526,969,178,426,4,85.0,,25,20,5,25,4,80.0
1047,tt0078966,The China Syndrome,1979,"5,000+",8961,1281,309,448,3.8,81.0,,40,35,5,40,3.8,88.0
1048,tt0078966,The China Syndrome,1979,"5,000+",8961,1281,309,448,3.8,81.0,,40,35,5,40,3.8,88.0
1049,tt0077928,Midnight Express,1978,"25,000+",31219,4957,604,1416,4.2,89.0,,30,27,3,30,4.2,90.0
1050,tt0080678,The Elephant Man,1980,Fewer than 50,48,14,2,1,3.9,88.0,,0,0,0,0,3.9,
1051,tt0077416,The Deer Hunter,1979,"100,000+",103845,21327,1995,5783,4.3,91.0,,132,114,18,132,4.3,86.0
1052,tt0077416,The Deer Hunter,1979,"100,000+",103845,21327,1995,5783,4.3,91.0,,132,114,18,132,4.3,86.0
1053,tt0080979,Kagemusha,1980,"10,000+",12456,2719,247,716,4.2,92.0,,26,23,3,26,4.2,88.0
1054,tt0079417,Kramer vs. Kramer,1980,"25,000+",43628,7104,879,1953,4.1,89.0,,101,90,11,101,4.1,89.0
1055,tt0080678,The Elephant Man,1980,Fewer than 50,48,14,2,1,3.9,88.0,,0,0,0,0,3.9,
1056,tt0078841,Being There,1980,"25,000+",25219,5287,471,1745,4.3,92.0,,62,59,3,62,4.3,95.0
1057,tt0079417,Kramer vs. Kramer,1980,"25,000+",43628,7104,879,1953,4.1,89.0,,101,90,11,101,4.1,89.0
1058,tt0082158,Chariots of Fire,1981,"25,000+",37275,4107,1038,1671,4,80.0,,115,96,19,115,4,83.0
1059,tt0080157,Yanks,1979,"1,000+",1890,100,60,47,3.7,62.0,,21,12,9,21,3.7,57.0
1060,tt0078841,Being There,1980,"25,000+",25219,5287,471,1745,4.3,92.0,,62,59,3,62,4.3,95.0
1061,tt0080388,Atlantic City,1981,"5,000+",5264,654,190,204,3.8,77.0,,38,38,0,38,3.8,100.0
1062,tt0082416,The French Lieutenant's Woman,1981,"5,000+",6933,639,315,248,3.6,67.0,,29,24,5,29,3.6,83.0
1063,tt0080388,Atlantic City,1981,"5,000+",5264,654,190,204,3.8,77.0,,38,38,0,38,3.8,100.0
1064,tt0082158,Chariots of Fire,1981,"25,000+",37275,4107,1038,1671,4,80.0,,115,96,19,115,4,83.0
1065,tt0082416,The French Lieutenant's Woman,1981,"5,000+",6933,639,315,248,3.6,67.0,,29,24,5,29,3.6,83.0
1066,tt0082971,Raiders of the Lost Ark,1981,"250,000+",828694,76412,3544,26536,4.5,96.0,,151,141,10,151,4.5,93.0
1067,tt0080339,Airplane!,1980,"250,000+",292469,24920,3179,12310,4.2,89.0,,70,68,2,70,4.2,97.0
1068,tt0083987,Gandhi,1982,"25,000+",49947,8374,731,2481,4.3,92.0,,110,98,12,110,4.3,89.0
1069,tt0083866,E.T. the Extra-Terrestrial,1982,"250,000+",32314349,82689,32311,1318882,3.5,72.0,,145,143,2,145,3.5,99.0
1070,tt0082477,Gregory's Girl,1981,"5,000+",5679,622,147,295,,,,23,22,1,23,,96.0
1071,tt0082477,Gregory's Girl,1981,"5,000+",5679,622,147,295,,,,23,22,1,23,,96.0
1072,tt0083866,E.T. the Extra-Terrestrial,1982,"250,000+",32314349,82689,32311,1318882,3.5,72.0,,145,143,2,145,3.5,99.0
1073,tt0083987,Gandhi,1982,"25,000+",49947,8374,731,2481,4.3,92.0,,110,98,12,110,4.3,89.0
1074,tt0082846,On Golden Pond,1982,"10,000+",20647,2431,377,936,4.1,87.0,,44,40,4,44,4.1,91.0
1075,tt0082846,On Golden Pond,1982,"10,000+",20647,2431,377,936,4.1,87.0,,44,40,4,44,4.1,91.0
1076,tt0085478,Educating Rita,1983,"5,000+",7872,979,231,418,3.9,81.0,,17,14,3,17,3.9,82.0
1077,tt0085478,Educating Rita,1983,"5,000+",7872,979,231,418,3.9,81.0,,17,14,3,17,3.9,82.0
1078,tt0084805,Tootsie,1983,"50,000+",58673,6271,1443,2154,3.9,81.0,,53,48,5,53,3.9,91.0
1079,tt0084805,Tootsie,1983,"50,000+",58673,6271,1443,2154,3.9,81.0,,53,48,5,53,3.9,91.0
1080,tt0084058,Heat and Dust,1983,500+,594,56,39,24,3.5,59.0,,14,11,3,14,3.5,79.0
1081,tt0084058,Heat and Dust,1983,500+,594,56,39,24,3.5,59.0,,14,11,3,14,3.5,79.0
1082,tt0085859,Local Hero,1983,"5,000+",7963,1729,260,668,4.3,87.0,,40,40,0,40,4.3,100.0
1083,tt0086465,Trading Places,1983,"50,000+",87915,9372,1716,3006,4,85.0,,52,46,6,52,4,88.0
1084,tt0085859,Local Hero,1983,"5,000+",7963,1729,260,668,4.3,87.0,,40,40,0,40,4.3,100.0
1085,tt4247618,The Dresser,1984,"1,000+",1818,252,40,90,4,86.0,,15,15,0,15,4,100.0
1086,tt0087553,The Killing Fields,1984,"10,000+",23190,3540,331,1093,4.2,91.0,,43,40,3,43,4.2,93.0
1087,tt0087553,The Killing Fields,1984,"10,000+",23190,3540,331,1093,4.2,91.0,,43,40,3,43,4.2,93.0
1088,tt4247618,The Dresser,1984,"1,000+",1818,252,40,90,4,86.0,,15,15,0,15,4,100.0
1089,tt0087884,"Paris, Texas",1984,"10,000+",24508,5805,419,1249,4.4,93.0,,53,50,3,53,4.4,94.0
1090,tt0086904,Another Country,1984,"2,500+",4424,309,108,129,3.8,74.0,,10,6,4,10,3.8,60.0
1091,tt0087884,"Paris, Texas",1984,"10,000+",24508,5805,419,1249,4.4,93.0,,53,50,3,53,4.4,94.0
1092,tt0085794,The King of Comedy,1983,"25,000+",27274,5431,621,1505,4.1,90.0,,70,62,8,70,4.1,89.0
1093,tt0086637,Zelig,1983,"10,000+",18486,3342,450,777,4.1,88.0,,32,31,1,32,4.1,97.0
1094,tt0087003,Broadway Danny Rose,1984,"5,000+",9549,1880,351,452,4,84.0,,29,29,0,29,4,100.0
1095,tt0085244,The Big Chill,1984,"10,000+",22403,2643,789,1004,3.9,77.0,,41,29,12,41,3.9,71.0
1096,tt0089841,Prizzi's Honor,1985,"5,000+",7954,822,501,323,3.4,62.0,,41,35,6,41,3.4,85.0
1097,tt0089838,A Private Function,1984,"1,000+",2141,98,58,49,3.5,63.0,,10,9,1,10,3.5,90.0
1098,tt0089838,A Private Function,1984,"1,000+",2141,98,58,49,3.5,63.0,,10,9,1,10,3.5,90.0
1099,tt0086879,Amadeus,1985,"100,000+",180470,24046,1328,7757,4.5,95.0,,153,136,17,153,4.5,89.0
1100,tt0087892,A Passage to India,1985,"5,000+",6973,943,254,351,3.8,79.0,,28,22,6,28,3.8,79.0
1101,tt0089853,The Purple Rose of Cairo,1985,"10,000+",20423,3803,534,962,4.1,88.0,,41,38,3,41,4.1,93.0
1102,tt0086879,Amadeus,1985,"100,000+",180470,24046,1328,7757,4.5,95.0,,153,136,17,153,4.5,89.0
1103,tt0087892,A Passage to India,1985,"5,000+",6973,943,254,351,3.8,79.0,,28,22,6,28,3.8,79.0
1104,tt0383278,Comfort and Joy,1984,500+,633,91,21,33,3.9,81.0,,12,12,0,12,3.9,100.0
1105,tt0089853,The Purple Rose of Cairo,1985,"10,000+",20423,3803,534,962,4.1,88.0,,41,38,3,41,4.1,93.0
1106,tt0088763,Back to the Future,1985,"250,000+",1097197,106004,6169,39791,4.5,94.0,,110,102,8,110,4.5,93.0
1107,tt0090329,Witness,1985,"25,000+",46965,4802,1198,1508,3.9,80.0,,45,42,3,45,3.9,93.0
1108,tt0088763,Back to the Future,1985,"250,000+",1097197,106004,6169,39791,4.5,94.0,,110,102,8,110,4.5,93.0
1109,tt0090329,Witness,1985,"25,000+",46965,4802,1198,1508,3.9,80.0,,45,42,3,45,3.9,93.0
1110,tt0091578,My Beautiful Laundrette,1985,"5,000+",7207,1039,365,379,3.8,74.0,,45,44,1,45,3.8,98.0
1111,tt0089755,Out of Africa,1986,"25,000+",40442,5959,1271,2101,4.1,82.0,,89,56,33,89,4.1,63.0
1112,tt0088111,The Shooting Party,1985,500+,690,39,25,20,3.5,61.0,,6,6,0,6,3.5,100.0
1113,tt0090830,Children of a Lesser God,1986,"5,000+",8584,1006,280,375,3.9,78.0,,35,28,7,35,3.9,80.0
1114,tt1200263,The Color Purple,1986,"100,000+",181096,19923,1347,7806,4.5,94.0,,123,89,34,123,4.5,72.0
1115,tt0091867,A Room with a View,1986,"25,000+",25533,4293,743,1352,4.2,85.0,,34,34,0,34,4.2,100.0
1116,tt0091867,A Room with a View,1986,"25,000+",25533,4293,743,1352,4.2,85.0,,34,34,0,34,4.2,100.0
1117,tt0089881,Ran,1986,"25,000+",38496,7362,421,2188,4.5,95.0,,91,87,4,91,4.5,96.0
1118,tt0090555,Crocodile Dundee,1986,"250,000+",254517,3407,2341,3579,3.5,59.0,,36,32,4,36,3.5,89.0
1119,tt28097834,The Mission,1986,"25,000+",38966,5179,775,1793,4.2,87.0,,29,19,10,29,4.2,66.0
1120,tt28097834,The Mission,1986,"25,000+",38966,5179,775,1793,4.2,87.0,,29,19,10,29,4.2,66.0
1121,tt0091167,Hannah and Her Sisters,1986,"25,000+",31172,5582,601,1335,4.2,90.0,,57,52,5,57,4.2,91.0
1122,tt0091288,Jean de Florette,1987,"10,000+",14164,2748,139,782,4.5,95.0,,23,21,2,23,4.5,91.0
1123,tt0091167,Hannah and Her Sisters,1986,"25,000+",31172,5582,601,1335,4.2,90.0,,57,52,5,57,4.2,91.0
1124,tt0091288,Jean de Florette,1987,"10,000+",14164,2748,139,782,4.5,95.0,,23,21,2,23,4.5,91.0
1125,tt0093818,Radio Days,1987,"10,000+",11409,2160,408,524,4,84.0,,38,35,3,38,4,92.0
1126,tt0093209,Hope and Glory,1987,"5,000+",5833,670,147,241,4,82.0,,26,25,1,26,4,96.0
1127,tt0093209,Hope and Glory,1987,"5,000+",5833,670,147,241,4,82.0,,26,25,1,26,4,96.0
1128,tt0093818,Radio Days,1987,"10,000+",11409,2160,408,524,4,84.0,,38,35,3,38,4,92.0
1129,tt0096332,The Unbearable Lightness of Being,1988,"10,000+",19506,3215,599,955,4.1,84.0,,29,25,4,29,4.1,86.0
1130,tt0093776,Prick Up Your Ears,1987,"2,500+",4427,400,108,146,3.9,79.0,,38,36,2,38,3.9,95.0
1131,tt0090570,84 Charing Cross Road,1987,"5,000+",5168,524,122,211,4,81.0,,14,12,2,14,4,86.0
1132,tt0093727,Personal Services,1987,500+,814,97,24,47,3.9,80.0,,6,4,2,6,3.9,67.0
1133,tt0093389,The Last Emperor,1988,"25,000+",40075,4999,686,1380,4.1,88.0,,124,107,17,124,4.1,86.0
1134,tt1684925,Wish You Were Here,1987,"1,000+",1039,137,40,68,4,77.0,,33,28,5,33,4,85.0
1135,tt0092593,Au revoir les enfants,1988,"10,000+",11836,2783,209,743,4.3,93.0,,37,36,1,37,4.3,97.0
1136,tt0095159,A Fish Called Wanda,1988,"100,000+",181413,9163,1715,3934,4,84.0,,68,65,3,68,4,96.0
1137,tt0092804,Cry Freedom,1987,"5,000+",9563,1151,164,396,4.1,88.0,,27,20,7,27,4.1,74.0
1138,tt0092593,Au revoir les enfants,1988,"10,000+",11836,2783,209,743,4.3,93.0,,37,36,1,37,4.3,97.0
1139,tt0096438,Who Framed Roger Rabbit,1988,"250,000+",443169,23349,4248,13296,4.1,85.0,,74,71,3,74,4.1,96.0
1140,tt0092965,Empire of the Sun,1988,"50,000+",60451,10536,1216,3563,4.2,90.0,,63,49,14,63,4.2,78.0
1141,tt0092593,Au revoir les enfants,1988,"10,000+",11836,2783,209,743,4.3,93.0,,37,36,1,37,4.3,97.0
1142,tt0095159,A Fish Called Wanda,1988,"100,000+",181413,9163,1715,3934,4,84.0,,68,65,3,68,4,96.0
1143,tt0094947,Dangerous Liaisons,1989,"25,000+",46692,6609,1390,1780,4,83.0,,34,32,2,34,4,94.0
1144,tt0094606,The Accidental Tourist,1989,"5,000+",6240,610,402,274,3.5,60.0,,34,28,6,34,3.5,82.0
1145,tt0093565,Moonstruck,1988,"25,000+",44979,4807,1167,1949,4,80.0,,74,68,6,74,4,92.0
1146,tt0093664,Dark Eyes,1988,500+,548,95,9,19,4.3,91.0,,10,9,1,10,4.3,90.0
1147,tt0098635,When Harry Met Sally...,1989,"250,000+",396395,31608,4066,12285,4.2,89.0,,79,72,7,79,4.2,91.0
1148,tt0098635,When Harry Met Sally...,1989,"250,000+",396395,31608,4066,12285,4.2,89.0,,79,72,7,79,4.2,91.0
1149,tt0096464,A World Apart,1988,"1,000+",1247,55,13,20,4,81.0,,11,10,1,11,4,91.0
1150,tt0097165,Dead Poets Society,1989,"250,000+",307794,45930,3883,13544,4.3,92.0,,63,53,10,63,4.3,84.0
1151,tt0096028,Salaam Bombay!,1989,"5,000+",5719,770,59,220,4.3,93.0,,30,28,2,30,4.3,93.0
1152,tt0098319,Shirley Valentine,1989,"5,000+",5854,783,124,350,4.2,86.0,,18,13,5,18,4.2,72.0
1153,tt0097165,Dead Poets Society,1989,"250,000+",307794,45930,3883,13544,4.3,92.0,,63,53,10,63,4.3,84.0
1154,tt0098319,Shirley Valentine,1989,"5,000+",5854,783,124,350,4.2,86.0,,18,13,5,18,4.2,72.0
1155,tt0095953,Rain Man,1989,"250,000+",314537,30188,3177,9851,4.2,90.0,,137,121,16,137,4.2,88.0
1156,tt0095675,Women On The Verge Of A Nervous Breakdown,1989,"10,000+",22662,3926,504,888,4.1,89.0,,36,33,3,36,4.1,92.0
1157,tt0098724,"Sex, Lies, and Videotape",1989,"25,000+",32696,3700,991,1071,3.9,79.0,,54,52,2,54,3.9,96.0
1158,tt0099685,Goodfellas,1990,"250,000+",431307,117712,3434,29247,4.6,97.0,,161,152,9,161,4.6,94.0
1159,tt0097239,Driving Miss Daisy,1990,"50,000+",53840,4934,1156,1640,3.9,81.0,,105,89,16,105,3.9,85.0
1160,tt0096969,Born on the Fourth of July,1990,"50,000+",59514,5357,1666,1697,3.8,76.0,,56,47,9,56,3.8,84.0
1161,tt0097123,Crimes and Misdemeanors,1990,"10,000+",23757,4666,488,1184,4.2,91.0,,51,47,4,51,4.2,92.0
1162,tt0099685,Goodfellas,1990,"250,000+",431307,117712,3434,29247,4.6,97.0,,161,152,9,161,4.6,94.0
1163,tt0097239,Driving Miss Daisy,1990,"50,000+",53840,4934,1156,1640,3.9,81.0,,105,89,16,105,3.9,85.0
1164,tt0100395,Postcards from the Edge,1990,"5,000+",8829,834,427,299,3.6,66.0,,36,30,6,36,3.6,83.0
1165,tt0097123,Crimes and Misdemeanors,1990,"10,000+",23757,4666,488,1184,4.2,91.0,,51,47,4,51,4.2,92.0
1166,tt0098621,The War of the Roses,1990,"25,000+",40882,2274,941,1014,3.7,71.0,,42,35,7,42,3.7,83.0
1167,tt0100405,Pretty Woman,1990,"250,000+",32709375,88809,40899,1183532,3.5,68.0,,77,50,27,77,3.5,65.0
1168,tt0100405,Pretty Woman,1990,"250,000+",32709375,88809,40899,1183532,3.5,68.0,,77,50,27,77,3.5,65.0
1169,tt0099334,Cyrano de Bergerac,1991,"10,000+",16295,2283,245,714,4.3,90.0,,30,30,0,30,4.3,100.0
1170,tt0102926,The Silence of the Lambs,1991,"250,000+",848625,85982,4183,29637,4.4,95.0,,153,145,8,153,4.4,95.0
1171,tt0099348,Dances with Wolves,1991,"100,000+",214037,18565,2843,7034,4.2,87.0,,131,114,17,131,4.2,87.0
1172,tt0102926,The Silence of the Lambs,1991,"250,000+",848625,85982,4183,29637,4.4,95.0,,153,145,8,153,4.4,95.0
1173,tt0099348,Dances with Wolves,1991,"100,000+",214037,18565,2843,7034,4.2,87.0,,131,114,17,131,4.2,87.0
1174,tt0099334,Cyrano de Bergerac,1991,"10,000+",16295,2283,245,714,4.3,90.0,,30,30,0,30,4.3,100.0
1175,tt0103074,Thelma & Louise,1991,"100,000+",170526,10330,2255,3591,4,82.0,,153,132,21,153,4,86.0
1176,tt0101605,The Commitments,1991,"25,000+",28433,3105,361,1218,4.2,90.0,,48,43,5,48,4.2,90.0
1177,tt0101605,The Commitments,1991,"25,000+",28433,3105,361,1218,4.2,90.0,,48,43,5,48,4.2,90.0
1178,tt0099699,Green Card,1991,"25,000+",26308,869,860,460,3.3,50.0,,32,19,13,32,3.3,59.0
1179,tt0101889,The Fisher King,1991,"25,000+",45912,6256,1060,1826,4,85.0,,65,55,10,65,4,85.0
1180,tt0103074,Thelma & Louise,1991,"100,000+",170526,10330,2255,3591,4,82.0,,153,132,21,153,4,86.0
1181,tt0104036,The Crying Game,1992,"25,000+",31941,4032,1116,1288,3.8,78.0,,72,68,4,72,3.8,94.0
1182,tt0104036,The Crying Game,1992,"25,000+",31941,4032,1116,1288,3.8,78.0,,72,68,4,72,3.8,94.0
1183,tt0103105,Toto le héros,1991,"1,000+",2379,360,32,78,4.3,92.0,,13,11,2,13,4.3,85.0
1184,tt0104454,Howards End,1992,"10,000+",13748,1884,431,537,4,81.0,,69,65,4,69,4,94.0
1185,tt0103129,Truly Madly Deeply,1991,"10,000+",10198,1188,169,621,4.3,88.0,,38,29,9,38,4.3,76.0
1186,tt0102138,JFK,1992,"50,000+",62793,10165,1345,3464,4.2,88.0,,70,59,11,70,4.2,84.0
1187,tt0105151,The Player,1992,"10,000+",20712,3372,626,901,4,84.0,,68,66,2,68,4,97.0
1188,tt0104454,Howards End,1992,"10,000+",13748,1884,431,537,4,81.0,,69,65,4,69,4,94.0
1189,tt0105151,The Player,1992,"10,000+",20712,3372,626,901,4,84.0,,68,66,2,68,4,97.0
1190,tt0105488,Strictly Ballroom,1992,"25,000+",43373,4417,645,2111,4.2,87.0,,49,43,6,49,4.2,88.0
1191,tt0105488,Strictly Ballroom,1992,"25,000+",43373,4417,645,2111,4.2,87.0,,49,43,6,49,4.2,88.0
1192,tt0105695,Unforgiven,1992,"100,000+",123281,22112,1567,6491,4.4,93.0,,110,106,4,110,4.4,96.0
1193,tt0104466,Husbands and Wives,1992,"10,000+",14208,2591,398,559,4,87.0,,43,40,3,43,4,93.0
1194,tt0104036,The Crying Game,1992,"25,000+",31941,4032,1116,1288,3.8,78.0,,72,68,4,72,3.8,94.0
1195,tt0105695,Unforgiven,1992,"100,000+",123281,22112,1567,6491,4.4,93.0,,110,106,4,110,4.4,96.0
1196,tt0107207,In the Name of the Father,1993,"25,000+",41458,7706,396,1873,4.4,95.0,,50,47,3,50,4.4,94.0
1197,tt0108052,Schindler's List,1993,"250,000+",413183,82246,2643,22968,4.6,97.0,,134,131,3,134,4.6,98.0
1198,tt0108101,Shadowlands,1993,"10,000+",10086,1651,204,658,4.3,89.0,,30,29,1,30,4.3,97.0
1199,tt0101700,Delicatessen,1992,"25,000+",47312,10847,1076,3021,4.2,91.0,,58,52,6,58,4.2,90.0
1200,tt0101640,Raise The Red Lantern,1992,"10,000+",22298,3626,246,1041,4.4,94.0,,29,28,1,29,4.4,97.0
1201,tt0105323,Scent of a Woman,1993,"100,000+",119641,17495,1475,5064,4.3,92.0,,48,41,7,48,4.3,85.0
1202,tt0108101,Shadowlands,1993,"10,000+",10086,1651,204,658,4.3,89.0,,30,29,1,30,4.3,97.0
1203,tt0107943,The Remains of the Day,1993,"10,000+",24488,4102,482,1128,4.2,89.0,,47,45,2,47,4.2,96.0
1204,tt0108052,Schindler's List,1993,"250,000+",413183,82246,2643,22968,4.6,97.0,,134,131,3,134,4.6,98.0
1205,tt0108101,Shadowlands,1993,"10,000+",10086,1651,204,658,4.3,89.0,,30,29,1,30,4.3,97.0
1206,tt0107943,The Remains of the Day,1993,"10,000+",24488,4102,482,1128,4.2,89.0,,47,45,2,47,4.2,96.0
1207,tt0102014,Hear My Song,1992,500+,631,63,20,33,4,76.0,,31,28,3,31,4,90.0
1208,tt0107822,The Piano,1993,"25,000+",48590,8471,1395,2363,4.1,86.0,,71,64,7,71,4.1,90.0
1209,tt0107206,In the Line of Fire,1993,"50,000+",55232,4414,1172,1260,3.8,79.0,,73,70,3,73,3.8,96.0
1210,tt0107920,Raining Stones,1993,"1,000+",2310,287,27,75,4.1,91.0,,11,11,0,11,4.1,100.0
1211,tt0107822,The Piano,1993,"25,000+",48590,8471,1395,2363,4.1,86.0,,71,64,7,71,4.1,90.0
1212,tt0104507,Indochine,1993,"5,000+",6778,1095,208,301,4.1,84.0,,20,15,5,20,4.1,75.0
1213,tt0111454,Tom & Viv,1993,"1,000+",1305,56,36,36,3.5,61.0,,14,5,9,14,3.5,36.0
1214,tt0108160,Sleepless in Seattle,1993,"250,000+",297563,16679,5640,7936,3.8,75.0,,61,46,15,61,3.8,75.0
1215,tt0106332,Farewell My Concubine,1993,"10,000+",16164,2703,214,727,4.4,93.0,,50,45,5,50,4.4,90.0
1216,tt0110932,Quiz Show,1994,"25,000+",31681,4204,645,1053,4,87.0,,59,57,2,59,4,97.0
1217,tt0107048,Groundhog Day,1993,"250,000+",417530,32059,4474,14892,4.2,88.0,,145,136,9,145,4.2,94.0
1218,tt0109830,Forrest Gump,1994,"250,000+",1244237,170818,8770,92568,4.1,95.0,,108,77,31,108,4.1,71.0
1219,tt0109830,Forrest Gump,1994,"250,000+",1244237,170818,8770,92568,4.1,95.0,,108,77,31,108,4.1,71.0
1220,tt0109831,Four Weddings and a Funeral,1994,"100,000+",185233,8230,2919,3642,3.8,74.0,,73,70,3,73,3.8,96.0
1221,tt0110932,Quiz Show,1994,"25,000+",31681,4204,645,1053,4,87.0,,59,57,2,59,4,97.0
1222,tt0043362,The Browning Version,1994,"1,000+",1044,104,28,33,3.8,79.0,,18,14,4,18,3.8,78.0
1223,tt0107282,The Joy Luck Club,1994,"25,000+",27742,2612,327,1123,4.2,89.0,,85,73,12,85,4.2,86.0
1224,tt0111149,Shallow Grave,1994,"25,000+",40003,4913,1018,1484,3.9,83.0,,52,37,15,52,3.9,71.0
1225,tt0110912,Pulp Fiction,1994,"250,000+",1130319,228493,9056,62525,4.6,96.0,,116,107,9,116,4.6,92.0
1226,tt0106339,Backbeat,1994,"5,000+",5533,370,188,217,3.7,66.0,,40,27,13,40,3.7,68.0
1227,tt0106408,Bhaji on the Beach,1994,"1,000+",1145,63,43,39,3.4,59.0,,49,43,6,49,3.4,88.0
1228,tt0110912,Pulp Fiction,1994,"250,000+",1130319,228493,9056,62525,4.6,96.0,,116,107,9,116,4.6,92.0
1229,tt0109831,Four Weddings and a Funeral,1994,"100,000+",185233,8230,2919,3642,3.8,74.0,,73,70,3,73,3.8,96.0
1230,tt0822847,Priest,1994,"2,500+",4940,524,104,201,4.1,83.0,,25,16,9,25,4.1,64.0
1231,tt0111495,Three Colours: Red,1994,"25,000+",35704,7284,433,1337,4.4,94.0,,61,61,0,61,4.4,100.0
1232,tt0111797,"Eat Drink, Man Woman",1994,"10,000+",14235,2562,222,722,4.2,92.0,,50,44,6,50,4.2,88.0
1233,tt0117951,Trainspotting,1995,"250,000+",314082,70363,5046,16445,4.3,93.0,,89,80,9,89,4.3,90.0
1234,tt0112431,Babe,1995,"250,000+",508991,8702,4227,10142,3.7,67.0,,71,69,2,71,3.7,97.0
1235,tt0111495,Three Colours: Red,1994,"25,000+",35704,7284,433,1337,4.4,94.0,,61,61,0,61,4.4,100.0
1236,tt0113627,Leaving Las Vegas,1995,"50,000+",56708,7987,1410,2679,4.1,85.0,,53,48,5,53,4.1,91.0
1237,tt0110428,The Madness of King George,1995,"5,000+",8409,993,246,347,3.9,80.0,,47,44,3,47,3.9,94.0
1238,tt0114388,Sense and Sensibility,1995,"100,000+",131025,18837,2127,6608,4.2,90.0,,68,66,2,68,4.2,97.0
1239,tt0110428,The Madness of King George,1995,"5,000+",8409,993,246,347,3.9,80.0,,47,44,3,47,3.9,94.0
1240,tt0109045,"The Adventures of Priscilla, Queen of the Desert",1994,"25,000+",44553,5076,703,2182,4.2,88.0,,51,48,3,51,4.2,94.0
1241,tt0117951,Trainspotting,1995,"250,000+",314082,70363,5046,16445,4.3,93.0,,89,80,9,89,4.3,90.0
1242,tt0114388,Sense and Sensibility,1995,"100,000+",131025,18837,2127,6608,4.2,90.0,,68,66,2,68,4.2,97.0
1243,tt0112431,Babe,1995,"250,000+",508991,8702,4227,10142,3.7,67.0,,71,69,2,71,3.7,97.0
1244,tt0110428,The Madness of King George,1995,"5,000+",8409,993,246,347,3.9,80.0,,47,44,3,47,3.9,94.0
1245,tt0114814,The Usual Suspects,1995,"250,000+",435681,92887,4000,25647,4.5,96.0,,81,71,10,81,4.5,88.0
1246,tt0109348,Bullets Over Broadway,1995,"10,000+",17063,2404,485,636,3.9,83.0,,60,57,3,60,3.9,95.0
1247,tt1707386,Les Misérables,1995,"25,000+",38311,4149,847,1635,4,83.0,,44,33,11,44,4,75.0
1248,tt0114814,The Usual Suspects,1995,"250,000+",435681,92887,4000,25647,4.5,96.0,,81,71,10,81,4.5,88.0
1249,tt0241303,Chocolat,2000,"250,000+",329147,35773,7232,13003,4,83.0,,119,75,44,119,4,63.0
1250,tt0114671,Land and Freedom,1995,"5,000+",5300,1034,62,265,4.4,94.0,,14,11,3,14,4.4,79.0
1251,tt0112637,Carrington,1995,"2,500+",3490,248,87,80,3.8,74.0,,26,14,12,26,3.8,54.0
1252,tt0249462,Billy Elliot,2000,"250,000+",280750,12295,1553,5390,4.2,89.0,,119,101,18,119,4.2,85.0
1253,tt0181865,Traffic,2000,"100,000+",190654,17711,3228,4677,4,85.0,,223,208,15,223,4,93.0
1254,tt0185014,Wonder Boys,2000,"25,000+",40336,4608,954,1558,4,83.0,,127,103,24,127,4,81.0
1255,tt0110598,Muriel's Wedding,1995,"50,000+",50152,4274,795,2008,4.1,84.0,,48,39,9,48,4.1,81.0
1256,tt0146882,High Fidelity,2000,"100,000+",211971,31622,3687,11172,4.2,90.0,,165,150,15,165,4.2,91.0
1257,tt0120630,Chicken Run,2000,"250,000+",549273,13040,7032,10145,3.6,65.0,,174,169,5,174,3.6,97.0
1258,tt0249462,Billy Elliot,2000,"250,000+",280750,12295,1553,5390,4.2,89.0,,119,101,18,119,4.2,85.0
1259,tt0172495,Gladiator,2000,"250,000+",34128168,170538,24401,1652336,3.8,87.0,,257,205,52,257,3.8,80.0
1260,tt0181875,Almost Famous,2000,"250,000+",325433,47287,4278,14940,4.3,92.0,,177,158,19,177,4.3,89.0
1261,tt0195685,Erin Brockovich,2000,"250,000+",418943,13393,3174,8239,3.9,81.0,,150,127,23,150,3.9,85.0
1262,tt0200720,The House of Mirth,2000,"5,000+",5080,459,180,226,3.7,72.0,,101,83,18,101,3.7,82.0
1263,tt2172103,Last Resort,2000,"1,000+",1491,140,25,42,3.9,85.0,,71,67,4,71,3.9,94.0
1264,tt0181875,Almost Famous,2000,"250,000+",325433,47287,4278,14940,4.3,92.0,,177,158,19,177,4.3,89.0
1265,tt0249462,Billy Elliot,2000,"250,000+",280750,12295,1553,5390,4.2,89.0,,119,101,18,119,4.2,85.0
1266,tt0195685,Erin Brockovich,2000,"250,000+",418943,13393,3174,8239,3.9,81.0,,150,127,23,150,3.9,85.0
1267,tt0203119,Sexy Beast,2000,"25,000+",38732,5207,950,2194,4,85.0,,140,121,19,140,4,86.0
1268,tt0213847,Malèna,2000,"25,000+",29700,4557,838,1318,4,84.0,,78,42,36,78,4,54.0
1269,tt0190590,"O Brother, Where Art Thou?",2000,"250,000+",257029,28570,3642,11525,4.1,89.0,,156,122,34,156,4.1,78.0
1270,tt0172495,Gladiator,2000,"250,000+",34128168,170538,24401,1652336,3.8,87.0,,257,205,52,257,3.8,80.0
1271,tt0118694,In The Mood For Love,2000,"50,000+",54206,14330,931,3548,4.5,94.0,,187,172,15,187,4.5,92.0
