,imdb_id,movie_name,release_year,audience_banded_rating_count,audience_rating_count,audience_liked_count,audience_not_liked_count,audience_review_count,audience_avg_rating,audience_score,tomato_banded_rating_count,tomato_rating_count,tomato_liked_count,tomato_not_liked_count,tomato_review_count,tomato_avg_rating,tomato_score
0,tt0255819,Baby Boy,2001,"50,000+",62708,7334,1061,2243,4.3,87.0,,93,66,27,93,6.20,71.0
1,tt0366182,Anokha Rishta,1986,0,0,0,0,0,,,,0,0,0,0,,
2,tt0367546,Bindiya Chamkegi,1984,0,0,0,0,0,,,,0,0,0,0,,
3,tt0255668,Vandanam,1989,0,0,0,0,0,,,,0,0,0,0,,
4,tt0120166,The Sorcerer's Apprentice,2001,250+,267,10,23,10,2.7,30.0,,0,0,0,0,,
5,tt0119548,Little City,1997,500+,892,27,15,18,3.8,64.0,,3,1,2,3,,
6,tt0094320,White of the Eye,1987,500+,510,62,47,34,3.4,57.0,,8,4,4,8,5.80,50.0
7,tt0099054,Archie: To Riverdale and Back Again,1990,Fewer than 50,42,8,10,4,3.3,44.0,,1,0,1,1,,
8,tt0097499,Henry V,1989,"10,000+",13524,2305,290,784,4.3,89.0,,42,41,1,42,8.20,98.0
9,tt0178022,Siam Sunset,1999,250+,330,31,20,22,3.5,60.0,,9,6,3,9,6.10,67.0
10,tt0166158,Daddy and Them,2001,"1,000+",1203,90,77,50,3.4,54.0,,7,6,1,7,6.30,86.0
11,tt0097670,Kinjite: Forbidden Subjects,1989,"1,000+",1625,42,78,55,3,35.0,,6,0,6,6,3.60,0.0
12,tt0402230,The Great New Wonderful,2005,"10,000+",18686,129,158,163,3,45.0,,41,30,11,41,6.60,73.0
13,tt0405393,Rudo y Cursi,2008,"10,000+",19424,1262,653,669,3.6,66.0,,112,82,30,112,6.40,73.0
14,tt0347167,The Hero: Love Story of a Spy,2003,250+,299,17,20,6,3.1,46.0,,6,3,3,6,5.30,50.0
15,tt0479879,Chasing Ghosts: Beyond the Arcade,2007,500+,653,132,76,65,3.6,63.0,,4,4,0,4,,
16,tt0097790,Loverboy,1989,"5,000+",8024,380,300,210,3.4,56.0,,10,5,5,10,4.80,50.0
17,tt0074653,The Human Tornado,1976,"1,000+",2042,121,54,96,3.8,69.0,,5,4,1,5,8.30,80.0
18,tt0488380,Closing the Ring,2007,"2,500+",3229,329,235,232,3.4,58.0,,19,6,13,19,4.60,32.0
19,tt1479388,The High Cost of Living,2010,500+,792,182,136,60,3.4,57.0,,15,8,7,15,5.50,53.0
20,tt0274789,Minsaara Kanavu,1997,0,0,0,0,0,,,,0,0,0,0,,
21,tt0450258,Alien Express,2005,Fewer than 50,10,0,1,1,,,,0,0,0,0,,
22,tt1792799,Chromeskull: Laid to Rest 2,2011,250+,329,69,143,75,2.8,33.0,,2,2,0,2,,
23,tt0114660,Things to Do in Denver When You're Dead,1995,"10,000+",13381,1508,580,584,3.8,72.0,,30,11,19,30,5.30,37.0
24,tt0368645,Cipher in the Snow,1974,0,0,0,0,0,,,,0,0,0,0,,
25,tt1756660,Oru Black & White Kudumbam,2009,0,0,0,0,0,,,,0,0,0,0,,
26,tt0087015,C.H.U.D.,1984,"5,000+",8907,337,697,429,2.8,33.0,,14,4,10,14,3.90,29.0
27,tt0469263,The Astronaut Farmer,2006,"250,000+",283607,3422,3514,3987,3.2,49.0,,137,80,57,137,6.00,58.0
28,tt0354104,Thiruthalvadhi,1992,0,0,0,0,0,,,,0,0,0,0,,
29,tt0096775,Agneekaal,1990,0,0,0,0,0,,,,0,0,0,0,,
30,tt0343449,The Bone Snatcher,2003,"2,500+",4361,27,118,57,2.3,19.0,,7,0,7,7,3.10,0.0
31,tt0092969,Enemy Territory,1987,50+,92,19,7,10,3.7,73.0,,1,0,1,1,,
32,tt1452628,Vanishing on 7th Street,2010,"10,000+",17226,837,3170,1125,2.4,21.0,,60,29,31,60,5.00,48.0
33,tt0392023,Gagamboy,2004,0,0,0,0,0,,,,0,0,0,0,,
34,tt1692889,Plug & Pray,2010,Fewer than 50,31,5,1,0,3.9,83.0,,0,0,0,0,,
35,tt1697920,Fly Away,2011,100+,216,45,27,17,3.6,62.0,,13,11,2,13,6.80,85.0
36,tt1578818,Tradition Is a Temple: The Modern Masters of New Orleans,2013,0,0,0,0,0,,,,0,0,0,0,,
37,tt2378334,Aval Varuvala,1998,0,0,0,0,0,,,,0,0,0,0,,
38,tt0106664,The Dark Half,1993,"5,000+",9024,361,576,302,3.1,39.0,,34,20,14,34,5.90,59.0
39,tt0461472,Boy Called Twist,2004,250+,475,13,8,15,3.9,62.0,,0,0,0,0,,
40,tt0065825,Hell Boats,1970,Fewer than 50,6,2,4,4,2.9,33.0,,0,0,0,0,,
41,tt0079094,Eagle's Wing,1979,100+,145,5,14,6,3,26.0,,1,1,0,1,,
42,tt0077928,Midnight Express,1978,"25,000+",31219,4957,604,1416,4.2,89.0,,30,27,3,30,7.50,90.0
43,tt0081764,Without Warning,1980,Fewer than 50,5,2,3,2,2.6,40.0,,0,0,0,0,,
44,tt0161292,Bleeder,1999,0,0,0,0,0,,,,0,0,0,0,,
45,tt0102517,Necessary Roughness,1991,"5,000+",9541,428,485,230,3.2,47.0,,31,11,20,31,4.60,35.0
46,tt0152930,Taxi,1998,"2,500+",3570,2894,675,925,3.9,81.0,,2,1,1,2,,
47,tt0219224,On the Beach,2000,"1,000+",1034,82,41,42,3.6,66.0,,5,3,2,5,5.70,60.0
48,tt0101283,Ajooba,1991,0,0,0,0,0,,,,0,0,0,0,,
49,tt0443436,The Aviary,2005,500+,506,6,2,1,3.9,75.0,,0,0,0,0,,
50,tt0152930,Taxi,1998,"2,500+",3570,2894,675,925,3.9,81.0,,2,1,1,2,,
51,tt0053651,Beyond the Time Barrier,1960,100+,159,13,28,19,2.8,32.0,,6,4,2,6,4.90,67.0
52,tt0114008,Nothing to Lose,1995,"25,000+",47374,2026,943,1124,3.7,68.0,,26,8,18,26,5.30,31.0
53,tt0271748,Raju Chacha,2000,Fewer than 50,46,3,14,1,2.5,18.0,,0,0,0,0,,
54,tt0103939,Chaplin,1992,"25,000+",25955,3716,898,1355,3.9,81.0,,55,33,22,55,5.70,60.0
55,tt1400528,Mon Mane Na,2008,0,0,0,0,0,,,,0,0,0,0,,
56,tt0142393,I'm Losing You,1998,250+,497,3,8,2,2.9,27.0,,5,2,3,5,4.90,40.0
57,tt0113759,The Man with the Perfect Swing,1995,0,0,0,0,0,,,,0,0,0,0,,
58,tt8942852,Dharma Seelan,1993,0,0,0,0,0,,,,0,0,0,0,,
59,tt0059466,Monsters Crash the Pajama Party,1965,Fewer than 50,2,1,1,1,,,,0,0,0,0,,
60,tt1664723,My Little Pony: Twinkle Wish Adventure,2009,Fewer than 50,47,8,7,6,3.4,53.0,,0,0,0,0,,
61,tt1882053,Chick Magnet,2011,100+,200,34,52,10,2.9,40.0,,0,0,0,0,,
62,tt1918969,Amar Bondhu Rashed,2011,0,0,0,0,0,,,,0,0,0,0,,
63,tt0336910,9 Dead Gay Guys,2002,"2,500+",2595,127,80,92,3.4,61.0,,23,5,18,23,4.40,22.0
64,tt0466839,I Could Never Be Your Woman,2007,"10,000+",23973,1679,2124,1405,3.1,44.0,,12,8,4,12,6.00,67.0
65,tt0237376,Kireedam,1989,250+,337,40,6,15,4.3,87.0,,0,0,0,0,,
66,tt1698537,Mamarazzi,2010,0,0,0,0,0,,,,0,0,0,0,,
67,tt0283037,Tanging yaman,2000,50+,98,14,0,4,4.7,100.0,,0,0,0,0,,
68,tt0428579,Suburban Girl,2007,"5,000+",5744,414,941,544,2.8,31.0,,8,4,4,8,6.10,50.0
69,tt0370279,Anbe Vaa,1966,Fewer than 50,36,0,1,0,,,,0,0,0,0,,
70,tt0287152,Yamraaj,1998,0,0,0,0,0,,,,0,0,0,0,,
71,tt1074201,It's Breaking News,2007,50+,85,2,5,1,2.6,29.0,,2,1,1,2,,
72,tt0492481,Puccini for Beginners,2006,500+,706,111,135,78,3.1,45.0,,63,31,32,63,5.60,49.0
73,tt0839742,Bhopal: A Prayer for Rain,2014,100+,223,37,26,13,3.7,59.0,,19,13,6,19,6.40,68.0
74,tt0115750,Breaking the Surface: The Greg Louganis Story,1997,100+,141,20,8,7,4.1,71.0,,0,0,0,0,,
75,tt0058155,The Gorgon,1964,500+,849,130,141,97,3.3,48.0,,12,8,4,12,6.00,67.0
76,tt1407061,Just Wright,2010,"100,000+",108544,3199,2076,1281,3.6,61.0,,111,52,59,111,5.20,47.0
77,tt0254179,Betaab,1983,250+,366,11,6,4,3.5,65.0,,0,0,0,0,,
78,tt0163983,Bless the Child,2000,0,0,0,0,0,,,,0,0,0,0,,
79,tt0053559,13 Ghosts,1960,"250,000+",282485,508,730,2032,3.1,41.0,,14,5,9,14,5.00,36.0
80,tt0062979,Flesh,1968,"1,000+",2226,115,112,79,3.3,51.0,,9,6,3,9,7.00,67.0
81,tt0163559,The Book of Stars,1999,500+,814,50,14,19,4,78.0,,2,0,2,2,,
82,tt1234586,Only for You,2008,"2,500+",3092,72,69,73,3.3,51.0,,0,0,0,0,,
83,tt6823322,Maanbumigu Maanavan,1996,0,0,0,0,0,,,,0,0,0,0,,
84,tt0368658,Stage Beauty,2004,"10,000+",11133,1430,411,704,3.9,78.0,,127,81,46,127,6.50,64.0
85,tt0896909,Baba Kalyani,2006,100+,216,0,5,1,2.2,0.0,,0,0,0,0,,
86,tt0790804,The Comebacks,2007,"100,000+",120376,1787,3598,2406,2.7,33.0,,33,3,30,33,3.00,9.0
87,tt0907618,Aadavari Matalaku Ardhalu Verule,2007,250+,289,12,3,7,4,80.0,,0,0,0,0,,
88,tt1613110,Kanden Kadhalai,2009,0,0,0,0,0,,,,0,0,0,0,,
89,tt0088134,Slapstick (Of Another Kind),1982,Fewer than 50,29,2,10,6,1.8,17.0,,0,0,0,0,,
90,tt1018723,Get Smart's Bruce and Lloyd Out of Control,2008,"2,500+",3653,206,564,361,2.7,27.0,,3,2,1,3,,
91,tt0113463,Jefferson in Paris,1995,"1,000+",1278,43,80,25,2.9,35.0,,16,5,11,16,4.80,31.0
92,tt1343362,Do Knot Disturb,2009,250+,262,20,66,41,2.3,23.0,,5,1,4,5,3.90,20.0
93,tt0082237,Dawn of the Mummy,1981,250+,361,10,33,20,2.5,23.0,,0,0,0,0,,
94,tt0800320,Clash of the Titans,2010,"250,000+",284114,20512,31297,18762,3,40.0,,266,72,194,266,4.40,27.0
95,tt0800320,Clash of the Titans,2010,"250,000+",284114,20512,31297,18762,3,40.0,,266,72,194,266,4.40,27.0
96,tt0249371,Asoka,2001,"5,000+",9422,621,281,326,3.7,69.0,,10,10,0,10,7.60,100.0
97,tt1820446,Four Friends,2010,Fewer than 50,7,0,1,0,,,,0,0,0,0,,
98,tt0160611,Ordinary Decent Criminal,2000,"5,000+",5618,462,312,209,3.4,60.0,,7,1,6,7,3.70,14.0
99,tt0435705,Next,2007,"250,000+",339774,17338,15403,15823,3.2,53.0,,131,37,94,131,4.60,28.0
100,tt0445946,The Contract,2006,"10,000+",18973,1050,3021,1922,2.6,26.0,,6,0,6,6,3.90,0.0
101,tt0109913,Go Fish,1994,"2,500+",3035,168,125,79,3.4,57.0,,69,52,17,69,6.40,75.0
102,tt0293088,Devil's Playground,2002,"5,000+",5019,433,192,276,3.6,69.0,,9,5,4,9,6.40,56.0
103,tt1773109,Yamla Pagla Deewana,2011,250+,492,106,91,68,3.4,54.0,,2,1,1,2,,
104,tt1842347,Damarukam,2012,Fewer than 50,1,1,0,0,,,,0,0,0,0,,
105,tt0119173,G.I. Jane,1997,"100,000+",160017,2656,2354,2396,3.4,53.0,,38,20,18,38,5.70,53.0
106,tt0091341,Kin-dza-dza!,1986,500+,836,292,19,77,4.5,94.0,,0,0,0,0,,
107,tt0787498,Not Like Everyone Else,2006,250+,266,20,17,20,3.4,54.0,,0,0,0,0,,
108,tt0286557,Coney Island Baby,2002,500+,940,3,3,3,3.3,50.0,,0,0,0,0,,
109,tt0119644,Meet Wally Sparks,1997,"2,500+",3445,66,148,65,2.8,31.0,,16,2,14,16,3.10,13.0
110,tt0062803,Chitty Chitty Bang Bang,1968,"250,000+",340454,5642,2325,7540,3.8,71.0,,30,21,9,30,5.90,70.0
111,tt0080157,Yanks,1979,"1,000+",1890,100,60,47,3.7,62.0,,21,12,9,21,5.60,57.0
112,tt0083168,Tanya's Island,1980,250+,401,4,12,6,2.5,25.0,,0,0,0,0,,
113,tt0210714,The Golden Spiders: A Nero Wolfe Mystery,2000,0,0,0,0,0,,,,0,0,0,0,,
114,tt0099155,Bloodfist II,1990,"1,000+",1842,13,19,16,3.1,41.0,,0,0,0,0,,
115,tt0104609,Kickboxer 3: The Art of War,1992,"2,500+",3733,32,97,48,2.7,25.0,,0,0,0,0,,
116,tt0248673,Aparan,1988,0,0,0,0,0,,,,0,0,0,0,,
117,tt2042447,The Amityville Haunting,2011,250+,437,23,220,94,1.6,9.0,,4,0,4,4,,
118,tt0187279,Meri Biwi Ka Jawab Nahin,2004,0,0,0,0,0,,,,0,0,0,0,,
119,tt0067592,The Devil's Nightmare,1971,250+,380,29,35,30,3.1,45.0,,3,1,2,3,,
120,tt0084171,Jekyll and Hyde... Together Again,1982,500+,646,72,28,58,3.9,72.0,,1,0,1,1,,
121,tt0814022,Bangkok Dangerous,2008,"100,000+",132404,2143,6079,3754,2.6,26.0,,94,8,86,94,3.50,9.0
122,tt0099080,Baaghi: A Rebel for Love,1990,250+,320,44,49,21,3.1,47.0,,10,3,7,10,3.50,30.0
123,tt0450278,Hostel,2005,"250,000+",471311,18793,16395,21674,3.2,53.0,,109,64,45,109,6.10,59.0
124,tt0450278,Hostel,2005,"250,000+",471311,18793,16395,21674,3.2,53.0,,109,64,45,109,6.10,59.0
125,tt0064155,Charro!,1969,"2,500+",2706,75,59,83,3.5,56.0,,2,0,2,2,,
126,tt0245682,Abhilasha,1983,0,0,0,0,0,,,,0,0,0,0,,
127,tt0357145,Seenu,1999,0,0,0,0,0,,,,0,0,0,0,,
128,tt0057568,Tere Ghar Ke Samne,1963,0,0,0,0,0,,,,0,0,0,0,,
129,tt0092206,The Whistle Blower,1986,"1,000+",1504,43,53,30,3.1,45.0,,10,9,1,10,7.60,90.0
130,tt0414998,Futile Attraction,2004,50+,56,0,4,1,,,,1,1,0,1,,
131,tt1294226,The Last Song,2010,"100,000+",160863,10666,5615,4294,3.7,65.0,,122,26,96,122,4.10,21.0
132,tt0058385,My Fair Lady,1964,"100,000+",187222,14889,1731,6418,4.3,90.0,,91,86,5,91,8.60,95.0
133,tt0226875,Female Prisoner Scorpion: Beast Stable,1973,500+,626,81,16,28,4,84.0,,1,1,0,1,,
134,tt0096028,Salaam Bombay!,1988,"5,000+",5719,770,59,220,4.3,93.0,,30,28,2,30,7.80,93.0
135,tt0057055,Father Came Too!,1964,Fewer than 50,3,1,2,0,,,,0,0,0,0,,
136,tt0119324,The House of Yes,1997,"5,000+",7646,909,281,405,3.9,76.0,,39,24,15,39,5.90,62.0
137,tt0434292,Princesas,2005,"10,000+",14558,512,114,182,3.9,82.0,,31,23,8,31,6.50,74.0
138,tt0329737,It's a Very Merry Muppet Christmas Movie,2002,"2,500+",4604,294,278,195,3.3,51.0,,11,9,2,11,6.50,82.0
139,tt0071216,Big Bad Mama,1974,"2,500+",4327,43,64,49,3.1,41.0,,16,12,4,16,6.00,75.0
140,tt0926063,Dance of the Dead,2008,"2,500+",3287,629,595,627,3.2,51.0,,5,4,1,5,7.20,80.0
141,tt0240670,Las Vegas Bloodbath,1989,0,0,0,0,0,,,,0,0,0,0,,
142,tt0290940,Zaalim,1994,0,0,0,0,0,,,,0,0,0,0,,
143,tt0246959,Sukrutham,1994,0,0,0,0,0,,,,0,0,0,0,,
144,tt0071523,Frightmare,1974,500+,915,54,46,46,3.2,54.0,,1,1,0,1,,
145,tt0110916,Puppet Master 5,1994,"5,000+",6176,83,174,96,2.8,32.0,,2,1,1,2,,
146,tt0388534,Wasp,2003,250+,361,87,15,25,4,85.0,,1,1,0,1,,
147,tt0100173,A Mom for Christmas,1990,"1,000+",1466,94,36,61,3.8,72.0,,0,0,0,0,,
148,tt0098825,House of Cards,1990,"2,500+",4111,182,84,67,3.8,68.0,,10,6,4,10,5.90,60.0
149,tt0053648,No Kidding,1960,Fewer than 50,33,1,1,2,,,,0,0,0,0,,
150,tt0121989,Baazi,1995,250+,251,13,16,4,3.4,45.0,,0,0,0,0,,
151,tt4516596,Vallarasu,2000,0,0,0,0,0,,,,0,0,0,0,,
152,tt0325123,Bright Young Things,2003,"5,000+",6448,548,265,300,3.6,67.0,,112,74,38,112,6.30,66.0
153,tt1773039,Sella Turcica,2010,50+,57,14,11,8,3.2,56.0,,0,0,0,0,,
154,tt0099625,Future Zone,1990,50+,73,1,19,7,1.7,5.0,,0,0,0,0,,
155,tt0057578,This Sporting Life,1963,"1,000+",1911,364,58,175,4.1,86.0,,24,23,1,24,8.20,96.0
156,tt0381341,Kisses and Caroms,2006,500+,987,15,53,38,2.2,22.0,,5,2,3,5,6.30,40.0
157,tt0381341,Kisses and Caroms,2006,500+,987,15,53,38,2.2,22.0,,5,2,3,5,6.30,40.0
158,tt1276104,Looper,2012,"100,000+",181008,75072,16687,12238,4,82.0,,275,256,19,275,8.10,93.0
159,tt0091538,Mona Lisa,1986,"5,000+",5769,770,182,253,3.9,81.0,,40,39,1,40,8.10,98.0
160,tt0126916,For Love of the Game,1999,"25,000+",43617,3132,1038,1319,3.9,75.0,,95,44,51,95,6.10,46.0
161,tt0220506,Halloween: Resurrection,2002,"50,000+",90719,1462,4485,2477,2.3,25.0,,70,7,63,70,3.40,10.0
162,tt0090106,Surviving,1985,100+,194,20,1,7,4.4,95.0,,0,0,0,0,,
163,tt0085253,Blood Rage,1987,Fewer than 50,16,9,7,3,3.1,56.0,,3,3,0,3,,
164,tt0406706,Devour,2005,"5,000+",8833,377,525,556,3,42.0,,5,1,4,5,3.70,20.0
165,tt0101420,Begotten,1989,"5,000+",6301,588,317,338,3.5,65.0,,10,7,3,10,6.20,70.0
166,tt0259423,Mangamma Gari Manavadu,1984,0,0,0,0,0,,,,0,0,0,0,,
167,tt0331952,The Clearing,2004,"5,000+",7409,313,663,338,2.8,32.0,,133,57,76,133,5.60,43.0
168,tt0106931,La Florida,1993,50+,82,8,13,4,2.8,38.0,,0,0,0,0,,
169,tt0055139,The Manster,1959,500+,687,26,60,47,2.7,30.0,,3,2,1,3,,
170,tt0115788,Buried Secrets,1996,Fewer than 50,23,1,1,1,,,,0,0,0,0,,
171,tt1218345,Dil Kabaddi,2008,250+,308,29,56,39,2.9,34.0,,2,0,2,2,,
172,tt0097044,Chances Are,1989,"5,000+",8980,707,389,337,3.7,65.0,,31,20,11,31,5.70,65.0
173,tt0266452,Death to Smoochy,2002,"50,000+",59991,4517,2293,2824,3.6,66.0,,119,50,69,119,5.30,42.0
174,tt0199290,3 Strikes,2000,"5,000+",7287,205,102,75,3.8,67.0,,29,0,29,29,2.60,0.0
175,tt0176269,Universal Soldier: The Return,1999,"25,000+",43518,392,1258,563,2.4,24.0,,58,3,55,58,2.90,5.0
176,tt0091027,Eye of the Tiger,1986,"1,000+",1887,47,57,46,3.1,45.0,,5,1,4,5,5.20,20.0
177,tt0072895,Dolemite,1975,"5,000+",5867,383,198,316,3.7,66.0,,14,8,6,14,5.00,57.0
178,tt5616312,The Adventures of Buckaroo Banzai: Across the Eighth Dimension,1985,"10,000+",17164,1900,860,1159,3.7,69.0,,44,29,15,44,6.50,66.0
179,tt0432088,Spirit Bear: The Simon Jackson Story,2005,100+,121,11,14,8,3,44.0,,1,1,0,1,,
180,tt1013860,Dylan Dog: Dead of Night,2010,"10,000+",15346,944,2346,813,2.6,29.0,,45,2,43,45,3.60,4.0
181,tt0964517,The Fighter,2010,"100,000+",121792,43521,5277,11223,4.1,89.0,,256,233,23,256,7.80,91.0
182,tt0964517,The Fighter,2010,"100,000+",121792,43521,5277,11223,4.1,89.0,,256,233,23,256,7.80,91.0
183,tt0096380,Vice Versa,1988,"5,000+",8110,253,358,235,3.1,41.0,,16,8,8,16,4.90,50.0
184,tt1485072,Teree Sang: A Kidult Love Story,2009,0,0,0,0,0,,,,0,0,0,0,,
185,tt0361925,Welcome to Mooseport,2004,"10,000+",20181,258,1071,416,2.4,19.0,,145,19,126,145,4.20,13.0
186,tt0787484,A Girl Like Me: The Gwen Araujo Story,2006,500+,700,166,17,79,4.4,91.0,,0,0,0,0,,
187,tt0292113,Mitr: My Friend,2002,50+,70,10,4,1,3.8,71.0,,0,0,0,0,,
188,tt1104814,Coffin Rock,2009,"2,500+",2539,76,174,100,2.7,30.0,,20,14,6,20,6.00,70.0
189,tt0172188,Bol Radha Bol,1992,250+,269,3,15,1,2.4,17.0,,0,0,0,0,,
190,tt12393110,Putham Puthu Payanam,1991,0,0,0,0,0,,,,0,0,0,0,,
191,tt0088775,Basic Training,1985,100+,177,4,16,5,2.5,20.0,,0,0,0,0,,
192,tt1013542,The Cheetah Girls: One World,2008,"5,000+",9202,356,203,235,3.7,64.0,,4,1,3,4,,
193,tt1149199,Aga Bai Arecha,2004,Fewer than 50,7,0,1,0,,,,0,0,0,0,,
194,tt2145803,Mouna Guru,2011,Fewer than 50,3,3,0,1,,,,0,0,0,0,,
195,tt0262333,Chronopolis,1982,Fewer than 50,1,0,1,1,,,,0,0,0,0,,
196,tt1156173,Vincere,2009,"10,000+",11170,459,218,174,3.5,68.0,,93,85,8,93,7.60,91.0
197,tt0100234,Close-Up,1990,500+,825,728,97,182,4.2,88.0,,17,15,2,17,8.30,88.0
198,tt0487037,Mammoth,2006,"5,000+",7009,680,407,289,3.4,63.0,,42,19,23,42,5.20,45.0
199,tt0487037,Mammoth,2006,"5,000+",7009,680,407,289,3.4,63.0,,42,19,23,42,5.20,45.0
200,tt0095989,Return of the Killer Tomatoes!,1988,"5,000+",8248,351,364,300,3.2,49.0,,6,0,6,6,3.40,0.0
201,tt0859622,The Last Day of Summer,2007,100+,239,30,15,13,3.5,67.0,,1,1,0,1,,
202,tt0091053,Fire with Fire,1986,"1,000+",2046,132,26,74,4.1,83.0,,1,0,1,1,,
203,tt1318001,Handsome Harry,2009,250+,393,60,48,37,3.3,56.0,,27,22,5,27,6.70,81.0
204,tt1233301,Ironclad,2011,"10,000+",10964,1244,1763,698,3.1,41.0,,54,23,31,54,5.20,43.0
205,tt0255653,Tortilla Soup,2001,"5,000+",5205,443,183,239,3.7,71.0,,74,55,19,74,6.40,74.0
206,tt0803061,Red Dog,2011,"2,500+",3628,1345,338,443,3.9,80.0,,37,31,6,37,6.70,84.0
207,tt0354946,Suyamvaram,1999,0,0,0,0,0,,,,0,0,0,0,,
208,tt0337633,Hathyar: Face to Face with Reality,2002,0,0,0,0,0,,,,0,0,0,0,,
209,tt0485270,Ratchakan,1997,0,0,0,0,0,,,,0,0,0,0,,
210,tt0118903,Falling Sky,1998,100+,242,17,15,11,3.2,53.0,,0,0,0,0,,
211,tt0102178,K2,1991,"5,000+",5276,172,181,98,3.3,49.0,,17,5,12,17,4.60,29.0
212,tt0089767,Pale Rider,1985,"25,000+",39791,3662,759,1038,3.9,83.0,,29,27,2,29,7.30,93.0
213,tt0053879,The Great Impostor,1960,100+,101,20,4,3,3.9,83.0,,1,0,1,1,,
214,tt0110064,House Party 3,1994,"5,000+",9439,447,221,189,3.7,67.0,,10,0,10,10,3.20,0.0
215,tt0227671,Tortilla Heaven,2007,"1,000+",1425,11,19,17,2.7,37.0,,12,3,9,12,4.50,25.0
216,tt1192385,Nenjinile,1999,0,0,0,0,0,,,,0,0,0,0,,
217,tt0088444,The Zany Adventures of Robin Hood,1984,100+,177,2,3,4,2.9,40.0,,0,0,0,0,,
218,tt0104804,Man Trouble,1992,"1,000+",2457,21,126,32,2.2,14.0,,30,2,28,30,3.80,7.0
219,tt0106399,Between Love and Hate,1993,0,0,0,0,0,,,,1,0,1,1,,
220,tt0060095,Alvarez Kelly,1966,"1,000+",2348,27,31,17,3.4,47.0,,3,2,1,3,,
221,tt0095299,Hide and Go Shriek,1988,100+,180,20,16,14,3.1,56.0,,0,0,0,0,,
222,tt0263879,Poola Rangadu,1967,0,0,0,0,0,,,,0,0,0,0,,
223,tt0053839,A French Mistress,1960,0,0,0,0,0,,,,0,0,0,0,,
224,tt0905968,Black Dahlia,2006,250+,310,5,44,32,1.2,10.0,,0,0,0,0,,
225,tt0321241,Anna's Dream,2002,50+,86,1,11,3,2,8.0,,0,0,0,0,,
226,tt0494652,"Welcome Home, Roscoe Jenkins",2008,"100,000+",190294,3959,2357,2800,3.6,63.0,,83,19,64,83,4.50,23.0
227,tt0095396,Chicken and Duck Talk,1988,0,0,0,0,0,,,,0,0,0,0,,
228,tt1503769,Collapse,2009,Fewer than 50,25,5,4,4,3.4,56.0,,1,1,0,1,,
229,tt0425061,Get Smart,2008,"250,000+",451455,37729,18890,25621,3.6,67.0,,222,113,109,222,5.60,51.0
230,tt0311648,Pieces of April,2003,"25,000+",29530,2289,835,1229,3.7,73.0,,154,129,25,154,7.10,84.0
231,tt0231775,Down to Earth,2001,"50,000+",62534,954,1412,945,3,40.0,,96,19,77,96,3.90,20.0
232,tt0305357,Charlie's Angels: Full Throttle,2003,"250,000+",463247,4780,7182,8588,2.9,40.0,,186,77,109,186,5.10,41.0
233,tt0305357,Charlie's Angels: Full Throttle,2003,"250,000+",463247,4780,7182,8588,2.9,40.0,,186,77,109,186,5.10,41.0
234,tt0379786,Serenity,2005,"250,000+",313456,45805,4366,22853,4.3,91.0,,189,155,34,189,7.20,82.0
235,tt0412637,Delirious,2006,"5,000+",8476,607,450,399,3.4,57.0,,64,53,11,64,6.80,83.0
236,tt1645131,Romeo & Juliet,2013,"1,000+",2251,846,987,255,3.1,46.0,,89,21,68,89,4.60,24.0
237,tt1645131,Romeo & Juliet,2013,"1,000+",2251,846,987,255,3.1,46.0,,89,21,68,89,4.60,24.0
238,tt0461946,Everything's Gone Green,2006,"5,000+",6023,365,240,300,3.4,60.0,,40,27,13,40,6.60,68.0
239,tt0307109,The Lost Skeleton of Cadavra,2001,"5,000+",7297,789,135,501,4.1,85.0,,68,37,31,68,5.90,54.0
240,tt0269374,Is There Anybody There?,1976,0,0,0,0,0,,,,0,0,0,0,,
241,tt0469099,Hey Hey It's Esther Blueburger,2008,500+,739,127,103,104,3.4,55.0,,6,3,3,6,5.30,50.0
242,tt1160317,Death of a Ghost Hunter,2007,"1,000+",1614,94,218,184,2.6,30.0,,0,0,0,0,,
243,tt0477078,Rocket Science,2007,"10,000+",20940,3257,1272,2011,3.7,72.0,,114,96,18,114,7.00,84.0
244,tt0307879,Burning Annie,2004,50+,95,6,10,10,2.8,38.0,,8,4,4,8,5.60,50.0
245,tt0278501,In Harihar Nagar,1990,0,0,0,0,0,,,,0,0,0,0,,
246,tt0838233,A Thousand Years of Good Prayers,2007,500+,858,118,98,73,3,55.0,,39,31,8,39,6.80,79.0
247,tt1085507,The Square,2008,0,0,0,0,0,,,,0,0,0,0,,
248,tt0238546,Queen of the Damned,2002,"250,000+",259941,11917,6104,10197,3.7,66.0,,130,22,108,130,4.00,17.0
249,tt0151511,Mausam,1975,50+,84,8,4,1,4,67.0,,0,0,0,0,,
250,tt1146431,Ben 10: Secret of the Omnitrix,2007,500+,616,107,26,28,4.1,81.0,,0,0,0,0,,
251,tt1204315,Meerkat Manor: The Story Begins,2008,100+,109,13,5,5,3.6,72.0,,1,1,0,1,,
252,tt0273539,Distant Shadow,2000,0,0,0,0,0,,,,0,0,0,0,,
253,tt0438562,Virginal Young Blondes,2004,0,0,0,0,0,,,,1,1,0,1,,
254,tt0121395,Imtihaan,1994,50+,58,1,0,0,,,,0,0,0,0,,
255,tt0118780,Broadway Damage,1997,500+,835,17,16,14,3.3,52.0,,9,2,7,9,4.00,22.0
256,tt0313971,Dil-E-Nadaan,1982,0,0,0,0,0,,,,0,0,0,0,,
257,tt0357945,Nammal,2002,0,0,0,0,0,,,,0,0,0,0,,
258,tt0113126,From the Mixed-Up Files of Mrs. Basil E. Frankweiler,1995,500+,687,14,20,18,3.4,41.0,,1,1,0,1,,
259,tt0301563,Love's Brother,2004,500+,885,65,34,24,3.6,66.0,,0,0,0,0,,
260,tt1928330,Bad Ass,2012,"5,000+",6781,663,1052,351,3,39.0,,5,1,4,5,4.70,20.0
261,tt0280396,Adharm,1992,0,0,0,0,0,,,,0,0,0,0,,
262,tt0064418,"Hello, Dolly!",1969,"10,000+",21249,1330,430,749,3.9,76.0,,31,14,17,31,6.00,45.0
263,tt0058324,Man's Favorite Sport?,1964,"1,000+",2434,164,62,76,3.8,73.0,,16,10,6,16,6.20,63.0
264,tt0104242,The Fear Inside,1992,50+,64,4,5,0,3.3,44.0,,1,1,0,1,,
265,tt0795438,Not Easily Broken,2009,"50,000+",69418,806,404,592,3.7,67.0,,68,21,47,68,4.60,31.0
266,tt0118184,Without a Map,1996,Fewer than 50,9,3,1,0,,,,0,0,0,0,,
267,tt0328031,King of the Ants,2003,"2,500+",3152,202,150,135,3.2,57.0,,0,0,0,0,,
268,tt0109676,Drop Zone,1994,"10,000+",19291,321,683,212,2.9,32.0,,23,9,14,23,4.60,39.0
269,tt0106455,Boiling Point,1993,"10,000+",10280,89,317,90,2.5,22.0,,12,2,10,12,4.40,17.0
270,tt0100884,Voices Within: The Lives of Truddi Chase,1990,Fewer than 50,7,1,0,0,,,,0,0,0,0,,
271,tt0080038,Le toubib,1979,0,0,0,0,0,,,,0,0,0,0,,
272,tt2112231,Poola Rangadu,2012,Fewer than 50,21,2,0,0,,,,0,0,0,0,,
273,tt0799951,Body Armour,2007,250+,302,13,33,22,2.4,28.0,,0,0,0,0,,
274,tt0079285,Saturn 3,1980,"2,500+",2756,122,282,139,2.7,30.0,,15,5,10,15,4.00,33.0
275,tt0218433,Me & Isaac Newton,1999,250+,326,6,0,1,4.5,100.0,,10,9,1,10,7.00,90.0
276,tt1172233,Whip It,2009,"100,000+",114071,13184,4648,5074,3.7,74.0,,192,164,28,192,7.00,85.0
277,tt0836682,Nocturna,2007,100+,176,145,31,53,4,82.0,,2,1,1,2,,
278,tt0095271,Halloween 4: The Return of Michael Myers,1988,"50,000+",69625,3389,2983,2042,3.4,53.0,,31,12,19,31,4.20,39.0
279,tt0972357,An American Opera,2007,0,0,0,0,0,,,,0,0,0,0,,
280,tt0848638,Sakkarakatti,2008,0,0,0,0,0,,,,0,0,0,0,,
281,tt1747924,My Future Boyfriend,2011,500+,740,86,193,32,2.7,31.0,,0,0,0,0,,
282,tt0104573,Juice,1992,"25,000+",48747,4943,553,1665,4.4,90.0,,30,24,6,30,6.40,80.0
283,tt0252223,All the Queen's Men,2001,"2,500+",3739,107,104,107,3.2,51.0,,29,2,27,29,3.50,7.0
284,tt1535612,The Son of No One,2011,"5,000+",5708,373,1331,275,2.5,22.0,,38,6,32,38,3.70,16.0
285,tt0273870,Narasimham,2000,0,0,0,0,0,,,,0,0,0,0,,
286,tt0263386,Going Greek,2001,"1,000+",1554,112,57,66,3.7,66.0,,0,0,0,0,,
287,tt0273842,Motocrossed,2001,"5,000+",6291,417,130,182,4,76.0,,2,2,0,2,,
288,tt0085211,The Prodigal Son,1981,"2,500+",3186,288,28,154,4.3,91.0,,5,5,0,5,7.00,100.0
289,tt0095951,The Raggedy Rawney,1988,Fewer than 50,5,0,1,1,,,,2,0,2,2,,
290,tt0092115,Troll,1986,"5,000+",8482,321,803,506,2.6,29.0,,10,3,7,10,3.70,30.0
291,tt0089243,Gymkata,1985,"2,500+",3836,176,270,242,2.8,40.0,,12,2,10,12,3.60,17.0
292,tt0073029,Galileo,1975,100+,135,7,8,7,3.5,47.0,,0,0,0,0,,
293,tt0397078,Just My Luck,2006,"250,000+",353920,8926,9595,9701,3.2,48.0,,111,16,95,111,3.90,14.0
294,tt0462519,School for Scoundrels,2006,"100,000+",107819,5141,4669,3784,3.3,52.0,,139,37,102,139,4.70,27.0
295,tt1312251,The Good Witch's Garden,2009,500+,537,104,54,31,3.7,66.0,,0,0,0,0,,
296,tt0073502,Overlord,1975,"1,000+",1352,158,60,97,3.7,72.0,,19,17,2,19,8.00,89.0
297,tt0960143,Love's Unfolding Dream,2007,"1,000+",2253,242,44,82,4.2,85.0,,1,0,1,1,,
298,tt0177226,Sisters of Death,1977,100+,239,3,59,30,2,5.0,,0,0,0,0,,
299,tt0059171,The Fat Spy,1966,50+,99,4,11,11,2.1,27.0,,1,0,1,1,,
300,tt0070694,"Silent Night, Bloody Night",1972,"1,000+",2160,69,164,94,2.7,30.0,,2,0,2,2,,
301,tt1985981,Desi Boyz,2011,500+,953,148,200,70,3,43.0,,2,1,1,2,,
302,tt0109369,Camp Nowhere,1994,"25,000+",28281,762,552,518,3.5,58.0,,12,2,10,12,3.60,17.0
303,tt0473360,Goal II: Living the Dream,2007,"10,000+",24470,2296,1418,1350,3.5,62.0,,18,7,11,18,4.80,39.0
304,tt0075774,Bobby Deerfield,1977,"1,000+",1353,76,94,47,3.1,45.0,,14,4,10,14,4.20,29.0
305,tt0473360,Goal II: Living the Dream,2007,"10,000+",24470,2296,1418,1350,3.5,62.0,,18,7,11,18,4.80,39.0
306,tt0099656,Ghosts Can't Do It,1989,250+,433,5,38,16,1.5,12.0,,3,0,3,3,,
307,tt1542852,Carancho,2010,"1,000+",2034,453,173,122,3.6,72.0,,49,43,6,49,6.90,88.0
308,tt0808526,Life During Wartime,2009,"5,000+",6239,501,553,364,3.1,48.0,,105,71,34,105,6.40,68.0
309,tt0398830,Cape of Good Hope,2004,"10,000+",12196,42,25,31,3.5,63.0,,31,21,10,31,6.40,68.0
310,tt0135706,When Trumpets Fade,1998,500+,770,217,74,79,3.7,75.0,,3,2,1,3,,
311,tt0097839,Marquis,1989,500+,573,60,18,23,3.7,77.0,,2,1,1,2,,
312,tt0770752,Fool's Gold,2008,"250,000+",356660,14036,15466,11959,3.2,48.0,,147,16,131,147,3.60,11.0
313,tt0393685,Santa's Slay,2005,"5,000+",7698,505,643,636,3.1,44.0,,5,2,3,5,4.60,40.0
314,tt0314814,Ullae Veliae,1993,0,0,0,0,0,,,,0,0,0,0,,
315,tt0477857,Sehar,2005,100+,177,28,8,12,3.8,78.0,,1,1,0,1,,
316,tt1499249,Lake Placid 3,2010,500+,795,59,317,115,2,16.0,,2,1,1,2,,
317,tt2268617,Puss in Boots: The Three Diablos,2012,100+,117,58,36,16,3.6,62.0,,0,0,0,0,,
318,tt2268617,Puss in Boots: The Three Diablos,2012,100+,117,58,36,16,3.6,62.0,,0,0,0,0,,
319,tt1585984,I Love Luci,2010,0,0,0,0,0,,,,0,0,0,0,,
320,tt2489412,Imaginarium,2012,250+,395,162,92,71,3.6,64.0,,0,0,0,0,,
321,tt2287671,Chemistry,2012,0,0,0,0,0,,,,0,0,0,0,,
322,tt0099263,The Christmas Toy,1986,500+,950,113,35,57,4.1,76.0,,1,1,0,1,,
323,tt0464105,Man Push Cart,2005,"2,500+",2844,335,175,199,3.6,66.0,,55,49,6,55,7.00,89.0
324,tt0279986,Nirnnayam,1995,0,0,0,0,0,,,,0,0,0,0,,
325,tt0115471,Adrenalin: Fear the Rush,1996,"1,000+",1803,17,62,26,2.2,22.0,,5,0,5,5,2.30,0.0
326,tt0823158,Wedding Wars,2006,"1,000+",1566,153,121,118,3.4,56.0,,0,0,0,0,,
327,tt0091310,Just Between Friends,1986,"1,000+",1841,31,28,18,3.3,53.0,,6,2,4,6,4.60,33.0
328,tt0243222,The Doe Boy,2001,500+,635,17,8,16,3.6,68.0,,4,2,2,4,,
329,tt0071598,Harry and Tonto,1974,"1,000+",1781,286,68,130,3.9,81.0,,32,28,4,32,7.30,88.0
330,tt1410068,Uncorked,2009,Fewer than 50,47,9,11,2,3.3,45.0,,0,0,0,0,,
331,tt1424003,The Infidel,2010,"5,000+",8393,489,589,345,3.2,45.0,,27,16,11,27,5.60,59.0
332,tt0252060,The Tony Blair Witch Project,2000,"250,000+",403007,12993,9964,16443,3.2,57.0,,170,146,24,170,7.70,86.0
333,tt1507255,Baana Kaathadi,2010,0,0,0,0,0,,,,0,0,0,0,,
334,tt0107370,Last Light,1993,250+,438,28,14,9,3.7,67.0,,1,1,0,1,,
335,tt0093995,Slugs,1988,"2,500+",3272,100,219,151,2.7,31.0,,8,3,5,8,4.90,38.0
336,tt0056193,Lolita,1962,"25,000+",46147,7223,1385,1864,4,84.0,,45,41,4,45,7.90,91.0
337,tt0246262,Swayam Krushi,1987,0,0,0,0,0,,,,0,0,0,0,,
338,tt0094118,Teen Wolf Too,1987,"5,000+",7991,141,659,338,2.2,18.0,,24,2,22,24,3.60,8.0
339,tt0408777,The Edukators,2004,"10,000+",22738,3883,502,1166,4.1,89.0,,76,53,23,76,6.50,70.0
340,tt0116479,The Hamster Factor and Other Tales of Twelve Monkeys,1996,250+,498,47,8,22,4.1,85.0,,1,1,0,1,,
341,tt1575694,The Hit List,2011,"1,000+",1794,227,806,215,2.1,22.0,,3,2,1,3,,
342,tt0116341,Forest Warrior,1996,500+,893,51,58,38,3.1,47.0,,0,0,0,0,,
343,tt0473553,The Tooth Fairy,2006,"10,000+",10918,129,249,201,2.8,34.0,,7,1,6,7,4.00,14.0
344,tt0210916,Postmen in the Mountains,1999,500+,576,100,7,35,4.3,93.0,,24,23,1,24,7.50,96.0
345,tt0117631,Shine,1996,"25,000+",30934,4152,471,1101,4.2,90.0,,44,40,4,44,7.90,91.0
346,tt1754438,Robotropolis,2011,100+,161,7,69,35,1.6,9.0,,1,0,1,1,,
347,tt0095444,Killer Klowns from Outer Space,1988,"25,000+",43479,2827,1879,2523,3.5,60.0,,26,20,6,26,6.20,77.0
348,tt0256380,Shallow Hal,2001,"250,000+",621319,7317,8905,12023,3.1,45.0,,134,65,69,134,5.50,49.0
349,tt0093870,RoboCop,1987,"100,000+",227112,16014,3025,7582,4.1,84.0,,83,76,7,83,8.10,92.0
350,tt1523483,Kaboom,2010,"5,000+",9571,627,919,395,2.9,40.0,,105,62,43,105,5.80,59.0
351,tt0113028,Far from Home: The Adventures of Yellow Dog,1995,"5,000+",7624,143,122,102,3.4,54.0,,8,5,3,8,6.00,63.0
352,tt0478025,Sa-kwa,2005,250+,255,4,6,1,3.4,40.0,,1,1,0,1,,
353,tt0298856,Evelyn,2002,"5,000+",7921,622,179,298,3.9,78.0,,117,75,42,117,6.10,64.0
354,tt1054112,Imago mortis,2009,"1,000+",1124,10,46,21,2.1,18.0,,0,0,0,0,,
355,tt0488381,Corporate,2006,"1,000+",1024,72,48,47,3.4,60.0,,0,0,0,0,,
356,tt0387059,Bee Season,2005,"10,000+",12440,374,684,452,2.9,35.0,,108,47,61,108,5.50,44.0
357,tt1488579,Mano po 6: A Mother's Love,2009,0,0,0,0,0,,,,0,0,0,0,,
358,tt0113360,The Hunted,1995,Fewer than 50,17,1,1,0,,,,0,0,0,0,,
359,tt1192865,The Boys from Baghdad High,2007,50+,58,4,2,4,3.8,67.0,,3,3,0,3,,
360,tt0384929,The Dying Gaul,2005,"2,500+",3302,163,151,130,3.2,52.0,,69,35,34,69,5.80,51.0
361,tt0819714,The Edge of Love,2008,"50,000+",53744,1121,1475,861,3.1,43.0,,59,22,37,59,5.10,37.0
362,tt2592236,Ozhimuri,2012,Fewer than 50,1,1,0,1,,,,0,0,0,0,,
363,tt1272011,Fortapàsc,2009,100+,119,22,12,5,3.7,65.0,,0,0,0,0,,
364,tt1168662,Wild Combination: A Portrait of Arthur Russell,2008,250+,330,55,12,23,3.8,82.0,,5,5,0,5,7.30,100.0
365,tt0485204,Duet,1994,Fewer than 50,28,2,3,0,3.2,40.0,,0,0,0,0,,
366,tt0118111,Waiting for Guffman,1996,"25,000+",41639,5941,582,2403,4.3,91.0,,55,50,5,55,7.70,91.0
367,tt1428538,Hansel & Gretel: Witch Hunters,2013,"50,000+",98853,22631,19689,4656,3.4,53.0,,147,24,123,147,4.20,16.0
368,tt0420260,Tonî Takitani,2004,"2,500+",4371,637,139,271,4,82.0,,58,51,7,58,7.40,88.0
369,tt0311941,Try Seventeen,2002,"5,000+",7545,245,431,208,2.9,36.0,,7,0,7,7,3.50,0.0
370,tt0382188,Mumbai Matinee,2003,0,0,0,0,0,,,,0,0,0,0,,
371,tt0293832,Hansel & Gretel,2002,"2,500+",2845,79,79,54,3.1,50.0,,5,0,5,5,3.20,0.0
372,tt0278525,Kadathanadan Ambadi,1990,0,0,0,0,0,,,,0,0,0,0,,
373,tt0090110,Sweet Dreams,1985,"5,000+",6503,279,67,136,4,81.0,,21,19,2,21,6.50,90.0
374,tt0114188,Problem Child 3: Junior in Love,1995,"2,500+",2594,45,177,58,2.2,20.0,,0,0,0,0,,
375,tt0438076,Happy Anniversary and Goodbye,1974,Fewer than 50,18,0,3,0,,,,0,0,0,0,,
376,tt0089893,Red Sonja,1985,"25,000+",35298,693,1741,781,2.6,28.0,,28,6,22,28,4.00,21.0
377,tt2011326,Thiru Thiru Thuru Thuru,2009,0,0,0,0,0,,,,0,0,0,0,,
378,tt0089805,Peyton Place: The Next Generation,1985,0,0,0,0,0,,,,0,0,0,0,,
379,tt0113416,The Incredibly True Adventure of Two Girls in Love,1995,"5,000+",6471,392,179,203,3.8,69.0,,19,15,4,19,6.80,79.0
380,tt0810880,Gospel Hill,2008,500+,609,34,61,39,3,36.0,,6,2,4,6,5.10,33.0
381,tt0062793,"Charlie, the Lonesome Cougar",1967,"1,000+",1926,48,30,40,3.7,62.0,,0,0,0,0,,
382,tt0757933,Sukob,2006,500+,967,51,17,54,4,75.0,,0,0,0,0,,
383,tt6779222,Renigunta,2009,0,0,0,0,0,,,,0,0,0,0,,
384,tt0406695,Dawn Anna,2005,500+,513,69,28,42,3.9,71.0,,0,0,0,0,,
385,tt0098454,Ten Little Indians,1989,"1,000+",1109,23,28,18,3,45.0,,2,0,2,2,,
386,tt0066390,Soldier Blue,1970,"1,000+",1669,201,81,85,3.7,71.0,,8,3,5,8,5.00,38.0
387,tt1996310,Lore,2012,"5,000+",9982,1519,476,235,3.8,76.0,,115,108,7,115,7.70,94.0
388,tt0056964,Critic's Choice,1963,100+,168,16,27,21,3.2,37.0,,1,0,1,1,,
389,tt0110665,The Night and the Moment,1994,500+,537,9,9,7,3.2,50.0,,1,0,1,1,,
390,tt0111793,Yeh Dillagi,1994,500+,536,26,28,8,3.2,48.0,,0,0,0,0,,
391,tt0478994,Citizen Duane,2006,100+,177,12,20,17,2.9,38.0,,6,2,4,6,4.30,33.0
392,tt0158780,The Mighty Kong,1998,Fewer than 50,35,7,13,4,2.4,35.0,,1,0,1,1,,
393,tt0107046,Gross Misconduct,1993,Fewer than 50,17,6,11,4,2.9,35.0,,0,0,0,0,,
394,tt0095347,I'll Be Home for Christmas,1988,Fewer than 50,6,1,0,0,,,,1,1,0,1,,
395,tt1728986,Bol Bachchan,2012,"2,500+",4670,142,139,47,3.2,51.0,,7,5,2,7,5.80,71.0
396,tt1896788,My Little Princess,2011,100+,225,34,37,13,3.1,48.0,,0,0,0,0,,
397,tt0092890,Dirty Dancing,1987,"250,000+",1055715,93960,10239,51368,4.4,90.0,,79,57,22,79,6.40,72.0
398,tt1421051,Somewhere,2010,"25,000+",27444,3198,3501,1796,3.1,48.0,,198,139,59,198,6.60,70.0
399,tt1054487,Futurama: Into the Wild Green Yonder,2009,"25,000+",38864,1305,611,840,3.6,68.0,,4,3,1,4,,
400,tt0116320,Fled,1996,"5,000+",8176,120,402,107,2.6,23.0,,33,6,27,33,4.40,18.0
401,tt0959329,Nine Dead,2009,"1,000+",2062,275,673,358,2.6,29.0,,1,0,1,1,,
402,tt1296899,Wake Wood,2009,"1,000+",1779,344,547,291,3,39.0,,26,21,5,26,6.60,81.0
403,tt0439418,7/G Rainbow Colony,2004,Fewer than 50,1,1,0,0,,,,0,0,0,0,,
404,tt1778342,The Fantastic Flying Books of Mr. Morris Lessmore,2011,100+,201,141,18,30,4.2,89.0,,0,0,0,0,,
405,tt1747967,Cassadaga,2011,250+,319,42,127,36,2.6,25.0,,11,2,9,11,4.40,18.0
406,tt0437238,Hulchul,2004,"2,500+",3709,133,59,55,3.7,69.0,,0,0,0,0,,
407,tt0168563,Can't Be Heaven,1999,250+,260,15,9,6,3.7,62.0,,3,1,2,3,,
408,tt1228705,Iron Man 2,2010,"250,000+",483494,91462,37027,26139,3.7,71.0,,305,219,86,305,6.50,72.0
409,tt1041659,My Run,2009,50+,87,15,11,7,3.5,58.0,,0,0,0,0,,
410,tt0268216,Charas,1976,0,0,0,0,0,,,,0,0,0,0,,
411,tt0362427,Avanim,2004,100+,101,6,6,5,3.3,50.0,,1,1,0,1,,
412,tt1116182,Affinity,2008,250+,474,65,93,72,3.2,41.0,,1,0,1,1,,
413,tt0811011,Pirates of Treasure Island,2006,250+,378,3,14,10,1.7,18.0,,0,0,0,0,,
414,tt0399040,Fan chan,2003,Fewer than 50,2,1,1,0,,,,0,0,0,0,,
415,tt0433405,Land of the Blind,2006,"2,500+",2852,217,126,150,3.5,63.0,,18,3,15,18,4.10,17.0
416,tt0240419,La Ciénaga,2001,"1,000+",1490,273,73,81,3.9,79.0,,47,41,6,47,7.00,87.0
417,tt0183678,The Prophecy 3: The Ascent,2000,"5,000+",7052,186,274,151,3.1,40.0,,6,1,5,6,4.40,17.0
418,tt1340095,The Cult of Sincerity,2008,Fewer than 50,11,2,1,0,,,,0,0,0,0,,
419,tt1382687,You Changed My Life,2009,500+,732,59,21,52,3.8,74.0,,0,0,0,0,,
420,tt0243554,When Strangers Appear,2001,500+,688,81,62,44,3.3,57.0,,3,1,2,3,,
421,tt0075862,Code Name: Diamond Head,1977,Fewer than 50,31,0,19,6,1.6,0.0,,0,0,0,0,,
422,tt0195909,Meeting People Is Easy,1998,"2,500+",2516,384,67,162,4.1,85.0,,7,5,2,7,6.50,71.0
423,tt0172089,Aatank Hi Aatank,1995,0,0,0,0,0,,,,0,0,0,0,,
424,tt1753733,Down the Road Again,2011,Fewer than 50,30,7,9,10,3.3,44.0,,3,2,1,3,,
425,tt0067572,Petrolejové lampy,1971,0,0,0,0,0,,,,0,0,0,0,,
426,tt2096562,Once Upon a Time in the East,2011,0,0,0,0,0,,,,0,0,0,0,,
427,tt6450174,Sadhu Miranda,2008,Fewer than 50,38,1,1,0,,,,0,0,0,0,,
428,tt0384696,Winnie the Pooh: Springtime with Roo,2004,"5,000+",8004,117,66,91,3.7,64.0,,3,2,1,3,,
429,tt0079700,The Passage,1979,100+,112,13,19,7,3,41.0,,4,2,2,4,,
430,tt0248695,Belle's Tales of Friendship,1999,Fewer than 50,35,1,2,1,,,,1,1,0,1,,
431,tt0473102,The Perfect Game,2009,"10,000+",22338,782,343,235,3.8,70.0,,43,25,18,43,5.40,58.0
432,tt0449994,Jodhaa Akbar,2008,"10,000+",17570,3189,913,1868,3.9,78.0,,19,15,4,19,7.30,79.0
433,tt0100213,My Blue Heaven,1990,"10,000+",16824,915,631,454,3.5,59.0,,21,15,6,21,5.90,71.0
434,tt0082770,Montenegro,1981,500+,891,74,22,30,3.8,77.0,,16,14,2,16,7.00,88.0
435,tt1276105,Saint John of Las Vegas,2009,"1,000+",1452,108,287,124,2.8,27.0,,53,13,40,53,4.30,25.0
436,tt1299653,Messengers 2: The Scarecrow,2009,"1,000+",1279,74,368,177,2.3,17.0,,2,0,2,2,,
437,tt0186657,The Unstoppable Man,1961,Fewer than 50,35,1,0,0,,,,0,0,0,0,,
438,tt1606267,Lafangey Parindey,2010,250+,411,47,86,45,2.9,35.0,,0,0,0,0,,
439,tt0438204,Mad Cowgirl,2006,500+,934,238,30,32,3.8,89.0,,12,4,8,12,5.80,33.0
440,tt0101628,Critters 4,1992,"10,000+",11470,109,509,204,2.2,18.0,,3,0,3,3,,
441,tt0092974,Ernest Goes to Camp,1987,"25,000+",47181,797,771,903,3.3,51.0,,13,8,5,13,5.40,62.0
442,tt0376215,Strip Search,2004,250+,275,24,28,12,3.2,46.0,,0,0,0,0,,
443,tt0071788,Macon County Line,1974,"1,000+",1331,29,21,20,3.5,58.0,,9,5,4,9,4.90,56.0
444,tt1320270,Juken sentai Gekiranger: Nei-Nei! Hou-Hou! Hong Kong Decisive Battle,2007,0,0,0,0,0,,,,0,0,0,0,,
445,tt0178184,Aan Milo Sajna,1970,Fewer than 50,49,2,0,2,,,,0,0,0,0,,
446,tt0082162,Chashme Buddoor,1981,100+,160,36,3,8,4.1,92.0,,0,0,0,0,,
447,tt1286147,Ghost Machine,2009,250+,442,32,130,67,2.5,20.0,,2,1,1,2,,
448,tt0155500,Antha Ezhu Natkal,1981,0,0,0,0,0,,,,0,0,0,0,,
449,tt0188205,Sonic Impact,1999,100+,169,3,10,2,2.7,23.0,,1,0,1,1,,
450,tt1183908,New Town Killers,2008,500+,544,68,147,98,2.8,32.0,,21,9,12,21,4.60,43.0
451,tt0139151,Inferno,1999,50+,67,1,3,2,,,,0,0,0,0,,
452,tt0271397,Bhoot Bungla,1965,Fewer than 50,6,1,0,1,,,,0,0,0,0,,
453,tt0245997,Khaidi,1983,0,0,0,0,0,,,,0,0,0,0,,
454,tt1874757,The Good Witch's Family,2011,Fewer than 50,32,15,12,0,3.5,56.0,,0,0,0,0,,
455,tt1657507,Colombiana,2011,"100,000+",162117,91288,44471,2990,3.8,67.0,,106,29,77,106,4.90,27.0
456,tt0465142,American Dreamz,2006,"50,000+",96104,1444,3252,2825,2.7,31.0,,183,71,112,183,5.30,39.0
457,tt1890493,Oosaravelli,2011,0,0,0,0,0,,,,0,0,0,0,,
458,tt0345591,Love Comes Softly,2003,"10,000+",13749,1591,237,815,4.3,87.0,,3,2,1,3,,
459,tt0293815,Friday After Next,2002,"100,000+",135134,8160,2729,2667,4,75.0,,72,19,53,72,4.20,26.0
460,tt0100407,Pride and Extreme Prejudice,1989,Fewer than 50,29,1,0,1,,,,0,0,0,0,,
461,tt1658797,Anuvahood,2011,"2,500+",2907,285,304,132,3.1,48.0,,13,2,11,13,3.20,15.0
462,tt0346631,Blood and Bone,2009,"2,500+",3234,1015,408,454,3.7,71.0,,1,1,0,1,,
463,tt0089882,The Rape of Richard Beck,1985,Fewer than 50,29,5,2,2,3.7,71.0,,0,0,0,0,,
464,tt0874333,Why I Wore Lipstick to My Mastectomy,2006,500+,639,89,12,48,4.2,88.0,,0,0,0,0,,
465,tt1410204,Killer Hair,2009,50+,54,2,8,2,2.2,20.0,,0,0,0,0,,
466,tt0405325,Sky High,2005,"100,000+",203594,5267,3941,4993,3.4,57.0,,132,97,35,132,6.50,73.0
467,tt0073915,Xala,1975,"1,000+",1051,115,68,69,3.5,63.0,,8,7,1,8,7.90,88.0
468,tt0405325,Sky High,2005,"100,000+",203594,5267,3941,4993,3.4,57.0,,132,97,35,132,6.50,73.0
469,tt0119925,The Postman,1997,"50,000+",55725,2380,2339,1836,3.2,50.0,,40,4,36,40,4.20,10.0
470,tt0120187,Spoiler,1998,100+,167,6,10,7,2.7,38.0,,0,0,0,0,,
471,tt0300980,Baseraa,1981,0,0,0,0,0,,,,0,0,0,0,,
472,tt0383574,Pirates of the Caribbean: Dead Man's Chest,2006,"250,000+",1847651,160748,62162,160996,3.9,72.0,,229,122,107,229,6.00,53.0
473,tt0810394,Gajendra,2004,0,0,0,0,0,,,,0,0,0,0,,
474,tt0486554,Big Dreams Little Tokyo,2006,Fewer than 50,4,2,0,2,,,,0,0,0,0,,
475,tt0246774,Marumalarchi,1998,0,0,0,0,0,,,,0,0,0,0,,
476,tt0106464,Bopha!,1993,"1,000+",1292,34,18,14,3.6,65.0,,11,9,2,11,7.00,82.0
477,tt0276744,13 Moons,2002,"1,000+",1402,40,49,35,3.1,45.0,,4,2,2,4,,
478,tt1956589,Padikkathavan,2009,0,0,0,0,0,,,,0,0,0,0,,
479,tt0425151,Jimmy and Judy,2006,"1,000+",1525,191,89,127,3.6,68.0,,8,4,4,8,4.40,50.0
480,tt1220888,Henry's Crime,2010,"5,000+",6841,338,1009,300,2.6,25.0,,54,23,31,54,5.00,43.0
481,tt0758784,Starting Out in the Evening,2007,"2,500+",3471,608,261,418,3.6,70.0,,99,87,12,99,7.30,88.0
482,tt0117887,That Thing You Do!,1996,"100,000+",126637,7511,2108,3411,3.9,78.0,,62,58,4,62,7.30,94.0
483,tt0384686,The White Countess,2005,"10,000+",20241,328,336,254,3.3,49.0,,88,44,44,88,5.90,50.0
484,tt1845849,Price Check,2012,"2,500+",3855,200,457,82,2.8,30.0,,21,13,8,21,5.80,62.0
485,tt0104990,Newsies,1992,"50,000+",50639,6731,961,3671,4.3,88.0,,38,15,23,38,5.00,39.0
486,tt0758747,Frozen Stupid,2008,Fewer than 50,18,2,0,2,,,,0,0,0,0,,
487,tt0202559,A Room for Romeo Brass,1999,"5,000+",5762,1056,86,477,4.2,92.0,,25,17,8,25,6.30,68.0
488,tt0328347,Un sabado mas,1988,0,0,0,0,0,,,,0,0,0,0,,
489,tt0158404,Channelling Baby,1999,0,0,0,0,0,,,,0,0,0,0,,
490,tt0783517,Encounter Point,2006,"1,000+",1921,24,1,14,4.5,96.0,,6,6,0,6,7.30,100.0
491,tt0492962,Destricted,2006,"1,000+",1881,76,233,136,2.5,25.0,,12,2,10,12,4.80,17.0
492,tt0080346,The Alien Dead,1980,100+,135,4,30,13,1.6,12.0,,0,0,0,0,,
493,tt0071205,Benaam,1974,50+,53,3,0,0,,,,0,0,0,0,,
494,tt0774755,Offside,2006,"5,000+",5849,691,247,360,3.7,74.0,,84,79,5,84,8.00,94.0
495,tt0910847,Breakfast with Scot,2007,"1,000+",2040,308,170,218,3.6,64.0,,28,15,13,28,5.40,54.0
496,tt0774755,Offside,2006,"5,000+",5849,691,247,360,3.7,74.0,,84,79,5,84,8.00,94.0
497,tt1272051,Space Dogs,2010,100+,113,16,29,15,2.8,36.0,,1,1,0,1,,
498,tt0837806,Starrbooty,2007,250+,316,33,23,26,3.4,59.0,,2,1,1,2,,
499,tt0249336,Aha Naa Pellanta,1987,0,0,0,0,0,,,,0,0,0,0,,
500,tt0960855,Tales from the Dead,2008,Fewer than 50,37,2,4,3,2.9,33.0,,0,0,0,0,,
501,tt0157171,Warlock III: The End of Innocence,1999,"2,500+",3096,26,70,52,2.4,27.0,,3,0,3,3,,
502,tt1300563,The Age of Stupid,2009,"1,000+",1548,359,172,187,3.6,68.0,,15,11,4,15,6.40,73.0
503,tt0079590,Muqaddar Ka Sikandar,1978,500+,779,69,16,22,4,81.0,,0,0,0,0,,
504,tt0315297,Twisted,2004,"10,000+",19139,491,1117,477,2.7,31.0,,135,3,132,135,3.00,2.0
505,tt0850253,Battle in Seattle,2007,"5,000+",9699,962,536,572,3.5,64.0,,61,35,26,61,5.80,57.0
506,tt1202579,Under Our Skin,2008,500+,676,127,17,49,4.3,88.0,,32,26,6,32,6.70,81.0
507,tt0115851,Celtic Pride,1996,"10,000+",10243,309,658,219,2.7,32.0,,25,3,22,25,3.80,12.0
508,tt0204425,Iga-no Kabamaru,1983,0,0,0,0,0,,,,0,0,0,0,,
509,tt0133024,Ishq,1997,Fewer than 50,1,1,0,0,,,,0,0,0,0,,
510,tt0117723,Spy Hard,1996,"25,000+",37943,656,1460,687,2.7,31.0,,42,3,39,42,3.70,7.0
511,tt0285869,Pandora's Box,2002,"1,000+",2476,174,32,71,4.3,85.0,,4,0,4,4,,
512,tt1056026,"30,000 Leagues Under the Sea",2007,250+,478,7,68,29,1.5,9.0,,0,0,0,0,,
513,tt0452668,Pterodactyl,2005,500+,697,44,120,97,2.3,27.0,,1,0,1,1,,
514,tt0106808,Empty Cradle,1993,100+,189,8,6,5,3.4,57.0,,1,1,0,1,,
515,tt0105629,Toys,1992,"50,000+",56934,1213,1902,1254,2.9,39.0,,28,8,20,28,4.50,29.0
516,tt0485922,Keerthi Chakra,2006,0,0,0,0,0,,,,0,0,0,0,,
517,tt1403130,Bodyguards and Assassins,2009,"2,500+",2717,822,342,399,3.6,71.0,,7,4,3,7,9.00,57.0
518,tt0125022,Heartbreakers,2001,"50,000+",71359,2198,2103,1597,3.3,51.0,,125,68,57,125,5.40,54.0
519,tt0145487,Spider-Man,2002,"250,000+",34297354,101591,49006,1692241,3.3,67.0,,249,224,25,249,7.60,90.0
520,tt0080975,Just Tell Me What You Want,1980,100+,231,7,8,6,3.2,47.0,,3,2,1,3,,
521,tt0118125,The Watermelon Woman,1996,500+,901,77,62,44,3.3,55.0,,64,59,5,64,7.20,92.0
522,tt0193187,Genius,1999,250+,444,46,47,16,3.3,49.0,,1,1,0,1,,
523,tt0158863,Private Practices: The Story of a Sex Surrogate,1985,50+,95,14,4,4,3.7,78.0,,0,0,0,0,,
524,tt0145487,Spider-Man,2002,"250,000+",34297354,101591,49006,1692241,3.3,67.0,,249,224,25,249,7.60,90.0
525,tt2236494,Shudra the Rising,2012,Fewer than 50,3,1,1,1,,,,0,0,0,0,,
526,tt0440441,The Graveyard,2006,250+,364,7,55,27,2,11.0,,1,0,1,1,,
527,tt0089907,The Return of the Living Dead,1985,"50,000+",55519,4514,1171,2359,4,79.0,,46,42,4,46,7.30,91.0
528,tt0218922,Original Sin,2001,"50,000+",52978,3138,1976,1593,3.6,61.0,,90,11,79,90,3.50,12.0
529,tt0066109,The Music Lovers,1971,500+,905,106,38,42,3.8,74.0,,17,10,7,17,6.70,59.0
530,tt1512235,Super,2010,0,0,0,0,0,,,,0,0,0,0,,
531,tt0384819,Azumi,2003,"10,000+",16739,1952,469,1055,4,81.0,,32,15,17,32,5.20,47.0
532,tt1630030,"Babe, I Love You",2010,100+,136,17,8,5,3.5,68.0,,0,0,0,0,,
533,tt0057521,Sparrows Can't Sing,1963,Fewer than 50,35,6,5,4,3.2,55.0,,5,4,1,5,8.00,80.0
534,tt1790885,Zero Dark Thirty,2012,"100,000+",197618,53982,13178,7335,4,80.0,,308,281,27,308,8.60,91.0
535,tt1429313,Africa United,2010,"1,000+",1020,181,78,80,3.7,70.0,,17,15,2,17,5.80,88.0
536,tt0068005,You'll Like My Mother,1972,50+,67,19,3,7,4.2,86.0,,2,1,1,2,,
537,tt0867591,Smother,2008,"2,500+",3298,98,397,225,2.4,20.0,,8,3,5,8,4.30,38.0
538,tt0906326,Just Buried,2007,"1,000+",1100,108,195,121,2.9,36.0,,9,3,6,9,4.70,33.0
539,tt0111094,The Scout,1994,"5,000+",7518,125,455,117,2.6,22.0,,26,8,18,26,4.60,31.0
540,tt1656186,Stolen,2012,"10,000+",10242,1245,2448,496,2.8,34.0,,21,4,17,21,4.00,19.0
541,tt1656186,Stolen,2012,"10,000+",10242,1245,2448,496,2.8,34.0,,21,4,17,21,4.00,19.0
542,tt0091869,Rosa Luxemburg,1986,100+,133,22,19,5,3.3,54.0,,5,5,0,5,7.00,100.0
543,tt0332308,Patayin sa sindak si Barbara,1995,0,0,0,0,0,,,,1,1,0,1,,
544,tt1456060,Boy Wonder,2010,"1,000+",1025,441,273,156,3.5,62.0,,7,4,3,7,6.70,57.0
545,tt0896533,Conjurer,2008,250+,353,18,101,50,2.3,15.0,,0,0,0,0,,
546,tt0335266,Lost in Translation,2003,"250,000+",338129,69526,11826,22313,4.1,85.0,,235,224,11,235,8.40,95.0
547,tt1242423,Dear Lemon Lima,2009,500+,582,108,61,30,3.6,64.0,,12,9,3,12,6.90,75.0
548,tt0307639,Virginia's Run,2002,"1,000+",1749,72,20,55,4,78.0,,2,1,1,2,,
549,tt2130256,The Glowing Hours,2012,Fewer than 50,7,4,0,0,,,,0,0,0,0,,
550,tt0335266,Lost in Translation,2003,"250,000+",338129,69526,11826,22313,4.1,85.0,,235,224,11,235,8.40,95.0
551,tt0105897,Zindagi Ek Juaa,1992,50+,91,4,2,1,3.9,67.0,,0,0,0,0,,
552,tt1222663,Woke Up Dead,2009,Fewer than 50,18,1,8,1,2,11.0,,0,0,0,0,,
553,tt0111384,Teesra Kaun?,1994,Fewer than 50,28,0,1,1,,,,0,0,0,0,,
554,tt1289406,Harry Brown,2009,"25,000+",42749,7042,2399,3334,3.7,75.0,,127,80,47,127,6.00,63.0
555,tt0260948,The Heart of the World,2000,250+,460,135,13,38,4.3,91.0,,6,6,0,6,8.30,100.0
556,tt0414713,Amu,2005,"1,000+",1318,95,30,58,3.8,76.0,,22,18,4,22,6.40,82.0
557,tt0345461,The Detonator,2006,"2,500+",3770,91,219,101,2.7,29.0,,2,0,2,2,,
558,tt0116845,The Leading Man,1996,"1,000+",1582,82,31,55,3.9,73.0,,16,11,5,16,6.20,69.0
559,tt1080671,Gowtham SSC,2005,0,0,0,0,0,,,,0,0,0,0,,
560,tt0076601,Raw Deal,1977,0,0,0,0,0,,,,0,0,0,0,,
561,tt0118778,Bring Me the Head of Mavis Davis,1997,250+,369,10,19,9,2.9,36.0,,0,0,0,0,,
562,tt0065441,The Baby Maker,1970,250+,445,6,6,3,3.3,50.0,,2,2,0,2,,
563,tt0339288,Leeches!,2003,"1,000+",1082,17,68,51,1.9,20.0,,0,0,0,0,,
564,tt1334553,The Perfect Host,2010,"5,000+",8164,1274,1042,568,3.3,55.0,,33,15,18,33,5.20,45.0
565,tt1622979,Final Destination 5,2011,"50,000+",52749,9210,8261,3695,3.4,53.0,,136,85,51,136,5.90,63.0
566,tt0113670,A Little Princess,1995,"100,000+",240506,6538,900,5533,4.3,88.0,,37,36,1,37,8.10,97.0
567,tt0070710,Snatched,1973,0,0,0,0,0,,,,0,0,0,0,,
568,tt0783736,I Am the Ripper,2004,100+,153,2,5,1,2.4,29.0,,0,0,0,0,,
569,tt0271259,Welcome to Collinwood,2002,"5,000+",7488,542,439,288,3.4,55.0,,67,37,30,67,5.90,55.0
570,tt1980209,Pain & Gain,2013,"50,000+",85799,15439,17542,3936,3.1,47.0,,203,101,102,203,5.40,50.0
571,tt0120855,Tarzan,1999,"250,000+",370643,12143,4035,7329,3.8,75.0,,106,94,12,106,7.60,89.0
572,tt0097700,L.A. Takedown,1989,Fewer than 50,3,3,0,1,,,,0,0,0,0,,
573,tt1389137,We Bought a Zoo,2011,"100,000+",132162,35621,14272,3798,3.8,71.0,,175,113,62,175,6.20,65.0
574,tt0276033,The Country Bears,2002,"10,000+",10746,280,554,283,2.7,34.0,,85,26,59,85,4.50,31.0
575,tt1054631,House Broken,2010,50+,59,21,29,2,2.8,42.0,,0,0,0,0,,
576,tt0373280,Sucker Free City,2004,250+,399,55,25,18,3.7,69.0,,2,2,0,2,,
577,tt0804540,Taxi 4,2007,"5,000+",6038,499,694,314,3,42.0,,0,0,0,0,,
578,tt1464174,"Big Mommas: Like Father, Like Son",2011,"100,000+",132158,58227,41595,947,3.5,58.0,,62,3,59,62,2.80,5.0
579,tt0109965,Guyver: Dark Hero,1994,"5,000+",6226,257,165,202,3.6,61.0,,3,2,1,3,,
580,tt1292703,Oye Lucky! Lucky Oye!,2008,"1,000+",1874,237,109,150,3.6,69.0,,2,2,0,2,,
581,tt0760311,He Was a Quiet Man,2007,"10,000+",19941,1983,1234,1547,3.4,62.0,,20,16,4,20,6.20,80.0
582,tt0320718,Velaikkaaran,1987,0,0,0,0,0,,,,0,0,0,0,,
583,tt0318433,Maaveeran,1986,0,0,0,0,0,,,,0,0,0,0,,
584,tt1468829,Cherry Tree Lane,2010,500+,660,84,240,129,2.5,26.0,,29,18,11,29,5.90,62.0
585,tt1311060,A.C.O.D.,2013,"5,000+",5723,489,1264,164,2.8,28.0,,58,30,28,58,5.50,52.0
586,tt1582546,Maryada Ramanna,2010,50+,66,19,9,9,3.6,68.0,,0,0,0,0,,
587,tt0303847,The Christmas Season Massacre,2001,Fewer than 50,1,0,1,1,,,,0,0,0,0,,
588,tt0453201,Sachein,2005,250+,306,16,4,5,4.1,80.0,,0,0,0,0,,
589,tt0085387,D.C. Cab,1983,"5,000+",5140,198,177,165,3.3,53.0,,11,2,9,11,4.20,18.0
590,tt0428541,Five Fingers,2006,"2,500+",4003,407,329,266,3.3,55.0,,4,3,1,4,,
591,tt0243759,The American Astronaut,2001,"2,500+",3933,457,56,248,4.3,89.0,,32,20,12,32,5.90,63.0
592,tt0428541,Five Fingers,2006,"2,500+",4003,407,329,266,3.3,55.0,,4,3,1,4,,
593,tt0119491,Lahoo Ke Do Rang,1997,0,0,0,0,0,,,,0,0,0,0,,
594,tt0396690,Kisna: The Warrior Poet,2005,500+,804,64,41,44,3.4,61.0,,2,0,2,2,,
595,tt0237009,August 1,1988,0,0,0,0,0,,,,0,0,0,0,,
596,tt2827516,Chhota Bheem Aur Krishna,2008,Fewer than 50,3,1,2,0,,,,0,0,0,0,,
597,tt0783238,The Dead Girl,2006,"10,000+",12636,1865,1021,1417,3.5,65.0,,82,62,20,82,6.70,76.0
598,tt0421994,Imagine Me & You,2005,"50,000+",71109,3742,1285,1911,3.9,74.0,,98,34,64,98,5.00,35.0
599,tt1031607,Jack Says,2008,50+,79,2,16,9,1.7,11.0,,0,0,0,0,,
600,tt0427000,Blood of a Champion,2005,50+,58,1,4,2,2.4,20.0,,0,0,0,0,,
601,tt1980263,The Adventures of Pureza: Queen of the Riles,2011,0,0,0,0,0,,,,0,0,0,0,,
602,tt0455708,Prudence and the Chief,1970,50+,63,6,8,3,2.9,43.0,,0,0,0,0,,
603,tt0159382,Croupier,1998,"5,000+",9821,1600,425,551,3.8,79.0,,59,56,3,59,7.60,95.0
604,tt0074342,Death Rage,1976,100+,206,7,28,21,2.6,20.0,,0,0,0,0,,
605,tt0437058,Aaj Ka Ravan,2000,0,0,0,0,0,,,,0,0,0,0,,
606,tt0075265,A Star Is Born,1976,"5,000+",6408,450,267,275,3.6,63.0,,42,16,26,42,5.40,38.0
607,tt0166110,Bones,2001,"10,000+",18207,385,584,384,2.9,40.0,,72,19,53,72,4.00,26.0
608,tt0249923,Romantic Comedy 101,2002,Fewer than 50,1,1,0,0,,,,0,0,0,0,,
609,tt0077994,Nightmare in Blood,1977,50+,67,2,7,2,2.6,22.0,,0,0,0,0,,
610,tt0093130,Gunsmoke: Return to Dodge,1987,100+,129,6,6,6,3.1,50.0,,1,1,0,1,,
611,tt0377061,I'll Believe You,2006,250+,374,8,31,20,2.6,21.0,,2,1,1,2,,
612,tt0257106,Scary Movie 2,2001,"250,000+",683149,13463,12322,13826,3.3,52.0,,111,15,96,111,3.50,14.0
613,tt0087817,Nothing Lasts Forever,1984,250+,327,29,27,24,3.4,52.0,,2,1,1,2,,
614,tt0228871,Sleepwalker,2000,250+,327,18,22,5,3.1,45.0,,0,0,0,0,,
615,tt0084861,Vice Squad,1982,"1,000+",1567,102,55,70,3.6,65.0,,5,3,2,5,6.00,60.0
616,tt0079938,Sparsh,1980,0,0,0,0,0,,,,0,0,0,0,,
617,tt0367232,Intern Academy,2004,"1,000+",1448,51,48,35,3.2,52.0,,0,0,0,0,,
618,tt0815178,The Life Before Her Eyes,2007,"5,000+",8748,1149,1088,912,3.2,51.0,,95,23,72,95,4.40,24.0
619,tt0172684,Kuch Kuch Hota Hai,1998,"25,000+",28177,3500,299,1269,4.5,92.0,,5,4,1,5,4.00,80.0
620,tt0323571,Nemesis Game,2003,"1,000+",1190,60,75,44,3.1,44.0,,3,0,3,3,,
621,tt1046894,Black Widow,2008,100+,168,4,18,7,2,18.0,,1,0,1,1,,
622,tt0065125,The Trouble with Girls,1969,"1,000+",2019,43,36,36,3.3,54.0,,0,0,0,0,,
623,tt0076706,Short Eyes,1977,500+,621,50,10,24,4,83.0,,12,11,1,12,6.80,92.0
624,tt0415141,Mama's Boy,2007,"2,500+",4470,361,1033,660,2.7,26.0,,12,1,11,12,3.70,8.0
625,tt0083951,The Flight of Dragons,1982,"5,000+",6652,615,52,329,4.4,92.0,,1,1,0,1,,
626,tt1213864,Love Sick: Secrets of a Sex Addict,2008,100+,239,8,14,5,2.9,36.0,,0,0,0,0,,
627,tt1825833,Kandahar,2010,Fewer than 50,14,3,4,0,3.4,43.0,,0,0,0,0,,
628,tt0871902,Waking Dreams,2007,0,0,0,0,0,,,,0,0,0,0,,
629,tt0186183,The Guilty,2000,250+,377,43,61,19,3,41.0,,5,2,3,5,6.00,40.0
630,tt1462769,The Odd Life of Timothy Green,2012,"100,000+",205117,11481,5592,1736,3.7,67.0,,131,47,84,131,5.20,36.0
631,tt0080322,Aakrosh,1980,0,0,0,0,0,,,,1,1,0,1,,
632,tt0093415,Light of Day,1987,500+,821,87,75,56,3.4,54.0,,15,8,7,15,5.20,53.0
633,tt1286821,More Than a Game,2008,"5,000+",7917,870,140,237,4.1,86.0,,51,36,15,51,6.40,71.0
634,tt0116170,Oedipo alcalde,1996,Fewer than 50,8,3,1,0,,,,0,0,0,0,,
635,tt1657510,Gimme Shelter,2013,"5,000+",8224,1096,632,237,3.6,63.0,,77,21,56,77,4.80,27.0
636,tt0099441,Disturbed,1990,Fewer than 50,22,3,4,0,2.8,43.0,,0,0,0,0,,
637,tt0367478,Wake of Death,2004,"5,000+",5045,199,262,168,3,43.0,,2,1,1,2,,
638,tt0477348,No Country for Old Men,2007,"250,000+",400569,123254,19635,60241,4.2,86.0,,289,270,19,289,8.70,93.0
639,tt0490114,Dolphins,2007,100+,131,1,13,8,1.7,7.0,,0,0,0,0,,
640,tt0758774,Body of Lies,2008,"100,000+",130188,11602,7199,6833,3.4,62.0,,215,119,96,215,5.90,55.0
641,tt0134273,8MM,1999,"100,000+",138047,3644,3358,2753,3.2,52.0,,84,19,65,84,4.20,23.0
642,tt0120169,Soul Food,1997,"10,000+",20842,1429,239,555,4.2,86.0,,45,37,8,45,6.30,82.0
643,tt0411118,Anthony Zimmer,2005,"2,500+",3459,328,190,131,3.5,63.0,,3,2,1,3,,
644,tt0110097,I'll Do Anything,1994,"1,000+",1783,64,90,43,3.1,42.0,,18,12,6,18,5.90,67.0
645,tt0455590,The Last King of Scotland,2006,"250,000+",258193,32512,4094,15337,4,89.0,,183,159,24,183,7.30,87.0
646,tt0095227,God Bless the Child,1988,500+,884,20,10,14,3.8,67.0,,0,0,0,0,,
647,tt1666642,Revenge of the Bridesmaids,2010,"1,000+",2364,425,336,81,3.5,56.0,,0,0,0,0,,
648,tt5235106,Ayiram Poi,1969,0,0,0,0,0,,,,0,0,0,0,,
649,tt1130967,The Graduates,2008,100+,164,5,25,8,2.7,17.0,,0,0,0,0,,
650,tt0086034,Octopussy,1983,"50,000+",61433,2845,3253,1832,3.2,47.0,,50,21,29,50,5.10,42.0
651,tt0844286,The Brothers Bloom,2008,"50,000+",91271,5238,2953,2734,3.5,64.0,,157,107,50,157,6.20,68.0
652,tt0059221,The Ghost and Mr. Chicken,1966,"5,000+",8460,681,228,417,3.9,75.0,,6,4,2,6,6.20,67.0
653,tt0074214,Black Shampoo,1976,"1,000+",1810,21,23,29,3.2,48.0,,0,0,0,0,,
654,tt2130242,Tere Naal Love Ho Gaya,2012,500+,591,59,71,21,3.2,45.0,,1,1,0,1,,
655,tt0076052,Fraternity Row,1977,Fewer than 50,3,1,1,1,,,,2,2,0,2,,
656,tt0374887,Munna Bhai M.B.B.S.,2003,"5,000+",7056,867,56,252,4.4,94.0,,1,1,0,1,,
657,tt0400944,The Witches Hammer,2006,Fewer than 50,43,0,5,2,1.7,0.0,,0,0,0,0,,
658,tt0414040,Gayab,2004,50+,74,1,6,1,2.1,14.0,,0,0,0,0,,
659,tt0258000,Panic Room,2002,"100,000+",236187,11937,6807,6023,3.5,64.0,,189,143,46,189,6.90,76.0
660,tt0258000,Panic Room,2002,"100,000+",236187,11937,6807,6023,3.5,64.0,,189,143,46,189,6.90,76.0
661,tt0271219,Tadpole,2002,"5,000+",5154,310,240,186,3.4,57.0,,108,83,25,108,6.70,77.0
662,tt0276628,Yehi Hai Zindagi,1977,0,0,0,0,0,,,,0,0,0,0,,
663,tt1645141,Sironia,2011,Fewer than 50,17,3,1,1,,,,0,0,0,0,,
664,tt0282223,'Twas the Night,2001,250+,356,28,49,16,2.9,36.0,,4,2,2,4,,
665,tt0878804,The Blind Side,2009,"250,000+",432193,71632,12806,19522,4.1,85.0,,206,135,71,206,6.10,66.0
666,tt0878804,The Blind Side,2009,"250,000+",432193,71632,12806,19522,4.1,85.0,,206,135,71,206,6.10,66.0
667,tt0359266,Fiffty Fiffty,1981,Fewer than 50,32,1,0,0,,,,0,0,0,0,,
668,tt0055998,Freud,1962,500+,647,68,28,25,3.7,70.0,,9,7,2,9,7.60,78.0
669,tt0092221,A Winner Never Quits,1986,Fewer than 50,17,3,2,2,3.7,60.0,,0,0,0,0,,
670,tt0054604,The Adventures of Lucky Pierre,1961,Fewer than 50,1,0,1,0,,,,0,0,0,0,,
671,tt0123371,Aberration,1997,100+,180,18,30,18,2.8,38.0,,3,1,2,3,,
672,tt1431204,Aila Re Oriya Pua,2009,0,0,0,0,0,,,,0,0,0,0,,
673,tt0446272,Amrutham,2004,0,0,0,0,0,,,,0,0,0,0,,
674,tt1055362,American Harmony,2009,100+,172,70,2,18,4.8,97.0,,5,5,0,5,7.20,100.0
675,tt0421562,Aethiree,2004,0,0,0,0,0,,,,0,0,0,0,,
676,tt0327409,Alien Hunter,2003,"1,000+",1271,23,125,52,2.5,16.0,,1,0,1,1,,
677,tt0156323,Screwed,2000,"5,000+",7177,413,441,273,3.2,48.0,,29,3,26,29,3.90,10.0
678,tt0168529,Bombay Boys,1998,Fewer than 50,19,2,2,0,,,,0,0,0,0,,
679,tt0162360,"Happy, Texas",1999,"5,000+",7851,451,363,255,3.3,55.0,,54,44,10,54,6.70,81.0
680,tt0232291,Pati Patni Aur Tawaif,1990,50+,67,1,0,0,,,,0,0,0,0,,
681,tt0301199,Dirty Pretty Things,2002,"25,000+",31459,3863,835,1231,3.9,82.0,,142,134,8,142,7.80,94.0
682,tt0102015,Hearts of Darkness: A Filmmaker's Apocalypse,1991,"5,000+",9425,1741,108,539,4.3,94.0,,27,27,0,27,8.40,100.0
683,tt0287603,Off Season,2001,0,0,0,0,0,,,,0,0,0,0,,
684,tt0080491,Caligula,1979,"10,000+",11302,939,1508,1103,2.8,38.0,,32,7,25,32,3.90,22.0
685,tt0186589,Sugar & Spice,2001,"50,000+",54675,768,1048,877,3,42.0,,75,21,54,75,4.60,28.0
686,tt0165396,My Brother the Pig,1999,250+,294,15,33,18,2.7,31.0,,0,0,0,0,,
687,tt0081318,City of the Living Dead,1980,"10,000+",10434,739,585,538,3.3,56.0,,15,6,9,15,5.80,40.0
688,tt0103244,Where the Spirit Lives,1989,Fewer than 50,9,1,4,0,2.6,20.0,,0,0,0,0,,
689,tt0092711,Business as Usual,1988,Fewer than 50,44,2,1,1,,,,1,0,1,1,,
690,tt0092493,Crocodile Dundee II,1988,"250,000+",264487,1167,1912,2549,3,38.0,,33,3,30,33,3.60,9.0
691,tt6449408,Thenavattu,2008,0,0,0,0,0,,,,0,0,0,0,,
692,tt1568346,The Girl with the Dragon Tattoo,2011,"100,000+",119599,53435,8516,10513,4.1,86.0,,259,224,35,259,7.60,86.0
693,tt1568346,The Girl with the Dragon Tattoo,2011,"100,000+",119599,53435,8516,10513,4.1,86.0,,259,224,35,259,7.60,86.0
694,tt1568346,The Girl with the Dragon Tattoo,2011,"100,000+",119599,53435,8516,10513,4.1,86.0,,259,224,35,259,7.60,86.0
695,tt0106449,Body Bags,1993,"1,000+",2249,198,307,122,3.1,39.0,,12,8,4,12,5.40,67.0
696,tt0097768,Lobster Man from Mars,1989,100+,134,10,14,11,3.1,42.0,,0,0,0,0,,
697,tt0057387,Operation Bikini,1963,Fewer than 50,31,2,2,1,,,,0,0,0,0,,
698,tt0059315,The Intelligence Men,1965,50+,61,12,8,8,3.2,58.0,,0,0,0,0,,
699,tt0112637,Carrington,1995,"2,500+",3490,248,87,80,3.8,74.0,,26,14,12,26,6.20,54.0
700,tt0372122,Adam & Steve,2005,"10,000+",22985,336,264,291,3.4,56.0,,37,20,17,37,5.50,54.0
701,tt0451094,Lady Vengeance,2005,"50,000+",61157,8785,1309,3245,4.1,87.0,,88,67,21,88,7.00,76.0
702,tt0058548,Santa Claus Conquers the Martians,1964,"5,000+",6049,243,645,574,2.2,27.0,,24,6,18,24,3.40,25.0
703,tt0294514,Deathrow,2000,0,0,0,0,0,,,,0,0,0,0,,
704,tt1054588,Flash of Genius,2008,"5,000+",6044,1098,908,954,3.3,55.0,,107,66,41,107,6.00,62.0
705,tt0098436,The Tall Guy,1989,"2,500+",4594,177,93,125,3.6,66.0,,20,17,3,20,6.70,85.0
706,tt0059262,Hercules and the Princess of Troy,1965,100+,127,4,4,5,3.2,50.0,,0,0,0,0,,
707,tt0097971,Night Game,1989,50+,67,2,14,3,2.2,12.0,,7,0,7,7,4.30,0.0
708,tt2323202,Big Fun in the Big Town,1986,0,0,0,0,0,,,,0,0,0,0,,
709,tt0811128,Turn the River,2007,500+,779,92,114,97,3.2,45.0,,21,13,8,21,5.70,62.0
710,tt1128071,Free Style,2008,500+,730,34,30,12,3.3,54.0,,18,6,12,18,4.00,33.0
711,tt0089145,Finnegan Begin Again,1985,Fewer than 50,33,8,2,2,3.9,80.0,,1,1,0,1,,
712,tt1870425,Mac & Devin Go to High School,2012,"1,000+",2328,449,278,89,3.6,62.0,,1,0,1,1,,
713,tt0397314,Arizona sur,2006,0,0,0,0,0,,,,0,0,0,0,,
714,tt0094669,Appointment with Death,1988,100+,217,29,42,15,3,41.0,,3,1,2,3,,
715,tt0114614,Tank Girl,1995,"25,000+",49710,2748,1652,2044,3.6,62.0,,46,20,26,46,5.10,43.0
716,tt0499573,Somebody Help Me,2007,"1,000+",2187,224,139,157,3.6,61.0,,3,1,2,3,,
717,tt0120510,Wide Awake,1998,"2,500+",4659,292,150,178,3.6,66.0,,33,15,18,33,5.10,45.0
718,tt1028532,Hachiko: A Dog's Story,2009,"10,000+",14998,6581,1211,2206,4.1,84.0,,28,18,10,28,5.90,64.0
719,tt0096427,We Think the World of You,1988,100+,102,4,11,3,2.7,27.0,,5,4,1,5,6.40,80.0
720,tt0064405,The Happy Ending,1969,100+,219,10,18,13,3.1,36.0,,9,3,6,9,4.90,33.0
721,tt0163913,You Know My Name,1999,"1,000+",1086,35,8,17,3.9,81.0,,2,1,1,2,,
722,tt0353213,Ayalathe Addeham,1992,Fewer than 50,4,1,1,0,,,,0,0,0,0,,
723,tt0106557,Children of the Corn II: The Final Sacrifice,1992,"10,000+",10731,132,519,193,,,,10,3,7,10,4.10,30.0
724,tt0106557,Children of the Corn II: The Final Sacrifice,1992,"10,000+",10731,132,519,193,,,,10,3,7,10,4.10,30.0
725,tt0120190,Sprung,1997,"1,000+",1322,116,42,46,3.8,73.0,,10,2,8,10,4.20,20.0
726,tt0078400,Tilt,1979,50+,87,8,6,4,3.4,57.0,,1,0,1,1,,
727,tt0123832,Family Plan,1997,"1,000+",1209,9,30,9,2.8,24.0,,0,0,0,0,,
728,tt0076716,Sinbad and the Eye of the Tiger,1977,"5,000+",7354,274,226,193,3.4,55.0,,10,6,4,10,5.40,60.0
729,tt0075439,New Fist of Fury,1976,250+,393,16,57,20,2.7,22.0,,3,1,2,3,,
730,tt6449342,Thiruvannamalai,2008,0,0,0,0,0,,,,0,0,0,0,,
731,tt0402399,The New World,2005,Fewer than 50,36,2,0,0,,,,0,0,0,0,,
732,tt0146165,The Rat Pack,1998,500+,806,114,83,58,3.6,58.0,,30,17,13,30,6.00,57.0
733,tt1682246,Girl Walks Into a Bar,2011,100+,201,24,13,15,3.8,65.0,,4,3,1,4,,
734,tt2375671,The Shift,2013,Fewer than 50,38,13,7,2,4,65.0,,0,0,0,0,,
735,tt0114687,The Toilers and the Wayfarers,1995,250+,370,5,10,5,2.8,33.0,,2,1,1,2,,
736,tt0290563,Devatha,1965,0,0,0,0,0,,,,0,0,0,0,,
737,tt0388288,My First Wedding,2006,"5,000+",6095,52,152,65,2.6,25.0,,7,0,7,7,3.50,0.0
738,tt0955313,Pachaikili Muthucharam,2007,100+,186,9,5,1,3.4,64.0,,0,0,0,0,,
739,tt3196334,Naanu Nanna Kanasu,2010,0,0,0,0,0,,,,0,0,0,0,,
740,tt0194947,Hornblower: The Examination for Lieutenant,1998,500+,702,158,20,41,4.1,89.0,,4,3,1,4,,
741,tt6823074,Deva,1995,0,0,0,0,0,,,,0,0,0,0,,
742,tt0091203,Highlander,1986,"100,000+",135613,9018,2455,5427,3.9,79.0,,38,27,11,38,6.30,71.0
743,tt0094154,Timestalkers,1987,100+,105,14,21,10,2.9,40.0,,0,0,0,0,,
744,tt0084369,"My Body, My Child",1982,0,0,0,0,0,,,,0,0,0,0,,
745,tt0090037,Smooth Talk,1985,"1,000+",1069,57,67,39,3.2,46.0,,30,28,2,30,7.20,93.0
746,tt0113808,Miami Rhapsody,1995,"2,500+",4271,51,141,44,2.6,26.0,,20,9,11,20,6.20,45.0
747,tt0120725,Krippendorf's Tribe,1998,"5,000+",7022,93,295,107,2.5,24.0,,40,7,33,40,4.20,18.0
748,tt1396208,Action Replayy,2010,250+,406,61,156,72,2.5,28.0,,5,0,5,5,4.00,0.0
749,tt1172570,Bronson,2008,"10,000+",17365,7154,2472,2353,3.7,74.0,,81,61,20,81,6.50,75.0
750,tt1319712,Exquisite Corpse,2010,Fewer than 50,4,0,3,0,,,,0,0,0,0,,
751,tt0756673,Labou,2008,100+,220,22,19,19,3.3,54.0,,1,1,0,1,,
752,tt1284028,Love the Beast,2009,500+,736,209,80,106,3.8,72.0,,23,14,9,23,5.40,61.0
753,tt2386342,Anjaneya,2003,0,0,0,0,0,,,,0,0,0,0,,
754,tt0206584,Battle Arena Toshinden,1994,100+,118,3,10,2,2.7,23.0,,1,1,0,1,,
755,tt0070656,Scream Blacula Scream,1973,"1,000+",2159,76,132,108,2.9,37.0,,7,2,5,7,4.90,29.0
756,tt0061610,"Easy Come, Easy Go",1967,"2,500+",4253,33,58,52,3,36.0,,7,3,4,7,4.50,43.0
757,tt0090005,Shadowlands,1986,100+,220,33,3,9,4.2,92.0,,0,0,0,0,,
758,tt0251972,Sainyam,1994,0,0,0,0,0,,,,0,0,0,0,,
759,tt0929629,Stargate: Continuum,2008,"25,000+",27996,1798,482,868,3.9,79.0,,1,1,0,1,,
760,tt1452626,Hahaha,2010,100+,145,35,34,11,3.1,50.0,,7,5,2,7,5.00,71.0
761,tt0090994,Echo Park,1985,500+,551,11,17,8,3.1,39.0,,9,7,2,9,6.60,78.0
762,tt1507355,The Butterfly Circus,2009,Fewer than 50,2,1,1,1,,,,0,0,0,0,,
763,tt2877914,18 Vayasu,2012,0,0,0,0,0,,,,0,0,0,0,,
764,tt1984153,Excision,2012,"1,000+",2380,908,584,330,3.4,61.0,,28,24,4,28,6.80,86.0
765,tt1512888,Aayirathil Oruvan,2010,Fewer than 50,2,2,0,0,,,,0,0,0,0,,
766,tt0090685,Back to School,1986,"25,000+",33206,1983,922,870,3.7,68.0,,38,33,5,38,6.90,87.0
767,tt1512888,Aayirathil Oruvan,2010,Fewer than 50,2,2,0,0,,,,0,0,0,0,,
768,tt0109424,Chungking Express,1994,"25,000+",39938,8450,605,2262,4.4,93.0,,68,60,8,68,7.90,88.0
769,tt3759954,Alai,2003,0,0,0,0,0,,,,0,0,0,0,,
770,tt0117878,Tere Mere Sapne,1996,0,0,0,0,0,,,,0,0,0,0,,
771,tt0158493,Belly,1998,"25,000+",34313,3838,560,1213,4.3,87.0,,22,5,17,22,3.70,23.0
772,tt0377100,Out of Reach,2004,"2,500+",2623,44,164,72,2.3,21.0,,0,0,0,0,,
773,tt0395169,Hotel Rwanda,2004,"100,000+",241649,39922,2583,12296,4.3,94.0,,191,173,18,191,8.00,91.0
774,tt1305656,Baler,2008,"1,000+",1196,22,19,24,3.3,54.0,,0,0,0,0,,
775,tt1024839,De Taali,2008,250+,339,46,43,32,3.2,52.0,,1,0,1,1,,
776,tt0371922,Saaya,2003,250+,394,29,18,10,3.5,62.0,,0,0,0,0,,
777,tt0062288,Something Weird,1967,250+,289,20,27,17,3,43.0,,1,0,1,1,,
778,tt0258280,Vazhve Mayam,1970,0,0,0,0,0,,,,0,0,0,0,,
779,tt0109778,Father and Scout,1994,100+,102,4,16,5,2.3,21.0,,0,0,0,0,,
780,tt2042633,Pranayam,2011,Fewer than 50,18,6,3,0,3.7,67.0,,1,1,0,1,,
781,tt0117799,Sweet Angel Mine,1996,0,0,0,0,0,,,,0,0,0,0,,
782,tt0215911,Koshish,1972,50+,81,14,2,4,4.2,88.0,,0,0,0,0,,
783,tt0829193,Honeydripper,2007,"1,000+",1797,204,152,184,3.4,57.0,,86,59,27,86,6.50,69.0
784,tt0452968,Athu Oru Kanaa Kaalam,2005,Fewer than 50,36,0,2,0,,,,0,0,0,0,,
785,tt0119772,The Nephew,1998,"1,000+",1142,52,27,21,3.8,66.0,,1,0,1,1,,
786,tt0971209,A Perfect Getaway,2009,"100,000+",161533,6062,5535,4431,3.3,52.0,,138,85,53,138,5.90,62.0
787,tt1046163,My Best Friend's Girl,2008,"50,000+",86633,3936,4586,3332,3.1,46.0,,59,8,51,59,3.60,14.0
788,tt0851530,The Lodger,2009,"5,000+",6631,147,339,180,2.8,30.0,,24,5,19,24,3.40,21.0
789,tt0096953,Bloodhounds of Broadway,1989,500+,520,14,48,22,2.7,23.0,,1,0,1,1,,
790,tt0404032,The Exorcism of Emily Rose,2005,"250,000+",376733,10052,6764,12421,3.4,60.0,,157,70,87,157,5.50,45.0
791,tt0331370,Whisky,2004,"2,500+",2820,356,122,121,3.7,74.0,,16,16,0,16,7.90,100.0
792,tt1401622,Premer Kahini,2008,0,0,0,0,0,,,,0,0,0,0,,
793,tt1185834,Star Wars: The Clone Wars,2008,"100,000+",164464,6127,9205,6567,3,40.0,,172,32,140,172,4.20,19.0
794,tt0375791,Gundaraj,1995,0,0,0,0,0,,,,0,0,0,0,,
795,tt0186910,Can of Worms,1999,100+,196,24,36,17,3,40.0,,1,1,0,1,,
796,tt0795505,Undead or Alive: A Zombedy,2007,"1,000+",1213,96,222,204,2.6,30.0,,4,1,3,4,,
797,tt0103956,Child's Play 3,1991,"50,000+",83381,1971,3043,1619,3.1,39.0,,16,3,13,16,4.20,19.0
798,tt0057812,7 Faces of Dr. Lao,1964,"2,500+",3773,352,99,179,3.9,78.0,,7,6,1,7,6.70,86.0
799,tt0115819,Cannibal! The Musical,1993,"10,000+",21040,2540,568,1512,4,82.0,,19,12,7,19,5.20,63.0
800,tt1194238,Polytechnique,2009,"1,000+",2123,625,196,214,3.7,76.0,,17,15,2,17,7.10,88.0
801,tt0829432,"Me & You, Us, Forever",2008,250+,452,16,27,20,2.7,37.0,,1,0,1,1,,
802,tt1555991,"Nobody, Nobody But Juan",2009,Fewer than 50,16,2,3,2,2.4,40.0,,0,0,0,0,,
803,tt1042547,"Sakal, sakali, saklolo",2007,250+,253,11,5,7,3.8,69.0,,0,0,0,0,,
804,tt0055453,The Sins of Rachel Cade,1961,Fewer than 50,22,1,6,7,2.5,14.0,,1,0,1,1,,
805,tt1645170,The Dictator,2012,"100,000+",167880,16882,21067,5641,3.1,44.0,,224,126,98,224,5.90,56.0
806,tt2008006,A Simple Life,2011,"1,000+",1332,528,88,113,4,86.0,,31,29,2,31,7.70,94.0
807,tt0164181,Stir of Echoes,1999,"50,000+",65160,4981,2172,2237,3.6,70.0,,108,73,35,108,6.40,68.0
808,tt1410051,Retreat,2011,"2,500+",3092,471,700,265,3,40.0,,13,8,5,13,5.50,62.0
809,tt0322936,Kehtaa Hai Dil Baar Baar,2002,Fewer than 50,4,0,3,0,,,,1,0,1,1,,
810,tt0248317,Ponthan Mada,1994,0,0,0,0,0,,,,0,0,0,0,,
811,tt0126810,Bedrooms and Hallways,1998,"1,000+",1919,156,79,87,3.7,66.0,,13,9,4,13,6.30,69.0
812,tt0256103,Intimacy,2001,"2,500+",4498,357,259,112,3.4,58.0,,70,46,24,70,6.30,66.0
813,tt0359013,Blade: Trinity,2004,"250,000+",438429,19527,13933,14512,3.4,58.0,,167,40,127,167,4.40,24.0
814,tt1125849,The Wrestler,2008,"100,000+",140835,33483,4479,15236,4.1,88.0,,231,227,4,231,8.40,98.0
815,tt0372401,Sex Sells: The Making of 'Touché',2005,Fewer than 50,32,1,6,3,2.3,14.0,,1,1,0,1,,
816,tt0061052,The Swinger,1966,50+,73,7,5,2,3.3,58.0,,2,0,2,2,,
817,tt0072756,Cage Without a Key,1975,0,0,0,0,0,,,,1,0,1,1,,
818,tt0119094,Face/Off,1997,"250,000+",450773,35530,7666,15965,4,82.0,,93,86,7,93,7.80,92.0
819,tt1522133,Angshumaner Chhobi,2009,Fewer than 50,8,4,0,1,,,,0,0,0,0,,
820,tt0285492,Cube 2: Hypercube,2002,"25,000+",34130,1459,2699,1332,2.8,35.0,,11,5,6,11,5.20,45.0
821,tt2268746,Oh Schucks ..... It's Schuster!,1989,0,0,0,0,0,,,,0,0,0,0,,
822,tt0131369,EDtv,1999,"50,000+",61145,1227,2886,993,2.9,30.0,,48,30,18,48,6.20,63.0
823,tt1307897,Turn the Beat Around,2010,100+,213,24,36,14,3,40.0,,1,1,0,1,,
824,tt0064963,The Set,1970,0,0,0,0,0,,,,0,0,0,0,,
825,tt1838630,Punyam Aham,2010,0,0,0,0,0,,,,0,0,0,0,,
826,tt0452643,Love and Other Disasters,2006,"5,000+",6918,1316,1008,785,3.4,57.0,,5,1,4,5,3.50,20.0
827,tt1740033,The Book of Masters,2009,0,0,0,0,0,,,,0,0,0,0,,
828,tt0134618,"Mystery, Alaska",1999,"25,000+",32255,1655,848,760,3.6,66.0,,82,30,52,82,4.90,37.0
829,tt2179888,Ndoto Za Elibidi,2010,0,0,0,0,0,,,,0,0,0,0,,
830,tt0055811,The Broken Land,1962,100+,125,2,5,5,2.7,29.0,,0,0,0,0,,
831,tt1300159,Growth,2010,500+,618,316,121,49,4.1,72.0,,0,0,0,0,,
832,tt1397492,Well Done Abba!,2009,250+,264,67,34,44,3.5,66.0,,1,1,0,1,,
833,tt0825279,20 Years After,2008,250+,405,11,93,48,1.8,11.0,,1,0,1,1,,
834,tt0225029,Aflatoon,1997,50+,88,2,8,1,2.5,20.0,,0,0,0,0,,
835,tt1720258,The Darkness Within,2009,0,0,0,0,0,,,,0,0,0,0,,
836,tt0119225,Gridlock'd,1997,"5,000+",9847,932,248,317,3.9,79.0,,34,30,4,34,6.70,88.0
837,tt0100791,To Sleep with Anger,1990,500+,555,73,19,26,3.9,79.0,,35,31,4,35,7.30,89.0
838,tt0093067,Gaby: A True Story,1987,250+,268,13,7,10,3.7,65.0,,2,2,0,2,,
839,tt0374848,Main Madhuri Dixit Banna Chahti Hoon!,2003,500+,540,18,12,11,3.3,60.0,,1,0,1,1,,
840,tt0096223,Tapeheads,1988,"2,500+",4483,194,228,145,3.2,46.0,,15,9,6,15,5.60,60.0
841,tt1418749,Takkar,2008,0,0,0,0,0,,,,0,0,0,0,,
842,tt0353014,Wonderful Days,2003,"5,000+",5360,481,219,259,3.7,69.0,,43,23,20,43,5.60,53.0
843,tt1334573,Moby Dick,2011,Fewer than 50,36,1,1,0,,,,1,0,1,1,,
844,tt0373400,"Triads, Yardies & Onion Bhajees!",2003,0,0,0,0,0,,,,0,0,0,0,,
845,tt0485851,The Air I Breathe,2007,"10,000+",22847,2764,1773,2008,3.4,61.0,,40,4,36,40,3.80,10.0
846,tt0083590,The Atomic Cafe,1982,"2,500+",2522,409,69,159,4.1,86.0,,28,26,2,28,7.80,93.0
847,tt0370242,32A,2007,100+,190,20,22,22,3.3,48.0,,0,0,0,0,,
848,tt0120391,TwentyFourSeven,1997,500+,980,206,47,91,3.9,81.0,,20,7,13,20,5.70,35.0
849,tt0829424,Evil Bong,2006,"2,500+",2941,163,266,236,2.8,38.0,,1,0,1,1,,
850,tt0260107,Jeevan Dhaara,1982,0,0,0,0,0,,,,0,0,0,0,,
851,tt0102985,Stop at Nothing,1991,0,0,0,0,0,,,,0,0,0,0,,
852,tt0155487,Amaram,1991,0,0,0,0,0,,,,0,0,0,0,,
853,tt0338139,Iron Jawed Angels,2004,"5,000+",6406,1138,145,480,4.3,89.0,,9,5,4,9,6.80,56.0
854,tt1646981,The Off Hours,2011,50+,78,11,20,7,3.2,35.0,,1,1,0,1,,
855,tt0192671,That Championship Season,1999,Fewer than 50,1,0,1,0,,,,0,0,0,0,,
856,tt0270288,Confessions of a Dangerous Mind,2002,"50,000+",58921,6067,2014,1931,3.7,75.0,,164,131,33,164,7.20,80.0
857,tt1629705,Blackthorn,2011,"1,000+",2267,482,303,164,3.5,61.0,,76,57,19,76,6.40,75.0
858,tt1539491,Bale Pandiya,2010,Fewer than 50,9,0,1,1,,,,0,0,0,0,,
859,tt1056467,Dying God,2008,100+,184,2,34,17,1.4,6.0,,0,0,0,0,,
860,tt0848587,Halloween Night,2006,500+,931,21,113,66,2.1,16.0,,1,0,1,1,,
861,tt0059771,A Swingin' Summer,1965,Fewer than 50,41,1,4,6,2.3,20.0,,0,0,0,0,,
862,tt0810784,Bright Star,2009,"10,000+",11429,2651,1217,1422,3.6,68.0,,179,148,31,179,7.30,83.0
863,tt1601813,Brahmanandam Drama Company,2008,0,0,0,0,0,,,,0,0,0,0,,
864,tt0102690,Popcorn,1991,"1,000+",2376,118,169,117,3,41.0,,21,8,13,21,5.70,38.0
865,tt0841032,The Perfect Holiday,2007,"100,000+",159652,1087,995,1005,3.3,52.0,,59,11,48,59,3.90,19.0
866,tt0210943,Relative Values,2000,"1,000+",1682,103,59,53,3.5,64.0,,5,1,4,5,5.60,20.0
867,tt0175564,Dharkan,1972,Fewer than 50,28,0,1,1,,,,0,0,0,0,,
868,tt0282659,King of Texas,2002,"1,000+",1448,14,19,23,3.2,42.0,,6,3,3,6,6.10,50.0
869,tt1278153,War Wolves,2009,100+,237,5,55,27,1.6,8.0,,0,0,0,0,,
870,tt0368969,Shubho Mahurat,2003,Fewer than 50,1,1,0,0,,,,0,0,0,0,,
871,tt0377321,Aasai,1995,Fewer than 50,44,6,1,1,3.9,86.0,,0,0,0,0,,
872,tt0094962,The Dead Next Door,1989,"2,500+",2867,143,159,164,3.1,47.0,,1,1,0,1,,
873,tt1478325,Malibu Shark Attack,2009,250+,278,25,113,47,2,18.0,,2,0,2,2,,
874,tt0760233,Caillou's Holiday Movie,2003,Fewer than 50,40,9,8,6,2.7,53.0,,0,0,0,0,,
875,tt0106725,Dil Tera Aashiq,1993,250+,436,9,13,2,3.3,41.0,,0,0,0,0,,
876,tt0065528,Catch-22,1970,"10,000+",10586,1475,474,663,3.8,76.0,,32,26,6,32,7.30,81.0
877,tt0080752,Forbidden Zone,1980,"5,000+",6137,819,189,499,4.1,81.0,,12,10,2,12,6.60,83.0
878,tt4323928,Aattanayagann,2010,0,0,0,0,0,,,,0,0,0,0,,
879,tt0063655,Submarine X-1,1968,500+,933,3,14,6,2.8,18.0,,1,0,1,1,,
880,tt1042499,Filth and Wisdom,2008,"1,000+",1932,158,216,141,3,42.0,,62,15,47,62,4.10,24.0
881,tt1331126,Victoria Day,2009,100+,122,10,9,9,3.4,53.0,,3,2,1,3,,
882,tt0272018,Call Me Claus,2001,"2,500+",4168,84,112,63,3.1,43.0,,4,1,3,4,,
883,tt0093978,A Chinese Ghost Story,1987,"5,000+",6389,779,128,269,4.1,86.0,,10,7,3,10,7.80,70.0
884,tt0217904,Zombie! vs. Mardi Gras,1999,Fewer than 50,21,1,1,1,,,,10,2,8,10,3.60,20.0
885,tt1586261,Paranormal Entity,2009,"1,000+",2005,217,550,264,2.5,28.0,,0,0,0,0,,
886,tt0289845,Aks,2001,0,0,0,0,0,,,,0,0,0,0,,
887,tt0380215,Bereft,2004,100+,235,7,17,10,2.9,29.0,,1,0,1,1,,
888,tt1073498,Meet the Spartans,2008,"100,000+",245062,5727,16824,11370,2.2,25.0,,49,1,48,49,2.40,2.0
889,tt0057985,The Curse of the Living Corpse,1964,100+,143,5,20,12,2.7,20.0,,1,0,1,1,,
890,tt0407814,Full Grown Men,2006,250+,368,10,30,14,2.6,25.0,,25,11,14,25,5.30,44.0
891,tt0108447,The Unnamable II: The Statement of Randolph Carter,1992,500+,819,16,36,19,2.8,31.0,,2,0,2,2,,
892,tt0103982,Cold Heaven,1991,100+,100,4,15,3,2.4,21.0,,5,3,2,5,5.50,60.0
893,tt0382806,Look Both Ways,2005,"5,000+",6358,403,134,229,3.7,75.0,,58,44,14,58,6.50,76.0
894,tt0426581,Spookley the Square Pumpkin,2005,500+,843,26,17,16,3.2,60.0,,0,0,0,0,,
895,tt0227173,"Olive, the Other Reindeer",1999,"5,000+",6190,154,89,96,3.6,63.0,,5,3,2,5,6.00,60.0
896,tt1124388,Play the Game,2009,"10,000+",22805,277,176,105,3.5,61.0,,32,9,23,32,4.60,28.0
897,tt0444672,Moving McAllister,2007,"2,500+",3104,208,508,331,2.7,29.0,,10,1,9,10,3.40,10.0
898,tt0402336,The Last Ride,2004,"2,500+",2889,78,54,56,3.4,59.0,,0,0,0,0,,
899,tt0107076,Hard Target,1993,"25,000+",35928,1376,1422,1013,3.3,49.0,,40,24,16,40,5.50,60.0
900,tt0341569,Self Medicated,2005,500+,815,44,41,36,3.2,52.0,,38,14,24,38,5.10,37.0
901,tt0341563,Sawan Bhadon,1970,0,0,0,0,0,,,,0,0,0,0,,
902,tt0068284,Blacula,1972,"5,000+",5809,253,331,290,3.1,43.0,,28,13,15,28,5.30,46.0
903,tt1730133,Qualquer Gato Vira-Lata,2011,0,0,0,0,0,,,,0,0,0,0,,
904,tt0216292,Too Much Sex,1999,0,0,0,0,0,,,,0,0,0,0,,
905,tt1192628,Rango,2011,"100,000+",120761,32010,13967,9122,3.6,70.0,,228,200,28,228,7.60,88.0
906,tt0204137,Animal Factory,2000,"5,000+",9415,532,374,228,3.4,59.0,,35,29,6,35,6.90,83.0
907,tt1361504,50 Years! Of Love?,2008,Fewer than 50,46,3,1,0,,,,0,0,0,0,,
908,tt0431405,Sleeping Dogs Lie,2005,"2,500+",4942,293,432,376,2.9,41.0,,53,35,18,53,6.20,66.0
909,tt0431405,Sleeping Dogs Lie,2005,"2,500+",4942,293,432,376,2.9,41.0,,53,35,18,53,6.20,66.0
910,tt0068281,Black Gunn,1972,100+,105,10,22,14,2.9,31.0,,2,0,2,2,,
911,tt0156923,Raat Aur Din,1967,0,0,0,0,0,,,,0,0,0,0,,
912,tt0087837,Old Enough,1984,Fewer than 50,42,4,8,1,2.8,33.0,,2,2,0,2,,
913,tt0756703,Feel the Noise,2007,"100,000+",109108,783,1064,782,2.9,42.0,,27,3,24,27,4.00,11.0
914,tt0328395,Seerivarum Kaalai,2001,0,0,0,0,0,,,,0,0,0,0,,
915,tt0313737,Two Weeks Notice,2002,"250,000+",274094,8218,5699,5360,3.5,59.0,,124,52,72,124,5.30,42.0
916,tt0083844,Don't Go to Sleep,1982,250+,370,52,25,36,3.8,68.0,,0,0,0,0,,
917,tt0386588,Hitch,2005,"250,000+",32624083,75409,45381,1109726,3.4,62.0,,188,129,59,188,6.30,69.0
918,tt0100095,Maine Pyar Kiya,1989,Fewer than 50,2,2,0,0,,,,1,1,0,1,,
919,tt0064193,Crossplot,1969,250+,336,5,26,10,2.8,16.0,,0,0,0,0,,
920,tt0158011,Trance,1998,0,0,0,0,0,,,,0,0,0,0,,
921,tt0262801,Swarg Narak,1978,0,0,0,0,0,,,,0,0,0,0,,
922,tt0114594,Swimming with Sharks,1994,"10,000+",11104,1787,471,722,3.8,79.0,,38,29,9,38,6.50,76.0
923,tt0880571,Monks - The Transatlantic Feedback,2006,100+,173,15,6,8,3.4,71.0,,8,8,0,8,6.90,100.0
924,tt1482393,Beverly Hills Chihuahua 2,2011,"1,000+",1108,246,252,100,3.2,49.0,,3,2,1,3,,
925,tt0091818,Radioactive Dreams,1984,100+,247,22,27,19,3,45.0,,0,0,0,0,,
926,tt0270393,Groom Lake,2002,Fewer than 50,38,1,5,2,1.8,17.0,,0,0,0,0,,
927,tt0091123,GoBots: Battle of the Rock Lords,1986,50+,80,10,9,3,3,53.0,,5,1,4,5,3.00,20.0
928,tt0068315,Brian's Song,1971,"5,000+",9129,734,167,364,4.1,82.0,,12,11,1,12,7.70,92.0
929,tt1069238,Departures,2008,"50,000+",52006,5060,459,1981,4.2,92.0,,108,86,22,108,7.10,80.0
930,tt0077294,Capricorn One,1977,"5,000+",8072,587,422,388,3.4,58.0,,23,15,8,23,6.20,65.0
931,tt0100201,Mr. Destiny,1990,"5,000+",9112,341,273,169,3.5,56.0,,17,6,11,17,4.30,35.0
932,tt0475380,Scenes of a Sexual Nature,2006,"2,500+",4855,439,461,410,3.1,49.0,,6,3,3,6,5.00,50.0
933,tt0199626,In the Cut,2003,"10,000+",12875,627,1212,579,2.8,34.0,,177,60,117,177,4.90,34.0
934,tt0886531,Shades of Ray,2008,500+,544,178,53,54,3.7,77.0,,0,0,0,0,,
935,tt0185014,Wonder Boys,2000,"25,000+",40336,4608,954,1558,4,83.0,,127,103,24,127,7.20,81.0
936,tt0154749,Kudrat,1981,Fewer than 50,26,1,0,0,,,,0,0,0,0,,
937,tt0402901,The Cave,2005,"50,000+",93658,1120,2908,2101,2.5,28.0,,112,13,99,112,3.70,12.0
938,tt0192198,Kandan Karunai,1967,0,0,0,0,0,,,,0,0,0,0,,
939,tt1849718,Agneepath,2012,"1,000+",2123,454,281,187,3.5,62.0,,13,12,1,13,7.00,92.0
940,tt0267548,Haseena Maan Jaayegi,1999,250+,423,32,22,11,3.4,59.0,,0,0,0,0,,
941,tt0160399,Impostor,2001,"5,000+",7398,411,587,276,3,41.0,,97,24,73,97,4.00,25.0
942,tt0265208,The Girl Next Door,2004,"5,000+",7116,1432,915,1111,3.4,61.0,,15,10,5,15,6.10,67.0
943,tt0265208,The Girl Next Door,2004,"5,000+",7116,1432,915,1111,3.4,61.0,,15,10,5,15,6.10,67.0
944,tt0265208,The Girl Next Door,2004,"5,000+",7116,1432,915,1111,3.4,61.0,,15,10,5,15,6.10,67.0
945,tt0395565,Gracie's Choice,2004,"1,000+",1983,364,58,133,4.2,86.0,,0,0,0,0,,
946,tt1555064,Country Strong,2010,"25,000+",33018,3422,3007,1478,3.4,53.0,,134,29,105,134,4.60,22.0
947,tt0255097,Deewane,2000,50+,89,2,5,2,2.2,29.0,,0,0,0,0,,
948,tt0963794,The Ruins,2008,"250,000+",530616,3888,9035,7688,2.7,30.0,,98,49,49,98,5.50,50.0
949,tt0079444,The Last of the Knucklemen,1979,0,0,0,0,0,,,,0,0,0,0,,
950,tt0106220,Addams Family Values,1993,"250,000+",386998,7528,4373,5761,3.6,63.0,,114,85,29,114,6.70,75.0
951,tt0445922,Across the Universe,2007,"250,000+",333743,61140,13350,37175,4.1,82.0,,178,94,84,178,5.90,53.0
952,tt0106600,Confessions of a Sorority Girl,1994,"1,000+",1646,12,25,13,2.8,32.0,,0,0,0,0,,
953,tt0306685,Cradle 2 the Grave,2003,"50,000+",81080,2542,2378,1442,3.3,52.0,,125,33,92,125,4.60,26.0
954,tt1298643,Closed for the Season,2010,Fewer than 50,23,1,16,7,1.4,6.0,,0,0,0,0,,
955,tt0166195,Foolish,1999,"1,000+",1096,75,38,30,3.8,66.0,,16,0,16,16,3.20,0.0
956,tt0117119,My Fellow Americans,1996,"5,000+",8796,812,456,396,3.6,64.0,,60,28,32,60,5.30,47.0
957,tt1397280,Taken 2,2012,"100,000+",212596,28624,25986,6796,3.4,52.0,,173,38,135,173,4.20,22.0
958,tt0064451,A Touch of Zen,1971,"1,000+",1378,276,55,104,4,83.0,,38,37,1,38,8.30,97.0
959,tt0494953,Gunahon Ka Devta,1990,0,0,0,0,0,,,,0,0,0,0,,
960,tt0115994,Curdled,1996,"1,000+",1482,140,103,73,3.4,58.0,,11,1,10,11,4.40,9.0
961,tt0058691,The Truth About Spring,1965,100+,176,8,12,6,3.2,40.0,,0,0,0,0,,
962,tt0081499,The Young Master,1980,"5,000+",7340,329,86,147,3.9,79.0,,3,3,0,3,,
963,tt1873591,Oru Naal Varum,2010,Fewer than 50,5,2,1,0,,,,0,0,0,0,,
964,tt1210071,The Janky Promoters,2009,"1,000+",2259,82,107,41,3,43.0,,4,1,3,4,,
965,tt0155938,Palangal,1981,0,0,0,0,0,,,,0,0,0,0,,
966,tt0106400,The Beverly Hillbillies,1993,"50,000+",53469,492,1031,786,2.8,32.0,,33,8,25,33,3.50,24.0
967,tt0072937,Encounter with the Unknown,1972,Fewer than 50,7,1,2,2,,,,1,1,0,1,,
968,tt0107103,Hercules Returns,1993,"1,000+",1031,248,13,153,4.5,95.0,,0,0,0,0,,
969,tt0110089,I Don't Hate Las Vegas Anymore,1994,Fewer than 50,44,2,0,1,,,,1,1,0,1,,
970,tt0119574,Love and Death on Long Island,1997,"1,000+",1699,109,82,63,3.4,57.0,,39,34,5,39,7.90,87.0
971,tt1340418,An American Girl: Chrissa Stands Strong,2009,250+,412,61,42,38,3.6,59.0,,0,0,0,0,,
972,tt0198386,The Crew,2000,"2,500+",4130,82,162,73,2.8,34.0,,85,17,68,85,3.80,20.0
973,tt0174903,Marked for Death,1987,"10,000+",19573,714,719,486,3.3,50.0,,11,3,8,11,4.00,27.0
974,tt0155227,Swarag Se Sunder,1986,0,0,0,0,0,,,,0,0,0,0,,
975,tt1331307,Dread,2009,"2,500+",2962,409,508,304,3,45.0,,1,1,0,1,,
976,tt0077681,The Hills Have Eyes,1977,"50,000+",52085,1778,1527,1397,3.3,54.0,,27,18,9,27,6.20,67.0
977,tt0099939,King of New York,1990,"10,000+",21282,2633,785,1049,3.9,77.0,,30,21,9,30,6.10,70.0
978,tt0968261,Cedie,1996,0,0,0,0,0,,,,0,0,0,0,,
979,tt0481513,Dr. Dolittle 3,2006,"50,000+",84523,511,632,705,3,45.0,,3,1,2,3,,
980,tt0150377,Double Jeopardy,1999,"100,000+",178359,3885,2515,2687,3.5,61.0,,87,24,63,87,4.50,28.0
981,tt1059773,The Adventures of Food Boy,2008,500+,511,45,88,51,2.7,34.0,,1,1,0,1,,
982,tt0099316,Crazy People,1990,"2,500+",4864,204,123,128,3.5,62.0,,20,7,13,20,4.40,35.0
983,tt1700808,Fast Girls,2012,"1,000+",1047,221,154,84,3.5,59.0,,23,19,4,23,5.70,83.0
984,tt1331298,Booky's Crush,2009,100+,130,12,7,6,3.7,63.0,,0,0,0,0,,
985,tt0213753,Kadhalar Dinam,1999,Fewer than 50,32,3,2,0,3.8,60.0,,0,0,0,0,,
986,tt0833557,Visioneers,2008,"2,500+",2954,674,579,402,3.2,54.0,,9,6,3,9,6.30,67.0
987,tt0392789,Spectres,2004,500+,648,4,7,10,3,36.0,,1,1,0,1,,
988,tt0098696,Your Mother Wears Combat Boots,1989,"1,000+",1081,11,6,7,3.7,65.0,,0,0,0,0,,
989,tt0293478,St. John's Wort,2001,0,0,0,0,0,,,,0,0,0,0,,
990,tt0072860,Deewaar,1975,"1,000+",1250,163,31,59,4.2,84.0,,3,2,1,3,,
991,tt0461695,Oil Storm,2005,0,0,0,0,0,,,,0,0,0,0,,
992,tt0272606,Jett Jackson: The Movie,2001,250+,264,30,34,16,3.2,47.0,,3,3,0,3,,
993,tt1682180,Stoker,2013,"10,000+",23169,6599,4361,1614,3.4,60.0,,206,145,61,206,6.70,70.0
994,tt0098273,Sea of Love,1989,"10,000+",15777,1361,701,414,3.6,66.0,,32,24,8,32,6.80,75.0
995,tt0078492,The Wild Geese,1978,"5,000+",5653,476,155,219,3.9,75.0,,9,6,3,9,6.40,67.0
996,tt0452694,The Time Traveler's Wife,2009,"250,000+",983034,18242,12427,11654,3.5,59.0,,158,61,97,158,5.10,39.0
997,tt0436971,Why We Fight,2005,"50,000+",67644,1843,253,1024,4.1,88.0,,116,91,25,116,7.10,78.0
998,tt0088915,A Chorus Line,1985,"10,000+",10268,636,404,440,3.5,61.0,,44,21,23,44,5.30,48.0
999,tt0054768,Creature from the Haunted Sea,1961,500+,903,43,174,99,2.2,20.0,,4,0,4,4,,
1000,tt0119086,Excess Baggage,1997,"25,000+",27416,509,747,437,3,40.0,,31,10,21,31,4.60,32.0
1001,tt0983909,Real Time,2008,500+,744,158,106,105,3.4,60.0,,4,2,2,4,,
1002,tt0202641,Two Family House,2000,"1,000+",1043,72,16,37,4,82.0,,35,31,4,35,7.70,89.0
1003,tt0117923,To Face Her Past,1996,0,0,0,0,0,,,,0,0,0,0,,
1004,tt0120738,Lost in Space,1998,"100,000+",173968,1204,3759,3151,2.5,24.0,,84,23,61,84,4.90,27.0
1005,tt0808285,The Good Heart,2009,"1,000+",1597,236,170,102,3.4,58.0,,37,12,25,37,4.60,32.0
1006,tt1314269,Applaus,2009,Fewer than 50,13,5,3,3,3.4,62.0,,27,24,3,27,7.20,89.0
1007,tt1783234,40 Point Plan,2012,0,0,0,0,0,,,,0,0,0,0,,
1008,tt0156413,The Clown at Midnight,1998,"1,000+",1185,36,57,38,3,38.0,,3,0,3,3,,
1009,tt0055035,Junglee,1961,0,0,0,0,0,,,,0,0,0,0,,
1010,tt0800268,Wieners,2008,500+,622,65,161,101,2.6,29.0,,1,0,1,1,,
1011,tt0090057,Spookies,1986,250+,256,23,91,42,2.6,20.0,,7,2,5,7,3.60,29.0
1012,tt0093315,Jocks,1986,250+,317,6,38,26,2.3,14.0,,1,0,1,1,,
1013,tt0106450,Body Melt,1993,250+,444,39,84,52,2.8,31.0,,5,5,0,5,6.50,100.0
1014,tt0102005,Harley Davidson and the Marlboro Man,1991,"10,000+",12291,855,462,467,3.7,65.0,,21,6,15,21,4.50,29.0
1015,tt0317676,House of the Dead,2003,"25,000+",46891,256,2210,1740,1.4,10.0,,61,2,59,61,2.50,3.0
1016,tt0380066,The Woods,2006,"25,000+",25353,469,801,619,3,37.0,,15,10,5,15,6.10,67.0
1017,tt0069029,The Blood Spattered Bride,1972,Fewer than 50,4,2,2,0,,,,2,1,1,2,,
1018,tt0072653,The Apple Dumpling Gang,1975,"10,000+",11112,408,276,287,3.5,60.0,,9,5,4,9,6.30,56.0
1019,tt0275773,Versus,2000,"10,000+",19131,2057,628,1426,3.9,77.0,,16,12,4,16,6.60,75.0
1020,tt0821638,Bury My Heart at Wounded Knee,2007,"2,500+",3832,739,208,392,3.9,78.0,,3,2,1,3,,
1021,tt0102984,Stone Cold,1991,"2,500+",3563,285,164,198,3.7,64.0,,9,3,6,9,5.00,33.0
1022,tt0145783,Forever Love,1998,500+,619,104,10,42,4.6,91.0,,0,0,0,0,,
1023,tt0449059,Little Miss Sunshine,2006,"250,000+",427835,120314,11299,45164,4.3,91.0,,219,199,20,219,7.70,91.0
1024,tt1131732,Flying By,2009,100+,169,4,19,11,2.6,18.0,,0,0,0,0,,
1025,tt1028576,Secretariat,2010,"50,000+",50007,6501,2037,2088,3.9,76.0,,160,102,58,160,6.10,64.0
1026,tt1284575,Bad Teacher,2011,"50,000+",85070,12169,21352,5823,2.9,36.0,,192,85,107,192,5.30,44.0
1027,tt1334456,Ice Twisters,2009,250+,331,37,113,57,2.4,25.0,,0,0,0,0,,
1028,tt0840361,The Town,2010,"100,000+",142670,50111,9027,12131,4,85.0,,238,219,19,238,7.70,92.0
1029,tt0353042,DC 9/11: Time of Crisis,2003,0,0,0,0,0,,,,0,0,0,0,,
1030,tt0122951,Any Mother's Son,1997,Fewer than 50,1,0,1,0,,,,0,0,0,0,,
1031,tt1225822,Extract,2009,"100,000+",174067,4389,7088,3596,3,38.0,,189,118,71,189,5.90,62.0
1032,tt1675192,Take Shelter,2011,"25,000+",25898,9387,2242,2292,3.9,81.0,,170,157,13,170,8.00,92.0
1033,tt0057336,Muriel,1963,500+,733,129,34,46,3.9,79.0,,13,11,2,13,8.00,85.0
1034,tt0256951,Nadiya Ke Paar,1982,Fewer than 50,37,5,1,0,4.2,83.0,,0,0,0,0,,
1035,tt0454224,Penny Dreadful,2006,0,0,0,0,0,,,,0,0,0,0,,
1036,tt0071730,Kunwara Baap,1974,0,0,0,0,0,,,,0,0,0,0,,
1037,tt0062897,Diwana,1967,0,0,0,0,0,,,,0,0,0,0,,
1038,tt0215028,Panchagni,1986,0,0,0,0,0,,,,0,0,0,0,,
1039,tt0120788,Permanent Midnight,1998,"5,000+",5671,344,298,191,3.3,54.0,,54,32,22,54,5.80,59.0
1040,tt1582641,Jhummandi Naadam,2010,100+,132,116,3,0,4.8,97.0,,0,0,0,0,,
1041,tt0230623,Parinayam,1994,0,0,0,0,0,,,,0,0,0,0,,
1042,tt0374021,A Man's Gotta Do,2004,"1,000+",1271,17,13,11,3.4,57.0,,9,0,9,9,3.90,0.0
1043,tt0068309,Boxcar Bertha,1972,"5,000+",5464,216,448,208,2.9,33.0,,24,13,11,24,5.10,54.0
1044,tt0118526,...First Do No Harm,1997,"1,000+",1281,99,53,51,3.6,65.0,,1,1,0,1,,
1045,tt0287537,Love Ke Liye Kuch Bhi Karega,2001,500+,682,30,43,8,3.1,41.0,,0,0,0,0,,
1046,tt1282015,2081,2009,500+,596,239,46,48,4.3,84.0,,2,2,0,2,,
1047,tt0940641,143,2004,0,0,0,0,0,,,,0,0,0,0,,
1048,tt0120789,Pleasantville,1998,"100,000+",231087,13827,3677,6220,3.9,79.0,,98,84,14,98,7.70,86.0
1049,tt1821478,Kaavalan,2011,"1,000+",1271,248,315,140,2.9,44.0,,0,0,0,0,,
1050,tt0481536,Harold & Kumar Escape from Guantanamo Bay,2008,"250,000+",377995,17766,11891,13486,3.5,60.0,,134,70,64,134,5.60,52.0
1051,tt2393707,Aparajita Tumi,2012,Fewer than 50,1,0,1,0,,,,0,0,0,0,,
1052,tt1326869,Stuck Like Chuck,2009,0,0,0,0,0,,,,0,0,0,0,,
1053,tt0206420,Woman on Top,2000,"5,000+",8073,442,597,291,3.1,43.0,,100,35,65,100,4.80,35.0
1054,tt0067917,Up the Chastity Belt,1972,100+,209,7,10,9,3.4,41.0,,0,0,0,0,,
1055,tt0112643,Castle Freak,1995,"5,000+",6658,224,284,204,3.1,44.0,,8,5,3,8,5.30,63.0
1056,tt0111549,Uncovered,1994,500+,941,37,46,22,3.2,45.0,,4,1,3,4,,
1057,tt2326758,Kadhalil Vizhunthen,2008,0,0,0,0,0,,,,0,0,0,0,,
1058,tt0490499,The Tiger's Tail,2006,500+,663,37,83,56,2.8,31.0,,21,3,18,21,4.70,14.0
1059,tt1966496,Kedi,2006,0,0,0,0,0,,,,0,0,0,0,,
1060,tt0120767,The Naked Man,1999,50+,99,10,19,6,2.4,34.0,,5,1,4,5,4.90,20.0
1061,tt0111271,Squanto: A Warrior's Tale,1994,"1,000+",2360,89,73,45,3.5,55.0,,10,6,4,10,5.60,60.0
1062,tt0098575,Valmont,1989,"5,000+",9493,804,357,301,3.7,69.0,,33,16,17,33,6.20,48.0
1063,tt0475293,High School Musical,2006,"250,000+",471147,41620,14743,38348,3.9,74.0,,21,14,7,21,5.70,67.0
1064,tt0118747,Blues Brothers 2000,1998,"50,000+",59283,1254,2103,1542,2.8,37.0,,48,22,26,48,5.10,46.0
1065,tt2065968,Dragons: Gift of the Night Fury,2011,250+,411,195,49,39,4.1,80.0,,0,0,0,0,,
1066,tt1208731,Toinen jalka haudasta,2009,0,0,0,0,0,,,,0,0,0,0,,
1067,tt0878835,Please Give,2010,"10,000+",11582,1525,860,670,3.4,64.0,,142,122,20,142,7.50,86.0
1068,tt1543912,Surfing Soweto,2007,Fewer than 50,5,2,2,0,,,,0,0,0,0,,
1069,tt0875692,Aggar: Passion Betrayal Terror,2007,0,0,0,0,0,,,,0,0,0,0,,
1070,tt0814759,Parc,2008,50+,58,0,3,0,,,,0,0,0,0,,
1071,tt0102951,Soapdish,1991,"5,000+",8876,890,517,363,3.6,63.0,,42,31,11,42,6.00,74.0
1072,tt0090151,"That was Then, This is Now",1985,"5,000+",7343,170,120,94,3.5,59.0,,5,0,5,5,3.20,0.0
1073,tt0117768,The Stupids,1996,"10,000+",10246,331,550,472,2.7,38.0,,14,3,11,14,4.30,21.0
1074,tt0278504,Insomnia,2002,"100,000+",105833,13925,4161,3961,3.7,77.0,,204,188,16,204,7.70,92.0
1075,tt0288730,Personals: College Girl Seeking...,2001,Fewer than 50,38,2,0,0,,,,0,0,0,0,,
1076,tt0421199,The Fallen Ones,2005,"1,000+",1294,7,28,28,2.1,20.0,,4,2,2,4,,
1077,tt0277434,We Were Soldiers,2002,"100,000+",203400,21051,4136,6588,4.1,84.0,,146,93,53,146,6.40,64.0
1078,tt0080515,A Change of Seasons,1980,Fewer than 50,17,10,7,5,3.6,59.0,,3,2,1,3,,
1079,tt1700844,The Deep Blue Sea,2011,"10,000+",21153,1172,1093,379,3.3,52.0,,145,117,28,145,7.10,81.0
1080,tt0272152,K-PAX,2001,"50,000+",79545,7816,2672,3011,3.8,75.0,,141,59,82,141,5.20,42.0
1081,tt1265621,Quantum Apocalypse,2010,50+,64,0,2,1,,,,0,0,0,0,,
1082,tt0099039,Angel Town,1990,100+,123,10,16,11,3.1,38.0,,0,0,0,0,,
1083,tt0351126,Jeevan Yudh,1997,Fewer than 50,31,0,1,0,,,,0,0,0,0,,
1084,tt0120865,This Is My Father,1998,"1,000+",1398,116,27,56,4,81.0,,28,21,7,28,6.70,75.0
1085,tt0434124,Kinky Boots,2005,"50,000+",72828,2783,971,1890,3.8,74.0,,113,66,47,113,5.80,58.0
1086,tt0105150,The Playboys,1992,"1,000+",1023,39,34,16,3.3,53.0,,25,23,2,25,6.80,92.0
1087,tt0493443,Finding Rin Tin Tin,2007,100+,195,17,18,15,3.3,49.0,,1,0,1,1,,
1088,tt0267130,Yodha,1991,Fewer than 50,29,0,1,0,,,,0,0,0,0,,
1089,tt0187445,Ranuva Veeran,1981,0,0,0,0,0,,,,0,0,0,0,,
1090,tt0187334,Naan Adimai Illai,1986,0,0,0,0,0,,,,0,0,0,0,,
1091,tt0053645,Bells Are Ringing,1960,"1,000+",1813,131,43,86,3.8,75.0,,11,9,2,11,6.60,82.0
1092,tt1758570,Battle of Los Angeles,2011,500+,717,23,187,95,1.4,11.0,,2,1,1,2,,
1093,tt0072068,La Raulito,1975,0,0,0,0,0,,,,0,0,0,0,,
1094,tt0435770,The Visitation,2006,"5,000+",5576,252,183,254,3.5,58.0,,3,0,3,3,,
1095,tt1073221,The Legend of God's Gun,2007,250+,435,10,12,9,3,45.0,,2,1,1,2,,
1096,tt0302640,The Hot Chick,2002,"250,000+",475321,9250,6392,10882,3.4,59.0,,82,17,65,82,3.90,21.0
1097,tt0112870,Dilwale Dulhania Le Jayenge,1995,"10,000+",20584,3143,187,955,4.6,94.0,,6,6,0,6,,100.0
1098,tt0091464,Malcolm,1986,500+,832,137,27,70,4.1,84.0,,4,3,1,4,,
1099,tt0103130,Trust,1990,"5,000+",5148,972,68,283,4.4,93.0,,25,20,5,25,7.00,80.0
1100,tt1854364,The Union,2011,Fewer than 50,17,5,2,3,3.7,71.0,,2,2,0,2,,
1101,tt0247909,Aaj Ka Goonda Raaj,1992,100+,191,4,1,1,3.8,80.0,,0,0,0,0,,
1102,tt0112870,Dilwale Dulhania Le Jayenge,1995,"10,000+",20584,3143,187,955,4.6,94.0,,6,6,0,6,,100.0
1103,tt1018817,April Fool's Day,2008,"1,000+",2043,75,363,217,2.1,17.0,,3,0,3,3,,
1104,tt1018817,April Fool's Day,2008,"1,000+",2043,75,363,217,2.1,17.0,,3,0,3,3,,
1105,tt0829176,Gallowwalkers,2012,500+,904,53,425,109,1.8,11.0,,4,1,3,4,,
1106,tt0108211,Stalingrad,1993,"5,000+",7675,1478,211,461,4.1,87.0,,0,0,0,0,,
1107,tt0108211,Stalingrad,1993,"5,000+",7675,1478,211,461,4.1,87.0,,0,0,0,0,,
1108,tt0063032,The Great Silence,1968,"5,000+",6802,770,90,283,4.2,89.0,,14,14,0,14,8.10,100.0
1109,tt0119454,Keeping the Promise,1997,500+,552,9,8,9,3.3,56.0,,0,0,0,0,,
1110,tt0284490,Showtime,2002,"25,000+",49200,774,2344,676,2.6,25.0,,122,30,92,122,4.70,25.0
1111,tt0113729,Mad Love,1995,"10,000+",19993,502,513,322,3.3,49.0,,26,8,18,26,4.60,31.0
1112,tt0083090,Skokie,1981,50+,91,4,8,2,3.1,33.0,,0,0,0,0,,
1113,tt0060741,The Navy vs. the Night Monsters,1966,500+,633,7,20,10,2.5,26.0,,2,0,2,2,,
1114,tt0284303,Megalodon,2002,"1,000+",1636,21,88,59,2,19.0,,0,0,0,0,,
1115,tt0229003,New Port South,2001,500+,589,25,22,17,3.2,53.0,,5,0,5,5,4.20,0.0
1116,tt0315273,Benji: Off the Leash!,2004,"1,000+",1777,33,31,30,3.3,52.0,,42,14,28,42,4.80,33.0
1117,tt0423370,This Revolution,2005,500+,540,59,25,39,3.5,70.0,,11,2,9,11,4.20,18.0
1118,tt0770810,How She Move,2007,"25,000+",32699,874,843,744,3.3,51.0,,79,52,27,79,5.90,66.0
1119,tt1356395,The Dog Who Saved Christmas,2009,250+,280,40,69,21,2.8,37.0,,0,0,0,0,,
1120,tt0167350,Progeny,1998,"1,000+",1279,12,31,20,2.5,28.0,,3,0,3,3,,
1121,tt1597178,Worried About the Boy,2010,100+,129,47,31,19,3.6,60.0,,0,0,0,0,,
1122,tt0058898,Alphaville,1965,"10,000+",13165,2147,507,710,4,81.0,,48,44,4,48,8.40,92.0
1123,tt1126618,Morning Glory,2010,"50,000+",50377,6429,6176,3036,3.3,51.0,,183,102,81,183,6.00,56.0
1124,tt0240890,Serendipity,2001,"100,000+",228331,22039,5928,9108,4,79.0,,142,84,58,142,5.80,59.0
1125,tt0102307,Light Sleeper,1992,"1,000+",2161,179,97,71,3.5,65.0,,45,39,6,45,7.50,87.0
1126,tt0078238,Sextette,1977,100+,130,11,27,21,2.5,30.0,,12,3,9,12,4.40,25.0
1127,tt0119137,Flubber,1997,"250,000+",623805,3054,6277,10080,2.8,33.0,,35,8,27,35,4.00,23.0
1128,tt0094655,Andy Colby's Incredible Adventure,1989,50+,53,2,1,1,,,,0,0,0,0,,
1129,tt0192634,Strange Justice,1999,0,0,0,0,0,,,,0,0,0,0,,
1130,tt0106689,Death Train,1993,"2,500+",2577,46,88,41,2.8,34.0,,1,1,0,1,,
1131,tt0073662,Satan's Triangle,1975,Fewer than 50,9,6,2,2,3.6,75.0,,0,0,0,0,,
1132,tt2325803,Kunguma Pottu Gounder,2001,0,0,0,0,0,,,,0,0,0,0,,
1133,tt0806203,Carriers,2009,"50,000+",93992,2799,4364,1820,3,39.0,,39,25,14,39,5.80,64.0
1134,tt0790781,Wendy Wu: Homecoming Warrior,2006,"25,000+",39678,1037,952,815,3.3,52.0,,4,2,2,4,,
1135,tt0082159,Charlie Chan and the Curse of the Dragon Queen,1981,"1,000+",1813,13,28,24,2.8,32.0,,7,2,5,7,5.30,29.0
1136,tt0070434,Namak Haraam,1973,Fewer than 50,1,1,0,0,,,,0,0,0,0,,
1137,tt2049636,Unity,2015,250+,263,35,21,18,3.5,62.0,,4,3,1,4,,
1138,tt0106500,CB4,1993,"10,000+",10481,706,444,386,3.6,61.0,,27,14,13,27,5.60,52.0
1139,tt10133460,Panchamirtham,2008,0,0,0,0,0,,,,0,0,0,0,,
1140,tt0083791,The Dark Crystal,1982,"100,000+",176570,15191,3637,7944,4,81.0,,48,37,11,48,6.50,77.0
1141,tt0320421,Sathyaa,1988,0,0,0,0,0,,,,0,0,0,0,,
1142,tt0120765,My Giant,1998,"5,000+",8945,101,298,117,2.5,25.0,,28,6,22,28,4.90,21.0
1143,tt1867070,Teen Thay Bhai,2011,Fewer than 50,4,1,3,0,,,,1,0,1,1,,
1144,tt0338963,Encrypt,2003,100+,171,3,8,6,2.5,27.0,,0,0,0,0,,
1145,tt0353590,Julie Ganapathy,2003,0,0,0,0,0,,,,0,0,0,0,,
1146,tt0287936,Blind Terror,2001,"1,000+",1741,5,12,8,2.6,29.0,,0,0,0,0,,
1147,tt0061383,Banning,1967,Fewer than 50,32,2,1,0,,,,1,1,0,1,,
1148,tt1289437,The Steam Experiment,2009,500+,967,14,284,147,1.5,5.0,,1,0,1,1,,
1149,tt0118804,The Butcher Boy,1997,"5,000+",6122,733,166,287,3.9,82.0,,61,47,14,61,7.50,77.0
1150,tt1229360,It Might Get Loud,2008,"10,000+",18237,2284,408,917,4,85.0,,112,89,23,112,6.90,79.0
1151,tt0102803,The Rocketeer,1991,"50,000+",57564,3064,1658,1668,3.6,65.0,,66,44,22,66,6.20,67.0
1152,tt0368563,Possession,2009,Fewer than 50,20,1,1,0,,,,0,0,0,0,,
1153,tt2571418,Sheelabathi,2005,0,0,0,0,0,,,,0,0,0,0,,
1154,tt0068257,Bawarchi,1972,500+,501,76,6,24,4.3,93.0,,1,1,0,1,,
1155,tt1639426,Udaan,2010,"1,000+",1234,585,73,210,4.1,89.0,,3,3,0,3,,
1156,tt1435469,Bharatha Vilas,1973,0,0,0,0,0,,,,0,0,0,0,,
1157,tt0113634,Midnight in St. Petersburg,1996,Fewer than 50,37,1,11,2,2.5,8.0,,1,0,1,1,,
1158,tt0458017,Mixed Doubles,2006,250+,263,26,13,14,3.4,67.0,,1,1,0,1,,
1159,tt0062492,Wild 90,1968,0,0,0,0,0,,,,1,0,1,1,,
1160,tt0080904,Humanoids from the Deep,1980,"2,500+",2616,186,270,170,3,41.0,,11,6,5,11,5.40,55.0
1161,tt0273226,Focus,2001,100+,106,10,2,2,4.5,83.0,,0,0,0,0,,
1162,tt0319056,Between Two Women,2003,100+,133,8,13,10,3.3,38.0,,0,0,0,0,,
1163,tt0070531,Phase IV,1974,"1,000+",1227,184,152,126,3.3,55.0,,19,10,9,19,5.70,53.0
1164,tt0095871,Pin,1988,"2,500+",3368,203,145,174,3.4,58.0,,4,3,1,4,,
1165,tt1034314,Iron Sky,2012,"10,000+",10170,2322,3898,1261,2.8,37.0,,44,18,26,44,4.50,41.0
1166,tt0175448,Apna Desh,1972,Fewer than 50,22,1,0,0,,,,0,0,0,0,,
1167,tt0400525,The Ice Harvest,2005,"50,000+",60383,1216,1616,1229,3.1,43.0,,135,63,72,135,5.50,47.0
1168,tt1244659,Extraordinary Measures,2010,"50,000+",74364,2545,2227,1410,3.3,53.0,,143,41,102,143,4.90,29.0
1169,tt0097261,Eat a Bowl of Tea,1989,"1,000+",1208,29,30,17,3.4,49.0,,4,4,0,4,,
1170,tt0066612,Companeros,1970,500+,868,161,24,51,4.1,87.0,,3,2,1,3,,
1171,tt2245526,Where the Wild Things Are,2009,"250,000+",298885,19285,14737,12518,3.3,57.0,,268,195,73,268,7.00,73.0
1172,tt0088390,Wet Gold,1984,50+,82,2,1,1,,,,0,0,0,0,,
1173,tt0087550,Kidco,1984,250+,395,36,9,14,3.8,80.0,,0,0,0,0,,
1174,tt0996966,"Not Quite Hollywood: The Wild, Untold Story of Ozploitation!",2008,"1,000+",2392,602,152,370,3.9,80.0,,65,62,3,65,7.50,95.0
1175,tt0083694,Britannia Hospital,1982,"1,000+",1434,80,67,56,3.4,54.0,,6,3,3,6,6.90,50.0
1176,tt0067141,Glen and Randa,1971,100+,249,11,8,9,3.2,58.0,,3,2,1,3,,
1177,tt1151319,The Key to Reserva,2007,250+,431,62,8,22,4.1,88.0,,1,1,0,1,,
1178,tt1283923,Morbid: A Love Story,2009,0,0,0,0,0,,,,0,0,0,0,,
1179,tt0057681,The Wheeler Dealers,1963,100+,101,13,10,7,3.6,57.0,,1,1,0,1,,
1180,tt0117765,Striptease,1996,"50,000+",54046,668,2104,1140,2.4,24.0,,71,9,62,71,3.90,13.0
1181,tt1032817,Middle of Nowhere,2008,500+,855,194,199,63,3.2,49.0,,2,2,0,2,,
1182,tt1630282,Sahi Dhandhe Galat Bande,2011,0,0,0,0,0,,,,0,0,0,0,,
1183,tt0368876,Moving Malcolm,2003,50+,71,1,5,2,2.6,17.0,,4,2,2,4,,
1184,tt0217680,Nang Nak,1999,500+,668,87,35,57,3.7,71.0,,1,0,1,1,,
1185,tt0256466,The Ultimate Christmas Present,2000,500+,613,71,73,33,3.4,49.0,,2,2,0,2,,
1186,tt0089393,Just One of the Guys,1985,"5,000+",9051,855,463,457,3.6,65.0,,14,8,6,14,4.80,57.0
1187,tt1961530,Tell Me O Kkhuda,2011,0,0,0,0,0,,,,1,0,1,1,,
1188,tt0393162,Coach Carter,2005,"250,000+",406953,25222,4467,10553,4.1,85.0,,150,96,54,150,6.00,64.0
1189,tt1604585,Kannu Pada Poguthaiya,2000,0,0,0,0,0,,,,0,0,0,0,,
1190,tt0082886,Paternity,1981,100+,100,4,14,4,2.6,22.0,,4,1,3,4,,
1191,tt0220157,When Brendan Met Trudy,2000,100+,122,11,8,7,3.4,58.0,,63,38,25,63,5.70,60.0
1192,tt0977663,Sands of Oblivion,2007,500+,537,9,118,70,1.9,7.0,,0,0,0,0,,
1193,tt0053727,College Confidential,1960,0,0,0,0,0,,,,0,0,0,0,,
1194,tt0178186,Aandhi,1975,50+,87,16,1,3,4.3,94.0,,1,1,0,1,,
1195,tt0463429,Bharathchandran I.P.S,2005,0,0,0,0,0,,,,0,0,0,0,,
1196,tt1602613,Only God Forgives,2013,"25,000+",26540,4257,7223,2095,2.8,37.0,,170,69,101,170,5.30,41.0
1197,tt0094056,Street Smart,1987,"1,000+",1354,76,95,61,3.2,45.0,,15,10,5,15,5.80,67.0
1198,tt0408309,Vampires vs. Zombies,2004,"1,000+",1336,35,76,83,2.1,32.0,,1,0,1,1,,
1199,tt0377131,Raghu Romeo,2003,50+,78,6,0,3,4,100.0,,0,0,0,0,,
1200,tt15031054,Sundara Purushan,1996,0,0,0,0,0,,,,0,0,0,0,,
1201,tt0816671,Teen Titans: Trouble in Tokyo,2006,"2,500+",4904,415,140,237,4,75.0,,1,1,0,1,,
1202,tt22336544,A Fistful of Dynamite,1972,"10,000+",11604,1967,393,726,4,83.0,,24,22,2,24,7.40,92.0
1203,tt0075141,Ride a Wild Pony,1975,Fewer than 50,25,6,4,4,3.4,60.0,,0,0,0,0,,
1204,tt0476964,The Brave One,2007,"250,000+",274436,16732,9538,11875,3.5,64.0,,184,79,105,184,5.60,43.0
1205,tt0281634,Balto: Wolf Quest,2001,"10,000+",13283,309,269,223,3.4,54.0,,1,0,1,1,,
1206,tt0119368,The Informant,1997,100+,152,3,4,2,3,43.0,,4,2,2,4,,
1207,tt0972785,Bring It On: In It to Win It,2007,"25,000+",28300,3170,1348,1602,3.9,70.0,,3,0,3,3,,
1208,tt0348505,Asylum,2005,"1,000+",2320,73,429,248,2,14.0,,3,0,3,3,,
1209,tt0088019,The Rosebud Beach Hotel,1984,50+,87,0,11,6,2.2,0.0,,0,0,0,0,,
1210,tt0374277,Touch of Pink,2004,"5,000+",6120,378,203,233,3.7,65.0,,62,23,39,62,5.10,37.0
1211,tt1255873,Hari Puttar: A Comedy of Terrors,2008,100+,102,1,10,5,1.6,9.0,,1,0,1,1,,
1212,tt0068282,Black Mama White Mama,1973,"2,500+",3473,79,125,76,3.1,38.0,,2,0,2,2,,
1213,tt0179182,Forever Mine,1999,"1,000+",1560,58,82,43,3.1,41.0,,7,2,5,7,5.10,29.0
1214,tt1105745,Wisegal,2008,250+,486,68,42,44,3.6,62.0,,0,0,0,0,,
1215,tt0438888,Kalpurush,2005,Fewer than 50,14,2,0,2,,,,0,0,0,0,,
1216,tt0099575,Fire Birds,1990,"5,000+",6851,144,268,111,2.8,35.0,,22,2,20,22,3.10,9.0
1217,tt1077262,Ajami,2009,"5,000+",7074,754,177,224,3.9,81.0,,69,67,2,69,7.70,97.0
1218,tt0119396,Jackie Brown,1997,"100,000+",215832,22377,3866,6862,4,85.0,,96,84,12,96,7.60,88.0
1219,tt0119244,Hacks,1997,50+,74,2,3,3,3.2,40.0,,0,0,0,0,,
1220,tt0123865,Gia,1998,"50,000+",53665,5795,1246,2369,4.1,82.0,,16,14,2,16,7.00,88.0
1221,tt1340123,Samson & Delilah,2009,"5,000+",8596,491,155,255,3.8,76.0,,54,51,3,54,7.80,94.0
1222,tt1530983,Red Hill,2010,"2,500+",4211,690,517,418,3.3,57.0,,68,54,14,68,6.50,79.0
1223,tt1080926,Dr. Dolittle: Million Dollar Mutts,2009,"1,000+",1517,68,65,32,3.2,52.0,,1,0,1,1,,
1224,tt0319829,Masked and Anonymous,2003,"2,500+",3613,206,254,203,3,45.0,,81,20,61,81,4.30,25.0
1225,tt0285531,Dreamcatcher,2003,"100,000+",132438,2570,4690,3860,2.8,35.0,,181,50,131,181,4.80,28.0
1226,tt0245501,Things Behind the Sun,2001,"1,000+",1070,86,25,30,3.9,78.0,,12,12,0,12,7.10,100.0
1227,tt1575576,Jayam Manadera,2000,0,0,0,0,0,,,,0,0,0,0,,
1228,tt0245501,Things Behind the Sun,2001,"1,000+",1070,86,25,30,3.9,78.0,,12,12,0,12,7.10,100.0
1229,tt0062768,Bye Bye Braverman,1968,250+,406,10,19,11,2.8,34.0,,9,3,6,9,5.60,33.0
1230,tt4328102,Kandaen,2011,0,0,0,0,0,,,,0,0,0,0,,
1231,tt0138444,Fifteen and Pregnant,1998,"5,000+",7477,363,213,223,3.7,63.0,,0,0,0,0,,
1232,tt1395738,Harry Potter and the Half-Blood Prince,2009,"250,000+",1560704,91431,26111,52758,3.9,78.0,,280,234,46,280,7.10,84.0
1233,tt0421237,Royal Kill,2009,250+,304,5,39,21,1.6,11.0,,1,0,1,1,,
1234,tt0065579,Cotton Comes to Harlem,1970,"1,000+",2047,82,42,61,3.6,66.0,,4,4,0,4,,
1235,tt0287262,Presença de Anita,2001,0,0,0,0,0,,,,0,0,0,0,,
1236,tt1931533,Seven Psychopaths,2012,"100,000+",130364,24270,9878,4427,3.7,71.0,,218,180,38,218,7.10,83.0
1237,tt0116778,Kingpin,1996,"50,000+",81405,5287,2385,2293,3.7,69.0,,39,19,20,39,5.70,49.0
1238,tt0088876,Came a Hot Friday,1985,Fewer than 50,20,6,0,2,4.2,100.0,,0,0,0,0,,
1239,tt0073328,Mackintosh and T.J.,1975,Fewer than 50,5,3,1,3,,,,0,0,0,0,,
1240,tt0177915,Mala época,1998,0,0,0,0,0,,,,0,0,0,0,,
1241,tt0353616,Kashmeeram,1994,0,0,0,0,0,,,,0,0,0,0,,
1242,tt0143261,Friends & Lovers,1999,"1,000+",1378,27,56,29,2.5,33.0,,15,1,14,15,2.60,7.0
1243,tt0463944,Code Breakers,2005,100+,241,10,16,9,2.9,38.0,,0,0,0,0,,
1244,tt0250617,Night at the Golden Eagle,2001,"1,000+",1106,45,27,23,3.3,62.0,,17,7,10,17,4.60,41.0
1245,tt0119643,Meet Joe Black,1998,"100,000+",240840,24420,5889,9197,4,81.0,,50,23,27,50,5.60,46.0
1246,tt0244549,Inspector Balram,1991,0,0,0,0,0,,,,0,0,0,0,,
1247,tt0499580,Though None Go with Me,2006,500+,820,138,26,89,4.2,84.0,,0,0,0,0,,
1248,tt0334754,Yossi & Jagger,2002,"2,500+",3405,444,152,144,3.8,74.0,,44,38,6,44,6.70,86.0
1249,tt0084840,Umbartha,1982,Fewer than 50,14,2,1,1,,,,1,1,0,1,,
1250,tt0411377,Man in the Mirror: The Michael Jackson Story,2004,500+,578,47,68,42,2.7,40.0,,3,0,3,3,,
1251,tt0071198,The Bat People,1974,250+,476,4,59,31,1.4,6.0,,0,0,0,0,,
1252,tt0110982,Revenge of the Nerds IV: Nerds in Love,1994,"5,000+",7529,83,266,111,2.4,24.0,,0,0,0,0,,
1253,tt1731141,Ender's Game,2013,"100,000+",118927,31081,16817,5500,3.6,65.0,,227,142,85,227,6.10,63.0
1254,tt0068967,Moon of the Wolf,1972,500+,957,13,75,44,2.2,15.0,,1,1,0,1,,
1255,tt1473074,Mammuth,2010,500+,972,82,114,48,3,42.0,,24,15,9,24,5.60,63.0
1256,tt0339785,Thoughtcrimes,2003,"1,000+",1419,79,25,50,4.1,76.0,,0,0,0,0,,
1257,tt10515868,Kathavarayan,2008,0,0,0,0,0,,,,0,0,0,0,,
1258,tt0481580,Autism: The Musical,2007,500+,602,162,25,95,4.1,87.0,,3,3,0,3,,
1259,tt0119053,Almost Heroes,1998,"25,000+",37506,1764,976,1000,3.7,64.0,,39,2,37,39,3.10,5.0
1260,tt0233147,Ayee Milan Ki Bela,1964,Fewer than 50,23,2,0,0,,,,0,0,0,0,,
1261,tt0101510,Bright Angel,1990,50+,81,4,11,2,2.7,27.0,,5,4,1,5,7.00,80.0
1262,tt0105251,Revenge of the Nerds III: The Next Generation,1992,"10,000+",11005,105,381,154,2.5,22.0,,1,1,0,1,,
1263,tt0473107,Wal-Mart: The High Cost of Low Price,2005,"5,000+",8177,1070,565,708,3.5,65.0,,29,26,3,29,7.00,90.0
1264,tt0962726,High School Musical 3: Senior Year,2008,"250,000+",354190,12968,5161,7673,3.9,72.0,,132,85,47,132,6.00,64.0
1265,tt0425601,Trailer Park Boys: The Movie,2006,"10,000+",12643,2208,637,1136,4,78.0,,23,13,10,23,5.50,57.0
1266,tt0756672,The Killing Floor,2007,"1,000+",2243,109,239,154,2.8,31.0,,1,0,1,1,,
1267,tt1223134,Anasuya,2007,0,0,0,0,0,,,,0,0,0,0,,
1268,tt0258273,Lovely & Amazing,2001,"5,000+",5313,463,267,191,3.5,63.0,,123,106,17,123,7.30,86.0
1269,tt1527835,Archipelago,2010,"1,000+",1805,214,149,83,3.4,59.0,,25,24,1,25,7.70,96.0
1270,tt0820987,Pacquiao: The Movie,2006,100+,179,6,4,2,3.5,60.0,,0,0,0,0,,
1271,tt0094134,Three Bewildered People in the Night,1987,Fewer than 50,44,1,5,2,2.1,17.0,,1,1,0,1,,
1272,tt0435706,Nina's Heavenly Delights,2006,"1,000+",1119,138,78,96,3.6,64.0,,19,3,16,19,3.80,16.0
1273,tt0104905,Mom and Dad Save the World,1992,"5,000+",9424,237,300,247,3.1,44.0,,25,3,22,25,3.70,12.0
1274,tt0260866,Don't Say a Word,2001,100+,163,13,9,7,3.2,59.0,,0,0,0,0,,
1275,tt1701210,Black Gold,2011,"1,000+",1541,314,292,111,3.4,52.0,,27,3,24,27,4.00,11.0
1276,tt0241025,Vanity Fair,2004,"25,000+",48744,2304,2306,1721,3.2,50.0,,168,85,83,168,5.80,51.0
1277,tt0119509,Leave It to Beaver,1997,"5,000+",9853,153,330,134,2.8,32.0,,28,6,22,28,4.10,21.0
1278,tt0080116,Wanda Nevada,1979,100+,155,16,27,10,3,37.0,,1,0,1,1,,
1279,tt0395932,Able Edwards,2004,50+,68,2,6,5,2.6,25.0,,1,1,0,1,,
1280,tt2196059,The Dark Place,2014,Fewer than 50,18,5,5,4,,,,0,0,0,0,,
1281,tt0066830,The Big Doll House,1971,"1,000+",1728,99,98,84,3.4,50.0,,7,7,0,7,7.40,100.0
1282,tt0059339,Joy in the Morning,1965,50+,65,5,6,2,2.9,45.0,,5,0,5,5,4.00,0.0
1283,tt0148375,Khilona,1970,50+,58,3,1,0,,,,0,0,0,0,,
1284,tt1416753,Mayura,1975,0,0,0,0,0,,,,0,0,0,0,,
1285,tt0892874,Halla Bol,2008,"1,000+",1311,119,136,122,3.2,47.0,,2,1,1,2,,
1286,tt0780534,My Mom's New Boyfriend,2008,"5,000+",5355,534,1286,664,2.7,29.0,,2,0,2,2,,
1287,tt0404390,Running Scared,2006,"100,000+",135460,9096,2388,5235,3.9,79.0,,131,54,77,131,5.00,41.0
1288,tt0074213,Black Samurai,1976,500+,843,32,32,35,3.1,50.0,,2,1,1,2,,
1289,tt0071706,Juggernaut,1974,"1,000+",1801,97,77,59,3.4,56.0,,10,8,2,10,7.60,80.0
1290,tt0100539,Sailaab,1990,Fewer than 50,5,0,1,1,,,,0,0,0,0,,
1291,tt0830199,Romeo & Juliet: Sealed with a Kiss,2005,"1,000+",1841,35,29,33,3.3,54.0,,5,1,4,5,3.70,20.0
1292,tt0061452,Casino Royale,1967,"25,000+",33283,837,1638,1063,2.7,34.0,,42,11,31,42,4.60,26.0
1293,tt2606826,Poraali,2011,0,0,0,0,0,,,,0,0,0,0,,
1294,tt1585272,Soul Boy,2010,50+,69,8,7,1,3.2,53.0,,1,1,0,1,,
1295,tt0451631,Apaharan,2005,250+,254,29,10,5,3.7,74.0,,0,0,0,0,,
1296,tt0090678,Avenging Force,1986,500+,656,51,53,47,3.2,50.0,,3,0,3,3,,
1297,tt11344336,Poomagal Oorvalam,1999,0,0,0,0,0,,,,0,0,0,0,,
1298,tt0780504,Drive,2011,"100,000+",120077,58576,15442,14422,3.9,79.0,,277,257,20,277,8.30,93.0
1299,tt0061180,The Whisperers,1967,100+,227,23,16,16,3.3,59.0,,6,4,2,6,6.30,67.0
1300,tt1270798,X-Men: First Class,2011,"100,000+",185495,83336,12075,18423,4.1,87.0,,299,257,42,299,7.40,86.0
1301,tt0063595,She-Devils on Wheels,1968,500+,915,35,49,30,2.9,42.0,,6,3,3,6,5.20,50.0
1302,tt0424880,Candy,2006,"25,000+",25428,4314,1296,2034,3.9,77.0,,75,35,40,75,5.70,47.0
1303,tt0384803,Alien 51,2004,100+,134,0,6,3,1.1,0.0,,1,0,1,1,,
1304,tt1219349,Jau Tithe Khau,2007,0,0,0,0,0,,,,0,0,0,0,,
1305,tt0104926,Mr. Baseball,1992,"5,000+",9454,374,540,267,3.1,41.0,,18,2,16,18,4.20,11.0
1306,tt0057918,Carry on Cleo,1964,"1,000+",2480,173,64,81,3.8,73.0,,4,2,2,4,,
1307,tt0114236,Ravan Raaj: A True Story,1995,0,0,0,0,0,,,,0,0,0,0,,
1308,tt0780653,The Wolfman,2010,"100,000+",223372,8753,17636,10553,2.8,33.0,,223,74,149,223,4.80,33.0
1309,tt0199372,Bontoc Eulogy,1995,Fewer than 50,8,0,3,0,,,,1,1,0,1,,
1310,tt0286942,Sardari Begum,1996,100+,142,11,4,5,3.9,73.0,,0,0,0,0,,
1311,tt0067119,Fright,1971,250+,401,17,26,17,3,40.0,,1,0,1,1,,
1312,tt0091068,Foreign Body,1986,Fewer than 50,46,3,0,1,,,,0,0,0,0,,
1313,tt1135952,White Material,2009,"10,000+",11180,469,265,186,3.4,64.0,,95,82,13,95,7.20,86.0
1314,tt1606376,Avan Ivan,2011,50+,60,14,12,7,3.1,54.0,,0,0,0,0,,
1315,tt0448182,Yesterday Was a Lie,2009,250+,372,111,23,16,4.1,83.0,,6,5,1,6,6.80,83.0
1316,tt0085889,Making of a Male Model,1983,0,0,0,0,0,,,,0,0,0,0,,
1317,tt2786580,Nasibo,1994,0,0,0,0,0,,,,0,0,0,0,,
1318,tt0110649,The New Age,1994,100+,179,10,15,6,3.1,40.0,,14,9,5,14,6.20,64.0
1319,tt0450232,16 Blocks,2006,"100,000+",164037,7897,5865,4889,3.4,57.0,,161,89,72,161,5.90,55.0
1320,tt0108223,Stepmonster,1993,500+,765,34,40,29,3,46.0,,5,0,5,5,2.40,0.0
1321,tt1185837,The Cell 2,2009,"10,000+",16710,22,286,157,1.5,7.0,,3,0,3,3,,
1322,tt1379177,The Disappearance of Alice Creed,2009,"25,000+",27704,2584,1281,1105,3.5,67.0,,99,80,19,99,6.90,81.0
1323,tt0072435,Zandy's Bride,1974,100+,118,21,15,14,3.4,58.0,,3,0,3,3,,
1324,tt0861699,Cruel and Unusual,2006,0,0,0,0,0,,,,0,0,0,0,,
1325,tt0110091,I Like It Like That,1994,"2,500+",3067,257,26,118,4.4,91.0,,69,61,8,69,7.40,88.0
1326,tt1020558,Centurion,2010,"25,000+",47787,3043,4095,1946,3.1,43.0,,114,68,46,114,5.50,60.0
1327,tt0473356,The Flock,2007,"5,000+",6339,499,1037,673,2.8,32.0,,2,1,1,2,,
1328,tt0066808,Bananas,1971,"10,000+",18471,2535,896,701,3.7,74.0,,35,29,6,35,7.50,83.0
1329,tt0495034,Golmaal: Fun Unlimited,2006,"2,500+",2532,228,79,76,3.8,74.0,,1,0,1,1,,
1330,tt0495034,Golmaal: Fun Unlimited,2006,"2,500+",2532,228,79,76,3.8,74.0,,1,0,1,1,,
1331,tt0057970,The Creeping Terror,1964,Fewer than 50,5,1,4,2,1.6,20.0,,0,0,0,0,,
1332,tt1161864,The Rite,2011,"50,000+",52724,5294,7837,3272,3,40.0,,174,38,136,174,4.30,22.0
1333,tt0097007,The Caller,1987,50+,61,6,12,5,3.2,33.0,,2,0,2,2,,
1334,tt1212408,Dog Tags,2008,250+,358,41,54,48,3.1,43.0,,1,1,0,1,,
1335,tt0106761,Double Dragon,1994,"25,000+",29995,309,869,622,2.3,26.0,,17,2,15,17,3.60,12.0
1336,tt0118586,All Over Me,1997,"2,500+",4708,338,141,140,3.7,71.0,,30,26,4,30,7.20,87.0
1337,tt2235232,Maharaja Talkies,2011,0,0,0,0,0,,,,0,0,0,0,,
1338,tt0097626,Johnny Handsome,1989,"2,500+",3697,187,210,80,3.3,47.0,,15,9,6,15,6.30,60.0
1339,tt0320097,Hum Kisi Se Kum Nahin,2002,250+,288,3,22,3,1.9,12.0,,0,0,0,0,,
1340,tt0082614,The Killing of Angel Street,1981,0,0,0,0,0,,,,1,1,0,1,,
1341,tt0075813,La casa del pelícano,1978,Fewer than 50,15,2,0,1,,,,0,0,0,0,,
1342,tt0088868,Bâton Rouge,1985,50+,50,3,1,0,,,,1,1,0,1,,
1343,tt0262571,Life Without Dick,2002,"1,000+",2103,29,90,47,2.4,24.0,,2,1,1,2,,
1344,tt0989000,In Search of a Midnight Kiss,2007,"2,500+",4171,1017,265,538,3.8,79.0,,65,55,10,65,7.00,85.0
1345,tt0100065,Love at Large,1990,500+,672,17,22,8,3.2,44.0,,9,7,2,9,5.60,78.0
1346,tt0302361,Bookies,2003,"1,000+",2026,102,102,61,3.3,50.0,,6,4,2,6,6.20,67.0
1347,tt0067327,The Last Movie,1971,500+,747,49,44,31,3.2,53.0,,16,8,8,16,6.00,50.0
1348,tt0325233,Dekada '70,2002,100+,131,22,3,5,4.2,88.0,,0,0,0,0,,
1349,tt0082796,Naram Garam,1981,Fewer than 50,1,1,0,0,,,,0,0,0,0,,
1350,tt0463939,Chellame,2004,0,0,0,0,0,,,,0,0,0,0,,
1351,tt1200852,Street Racer,2008,500+,551,25,74,42,2.3,26.0,,0,0,0,0,,
1352,tt1542411,Budrus,2009,100+,249,68,7,28,4.3,91.0,,25,22,3,25,7.40,88.0
1353,tt0071448,Dunderklumpen!,1974,500+,560,115,16,42,4.4,88.0,,0,0,0,0,,
1354,tt0119338,Hurricane,1997,500+,801,76,22,27,3.9,78.0,,16,14,2,16,7.00,88.0
1355,tt0356487,Whisky Romeo Zulu,2004,250+,411,46,14,12,3.9,77.0,,0,0,0,0,,
1356,tt0070222,Invasion of the Bee Girls,1973,"1,000+",1570,38,79,50,2.7,32.0,,9,4,5,9,5.20,44.0
1357,tt0070637,Saudagar,1973,Fewer than 50,9,3,0,0,,,,0,0,0,0,,
1358,tt0119237,Gummo,1997,"10,000+",22316,3847,1436,1894,3.8,73.0,,58,22,36,58,6.00,38.0
1359,tt0057396,Palm Springs Weekend,1963,50+,74,6,12,6,3,33.0,,1,0,1,1,,
1360,tt0059709,Shakespeare-Wallah,1965,100+,185,21,11,7,3.7,66.0,,9,8,1,9,6.70,89.0
1361,tt0070917,The Wicker Man,1973,"25,000+",43492,5929,1314,2846,4,82.0,,63,57,6,63,8.00,90.0
1362,tt0144557,Puddle Cruiser,1996,"2,500+",4327,176,249,189,3,41.0,,2,1,1,2,,
1363,tt1059980,Soccer Mom,2008,500+,807,89,107,58,3.1,46.0,,1,1,0,1,,
1364,tt0097116,Cousins,1989,"2,500+",3631,161,75,84,3.7,68.0,,9,5,4,9,6.00,56.0
1365,tt1183917,Teen Patti,2010,100+,229,15,55,40,2.3,21.0,,3,0,3,3,,
1366,tt0085267,Born in Flames,1983,250+,458,43,31,24,3.5,58.0,,32,28,4,32,6.80,88.0
1367,tt0075704,Audrey Rose,1977,"5,000+",7459,180,243,155,3.1,43.0,,21,12,9,21,5.80,57.0
1368,tt0233422,Chachi 420,1997,100+,200,21,13,1,3.6,62.0,,0,0,0,0,,
1369,tt0187004,Farishtay,1991,0,0,0,0,0,,,,0,0,0,0,,
1370,tt0265086,Black Hawk Down,2001,"250,000+",473526,54952,7524,18063,4.2,88.0,,175,134,41,175,7.00,77.0
1371,tt0052680,Cash McCall,1960,100+,118,20,21,11,3.3,49.0,,2,0,2,2,,
1372,tt0220969,All the King's Men,1999,100+,155,15,7,6,3.6,68.0,,2,1,1,2,,
1373,tt1235838,How I Got Lost,2009,100+,230,23,22,20,3.5,51.0,,1,0,1,1,,
1374,tt0293508,The Phantom of the Opera,2004,"250,000+",412326,41268,7695,26700,4.2,84.0,,169,56,113,169,5.00,33.0
1375,tt0265086,Black Hawk Down,2001,"250,000+",473526,54952,7524,18063,4.2,88.0,,175,134,41,175,7.00,77.0
1376,tt0293508,The Phantom of the Opera,2004,"250,000+",412326,41268,7695,26700,4.2,84.0,,169,56,113,169,5.00,33.0
1377,tt0092857,Death Wish 4: The Crackdown,1987,"5,000+",8124,253,379,206,3,40.0,,8,2,6,8,4.90,25.0
1378,tt0065903,Ishq Par Zor Nahin,1970,0,0,0,0,0,,,,0,0,0,0,,
1379,tt0089009,Defence of the Realm,1985,"1,000+",1066,61,28,36,3.7,69.0,,5,5,0,5,6.90,100.0
1380,tt0079176,French Postcards,1979,100+,184,14,7,7,3.5,67.0,,1,1,0,1,,
1381,tt1860353,Turbo,2013,"50,000+",89866,16355,8695,1969,3.7,65.0,,115,77,38,115,6.10,67.0
1382,tt0095053,El Dorado,1988,Fewer than 50,24,1,3,0,,,,2,1,1,2,,
1383,tt0845046,Son of Rambow,2007,"50,000+",62660,6580,1699,4187,3.8,80.0,,121,89,32,121,6.80,74.0
1384,tt0116650,Irma Vep,1996,"2,500+",3026,369,153,141,3.6,71.0,,47,44,3,47,7.40,94.0
1385,tt2109184,Paranormal Activity 4,2012,"100,000+",118158,7606,14571,3361,2.8,34.0,,113,26,87,113,4.20,23.0
1386,tt0417010,Nenunnanu,2004,50+,64,0,5,0,2.5,0.0,,0,0,0,0,,
1387,tt0385928,Panchatanthiram,2002,Fewer than 50,1,1,0,0,,,,0,0,0,0,,
1388,tt0318338,Avunu Valliddaru Ishtapaddaru,2002,0,0,0,0,0,,,,0,0,0,0,,
1389,tt0433363,Deadly Skies,2006,"1,000+",1244,10,23,17,2.6,30.0,,0,0,0,0,,
1390,tt0336669,Jologs,2002,50+,79,10,1,7,4.2,91.0,,0,0,0,0,,
1391,tt0079858,Scavenger Hunt,1979,500+,912,123,42,64,3.8,75.0,,2,0,2,2,,
1392,tt0119279,Bleeders,1997,250+,365,19,43,23,2.6,31.0,,3,0,3,3,,
1393,tt0116956,Magenta,1997,100+,126,1,4,2,2.6,20.0,,0,0,0,0,,
1394,tt0237682,Sadayam,1992,0,0,0,0,0,,,,1,1,0,1,,
1395,tt1079980,Death in Love,2008,"10,000+",10948,38,74,41,2.6,33.0,,20,9,11,20,5.00,45.0
1396,tt0235158,Aanaval Mothiram,1990,0,0,0,0,0,,,,0,0,0,0,,
1397,tt0473738,Awakening,2006,Fewer than 50,1,1,0,0,,,,0,0,0,0,,
1398,tt1470171,Abandoned,2010,"1,000+",1252,136,484,193,2.5,22.0,,2,2,0,2,,
1399,tt0120146,Sleeping with the Devil,1997,100+,210,9,5,5,3.6,64.0,,0,0,0,0,,
1400,tt0311018,Disappearance,2002,500+,540,24,25,21,3.2,49.0,,3,2,1,3,,
1401,tt0091713,Behind Enemy Lines,1986,0,0,0,0,0,,,,0,0,0,0,,
1402,tt0777991,Pamahiin,2006,50+,81,4,2,5,3.7,67.0,,0,0,0,0,,
1403,tt0757858,Agent X44,2007,250+,331,13,1,4,4.5,93.0,,0,0,0,0,,
1404,tt0089504,Lost in America,1985,"2,500+",4365,513,155,200,3.8,77.0,,39,37,2,39,8.00,95.0
1405,tt0194519,We Married Margo,2000,100+,174,21,5,17,3.7,81.0,,0,0,0,0,,
1406,tt0113269,Haunted,1995,"5,000+",7294,211,204,159,3.3,51.0,,5,4,1,5,5.80,80.0
1407,tt0259974,Digimon: The Movie,2000,"10,000+",20915,1271,658,712,3.7,66.0,,41,10,31,41,4.10,24.0
1408,tt0075936,Desperate Living,1977,"5,000+",5090,603,152,278,4,80.0,,10,7,3,10,5.90,70.0
1409,tt1411656,Bhai Bhauja,1967,0,0,0,0,0,,,,0,0,0,0,,
1410,tt0196158,Ticker,2001,"2,500+",2938,43,196,63,2.2,18.0,,4,0,4,4,,
1411,tt1781896,The Scorpion King 3: Battle for Redemption,2012,"1,000+",1350,156,847,152,1.7,15.0,,4,2,2,4,,
1412,tt0060414,A Fine Madness,1966,250+,306,12,24,12,2.9,33.0,,6,2,4,6,4.60,33.0
1413,tt1710573,Jesse Stone: Innocents Lost,2011,100+,120,37,30,14,3.4,55.0,,0,0,0,0,,
1414,tt0324013,Soldier's Girl,2003,"2,500+",4532,697,100,247,4.2,87.0,,8,7,1,8,6.40,88.0
1415,tt0072195,Space Is the Place,1974,"1,000+",1035,113,35,63,3.9,76.0,,7,5,2,7,6.70,71.0
1416,tt0205735,Les amants criminels,1999,Fewer than 50,14,0,1,0,,,,0,0,0,0,,
1417,tt0497353,Fatal Desire,2006,Fewer than 50,3,1,2,1,,,,0,0,0,0,,
1418,tt0097179,DeepStar Six,1989,500+,583,76,220,99,2.7,26.0,,13,2,11,13,4.20,15.0
1419,tt0187333,Nam Naadu,1969,0,0,0,0,0,,,,0,0,0,0,,
1420,tt0097926,Mujrim,1989,Fewer than 50,1,1,0,0,,,,0,0,0,0,,
1421,tt1031212,Adam's Wall,2008,100+,116,8,8,6,3,50.0,,0,0,0,0,,
1422,tt0367921,Kahani Kismat Ki,1973,Fewer than 50,6,1,0,0,,,,0,0,0,0,,
1423,tt0063765,The Vengeance of She,1968,0,0,0,0,0,,,,4,0,4,4,,
1424,tt0356362,Anna and the King,2000,"50,000+",75189,2996,1672,1501,3.6,64.0,,100,52,48,100,5.90,52.0
1425,tt0366242,The Black Ninja,2003,100+,147,4,13,6,2.1,24.0,,0,0,0,0,,
1426,tt0497329,Behind Enemy Lines II: Axis of Evil,2006,"10,000+",17812,348,594,365,2.8,37.0,,5,0,5,5,3.40,0.0
1427,tt0450238,The All Together,2007,500+,631,34,130,79,2.3,21.0,,10,0,10,10,2.30,0.0
1428,tt0263687,Mahamantri Timmarasu,1962,0,0,0,0,0,,,,0,0,0,0,,
1429,tt0420251,Three Extremes,2004,"2,500+",3766,2012,637,1007,3.8,76.0,,63,54,9,63,6.80,86.0
1430,tt0113135,Future War,1997,"1,000+",1228,31,144,94,1.5,18.0,,0,0,0,0,,
1431,tt0163745,The Debut,2000,"1,000+",1278,135,50,90,3.8,73.0,,24,17,7,24,6.30,71.0
1432,tt0082083,Blood Beach,1980,500+,974,32,99,69,2.5,24.0,,8,1,7,8,2.80,13.0
1433,tt0118851,Chinese Box,1997,"2,500+",2730,143,124,53,3.3,54.0,,22,14,8,22,6.50,64.0
1434,tt0102034,Highlander II: The Quickening,1991,"50,000+",53086,622,2136,1287,2.2,23.0,,25,0,25,25,3.00,0.0
1435,tt1959468,Manikyakallu,2011,Fewer than 50,8,2,1,1,,,,0,0,0,0,,
1436,tt0078324,Stony Island,1978,Fewer than 50,36,2,3,1,3.3,40.0,,4,4,0,4,,
1437,tt1264907,Sea Point Days,2008,0,0,0,0,0,,,,0,0,0,0,,
1438,tt1957945,La Luna,2011,250+,317,246,34,47,4.1,88.0,,1,1,0,1,,
1439,tt0493437,Apna Sapna Money Money,2006,"1,000+",1341,72,56,50,3.4,56.0,,1,0,1,1,,
1440,tt0181151,What Planet Are You From?,2000,"5,000+",5991,136,342,121,2.6,29.0,,77,32,45,77,5.00,42.0
1441,tt1247703,Welcome to Macintosh,2008,500+,583,64,68,58,3.2,48.0,,0,0,0,0,,
1442,tt0303267,El último tren,2002,"1,000+",1442,25,10,7,3.8,71.0,,0,0,0,0,,
1443,tt1967697,White Frog,2012,250+,365,102,45,22,3.9,69.0,,2,0,2,2,,
1444,tt0112527,Blood & Donuts,1995,"1,000+",1541,78,57,49,3.4,58.0,,2,0,2,2,,
1445,tt0250739,Sister Mary Explains It All,2001,100+,145,9,11,9,3.3,45.0,,2,1,1,2,,
1446,tt0148353,Jeene Ki Raah,1969,Fewer than 50,26,1,0,0,,,,0,0,0,0,,
1447,tt0404082,The Grizzly & the Treasure,1975,Fewer than 50,6,1,0,0,,,,0,0,0,0,,
1448,tt0374506,Arisan!,2003,250+,487,78,9,49,4.1,90.0,,0,0,0,0,,
1449,tt0073293,Lies My Father Told Me,1975,100+,170,17,3,5,4,85.0,,3,2,1,3,,
1450,tt0381187,Fist Power,2002,50+,91,5,4,4,3.3,56.0,,0,0,0,0,,
1451,tt0119832,One Night Stand,1997,"2,500+",4576,137,214,73,3,39.0,,32,11,21,32,5.10,34.0
1452,tt0119881,Perfect Body,1997,500+,587,73,38,26,3.8,66.0,,0,0,0,0,,
1453,tt0416041,River's End,2005,500+,744,22,13,13,3.4,63.0,,0,0,0,0,,
1454,tt1023490,Il divo,2008,"2,500+",4478,1238,304,456,3.9,80.0,,51,47,4,51,7.50,92.0
1455,tt0067109,Fools' Parade,1971,100+,125,15,10,6,3.3,60.0,,2,1,1,2,,
1456,tt1032747,The Butterfly Tattoo,2009,250+,389,16,22,13,3.1,42.0,,2,0,2,2,,
1457,tt0085332,Choices of the Heart,1983,Fewer than 50,40,0,2,1,,,,0,0,0,0,,
1458,tt1051844,Mapado 2,2007,Fewer than 50,42,0,2,0,,,,0,0,0,0,,
1459,tt0464154,Piranha 3D,2010,"10,000+",22634,1483,5191,1257,2.2,22.0,,53,6,47,53,3.40,11.0
1460,tt1730294,For the Love of Money,2012,"1,000+",1326,39,39,20,3.2,50.0,,7,0,7,7,3.50,0.0
1461,tt1505145,The War on Kids,2009,50+,83,2,2,2,,,,9,2,7,9,3.80,22.0
1462,tt0113926,Naked Souls,1996,100+,187,3,18,5,2.2,15.0,,1,0,1,1,,
1463,tt0421229,Mrs Palfrey at the Claremont,2005,"2,500+",3853,410,90,247,4,82.0,,60,42,18,60,6.40,70.0
1464,tt1937092,Always Kabhi Kabhi,2011,100+,169,7,18,8,2.4,28.0,,2,0,2,2,,
1465,tt0084776,Tempest,1982,500+,782,125,47,47,3.9,73.0,,11,6,5,11,5.90,55.0
1466,tt0087197,Electric Dreams,1984,"2,500+",4205,384,158,238,3.8,71.0,,19,9,10,19,5.60,47.0
1467,tt0472268,The Flying Scotsman,2006,"50,000+",83869,885,851,460,3.2,51.0,,54,27,27,54,5.50,50.0
1468,tt0136352,Koyla,1997,"1,000+",2088,113,91,52,3.3,55.0,,0,0,0,0,,
1469,tt0126019,Scobie Malone,1975,0,0,0,0,0,,,,0,0,0,0,,
1470,tt1386703,Total Recall,2012,"100,000+",116991,23147,25893,7425,3.2,47.0,,239,73,166,239,5.00,31.0
1471,tt0080031,Tom Horn,1980,"2,500+",2927,159,69,82,3.6,70.0,,7,5,2,7,6.50,71.0
1472,tt0383929,Black August,2007,250+,258,24,8,12,4,75.0,,2,2,0,2,,
1473,tt1492842,Forgetting the Girl,2012,100+,210,48,33,21,3.6,59.0,,8,6,2,8,6.40,75.0
1474,tt8883402,Bhole Shankar,2008,0,0,0,0,0,,,,0,0,0,0,,
1475,tt0129924,FernGully 2: The Magical Rescue,1998,"10,000+",10404,60,121,96,2.6,33.0,,1,1,0,1,,
1476,tt1610435,Shadowboxing,2010,0,0,0,0,0,,,,0,0,0,0,,
1477,tt0079446,Latitude 55°,1982,0,0,0,0,0,,,,0,0,0,0,,
1478,tt1104126,Shifty,2008,500+,998,246,121,129,3.5,67.0,,27,26,1,27,7.00,96.0
1479,tt0195945,Next Friday,2000,"100,000+",181695,9342,2940,3021,4,76.0,,66,14,52,66,4.10,21.0
1480,tt0263915,Raktha Sambandham,1962,0,0,0,0,0,,,,0,0,0,0,,
1481,tt0087958,Pyar Jhukta Nahin,1985,0,0,0,0,0,,,,0,0,0,0,,
1482,tt0088379,The Warrior and the Sorceress,1984,100+,112,9,24,17,2.6,27.0,,4,0,4,4,,
1483,tt0106912,Fire in the Sky,1993,"10,000+",20837,1109,840,777,3.4,57.0,,24,12,12,24,5.20,50.0
1484,tt0062739,The Bliss of Mrs. Blossom,1968,Fewer than 50,37,5,6,5,3.1,45.0,,2,2,0,2,,
1485,tt0175568,Divine Waters,1985,0,0,0,0,0,,,,0,0,0,0,,
1486,tt0156146,Tycus,1999,500+,894,6,17,12,2.6,26.0,,0,0,0,0,,
1487,tt0265171,Elvira's Haunted Hills,2001,"2,500+",4284,132,157,116,3.2,45.0,,13,9,4,13,5.90,69.0
1488,tt0246103,Naagu,1984,0,0,0,0,0,,,,0,0,0,0,,
1489,tt0079593,Murder by Natural Causes,1979,Fewer than 50,26,9,0,5,4.7,100.0,,0,0,0,0,,
1490,tt0345043,Chura Liyaa Hai Tumne,2003,0,0,0,0,0,,,,0,0,0,0,,
1491,tt0444182,Days of Glory,2006,"10,000+",10330,1413,367,718,3.8,79.0,,88,73,15,88,7.20,83.0
1492,tt0377994,Gramaphone,2003,0,0,0,0,0,,,,0,0,0,0,,
1493,tt1175292,The Imposter,2008,Fewer than 50,33,6,10,7,3.1,38.0,,0,0,0,0,,
1494,tt1323807,Trade In,2009,0,0,0,0,0,,,,0,0,0,0,,
1495,tt0055593,Very Important Person,1961,50+,59,17,9,11,3.6,65.0,,1,0,1,1,,
1496,tt0387563,Saving 'Star Wars',2004,Fewer than 50,3,3,0,2,,,,0,0,0,0,,
1497,tt1031225,The Cool School,2008,500+,514,31,18,17,3.6,63.0,,26,24,2,26,7.00,92.0
1498,tt0058091,Fate Is the Hunter,1964,Fewer than 50,24,8,5,6,3.6,62.0,,5,2,3,5,5.60,40.0
1499,tt0118163,The Whole Wide World,1996,"2,500+",2897,197,73,124,3.8,73.0,,17,13,4,17,7.00,76.0
1500,tt0080130,When a Stranger Calls,1979,"25,000+",32270,640,676,776,3.2,49.0,,16,6,10,16,5.00,38.0
1501,tt0064606,The Love God?,1969,250+,367,37,27,29,3.5,58.0,,1,0,1,1,,
1502,tt0058649,The Third Secret,1964,100+,101,6,8,4,3.3,43.0,,0,0,0,0,,
1503,tt0119336,Hurlyburly,1998,"5,000+",5974,402,215,175,3.6,65.0,,38,22,16,38,5.90,58.0
1504,tt0118673,Bade Miyan Chote Miyan,1998,0,0,0,0,0,,,,0,0,0,0,,
1505,tt0057688,Wives and Lovers,1963,0,0,0,0,0,,,,0,0,0,0,,
1506,tt0079576,More American Graffiti,1979,"2,500+",3955,117,239,115,2.8,33.0,,10,2,8,10,4.20,20.0
1507,tt0329354,Marigold,2007,"1,000+",1230,94,140,106,2.9,40.0,,27,8,19,27,4.70,30.0
1508,tt0078062,The Clonus Horror,1979,0,0,0,0,0,,,,0,0,0,0,,
1509,tt1576699,Mirrors 2,2010,"1,000+",1800,190,757,308,2.4,20.0,,4,1,3,4,,
1510,tt0243639,Veerta,1993,0,0,0,0,0,,,,0,0,0,0,,
1511,tt0218839,Best in Show,2000,"50,000+",56625,9762,1277,3498,4.1,88.0,,116,108,8,116,7.50,93.0
1512,tt0244776,Satyakam,1969,Fewer than 50,1,1,0,0,,,,0,0,0,0,,
1513,tt0233469,Collateral Damage,2002,"50,000+",79931,1156,3195,1226,2.7,27.0,,142,27,115,142,4.00,19.0
1514,tt1258187,Universalove,2008,50+,66,2,2,2,,,,0,0,0,0,,
1515,tt1013753,Milk,2008,"100,000+",178203,27875,3481,11668,4.1,89.0,,245,227,18,245,8.00,93.0
1516,tt0790799,$9.99,2008,"5,000+",5344,277,225,147,3.3,55.0,,54,39,15,54,6.50,72.0
1517,tt1152758,Dear Zachary: A Letter to a Son About His Father,2008,"5,000+",7222,3392,154,1068,4.5,96.0,,51,48,3,51,8.10,94.0
1518,tt1190858,Amreeka,2009,"2,500+",3198,594,192,264,3.7,76.0,,72,63,9,72,6.90,88.0
1519,tt1764508,Na Wewe,2010,Fewer than 50,43,12,5,6,3.5,71.0,,0,0,0,0,,
1520,tt0119031,Dying to Belong,1997,250+,493,33,60,27,2.8,35.0,,0,0,0,0,,
1521,tt0099935,Killer Tomatoes Strike Back!,1991,"2,500+",2750,36,84,55,2.7,30.0,,0,0,0,0,,
1522,tt0118367,Kangaroo Palace,1997,0,0,0,0,0,,,,0,0,0,0,,
1523,tt0275654,Sasneham,1990,0,0,0,0,0,,,,0,0,0,0,,
1524,tt0064601,Lost Flight,1970,Fewer than 50,1,1,0,1,,,,0,0,0,0,,
1525,tt1182350,You Will Meet a Tall Dark Stranger,2010,"10,000+",18925,1466,2902,1063,2.9,34.0,,138,62,76,138,5.40,45.0
1526,tt1553000,Homam,2008,0,0,0,0,0,,,,0,0,0,0,,
1527,tt0466771,"Puff, Puff, Pass",2006,"2,500+",3375,230,173,147,3.4,57.0,,2,0,2,2,,
1528,tt1001562,Witless Protection,2008,"10,000+",11428,706,817,630,3,46.0,,28,1,27,28,2.60,4.0
1529,tt4205128,Staying Alive,2015,Fewer than 50,5,2,1,2,,,,0,0,0,0,,
1530,tt0365519,Motives,2004,"2,500+",4057,270,59,141,4.2,82.0,,0,0,0,0,,
1531,tt0126344,I Went Down,1997,500+,758,113,18,56,4.2,86.0,,19,16,3,19,7.20,84.0
1532,tt0293342,Lajja,2001,"1,000+",1028,77,42,28,3.6,65.0,,0,0,0,0,,
1533,tt0062909,Dracula Has Risen from the Grave,1968,"2,500+",4328,295,192,180,3.4,60.0,,15,12,3,15,6.80,80.0
1534,tt0077275,The Brink's Job,1978,250+,349,53,41,23,3.5,56.0,,9,7,2,9,7.00,78.0
1535,tt0271732,The Pretender 2001,2001,100+,236,28,7,15,3.9,80.0,,0,0,0,0,,
1536,tt0131432,How I Spent My Summer Vacation,1997,Fewer than 50,30,2,1,0,,,,0,0,0,0,,
1537,tt0092571,Anne of Green Gables: The Sequel,1987,Fewer than 50,2,2,0,0,,,,0,0,0,0,,
1538,tt0092690,Born in East L.A.,1987,"5,000+",9834,420,267,258,3.6,61.0,,10,4,6,10,5.00,40.0
1539,tt0368725,The Fever,2004,500+,529,39,27,11,3.5,59.0,,0,0,0,0,,
1540,tt0977636,Aarya,2007,250+,255,40,6,8,4.2,87.0,,0,0,0,0,,
1541,tt0100491,Riff-Raff,1991,500+,984,207,43,47,3.8,83.0,,10,9,1,10,7.50,90.0
1542,tt0105481,Straight Talk,1992,"5,000+",7116,207,147,144,3.6,58.0,,13,6,7,13,5.20,46.0
1543,tt0154462,Edhir Neechal,1968,0,0,0,0,0,,,,0,0,0,0,,
1544,tt1353997,Dragon Quest,2009,100+,200,4,63,31,1.6,6.0,,0,0,0,0,,
1545,tt0109501,Cries from the Heart,1994,0,0,0,0,0,,,,0,0,0,0,,
1546,tt1615075,Suing the Devil,2011,250+,335,63,98,81,2.6,39.0,,1,0,1,1,,
1547,tt0055992,Follow That Dream,1962,"2,500+",4727,103,57,87,3.7,64.0,,3,3,0,3,,
1548,tt0064381,"Goodbye, Columbus",1969,"1,000+",1119,42,42,28,3.3,50.0,,12,11,1,12,7.10,92.0
1549,tt0150417,Dulhan Wahi Jo Piya Man Bhaaye,1977,0,0,0,0,0,,,,0,0,0,0,,
1550,tt0790723,Just Add Water,2008,"1,000+",1967,131,313,179,2.8,29.0,,2,0,2,2,,
1551,tt0406650,The Chumscrubber,2005,"25,000+",39541,3162,1033,1836,3.8,75.0,,60,22,38,60,5.00,37.0
1552,tt1540128,Playing for Keeps,2012,"10,000+",20534,2920,4212,636,3,41.0,,92,5,87,92,3.60,5.0
1553,tt0067421,Mere Apne,1971,Fewer than 50,34,3,1,1,,,,0,0,0,0,,
1554,tt0860454,MP3: Mera Pehla Pehla Pyaar,2007,500+,582,110,28,45,4,80.0,,1,0,1,1,,
1555,tt1257562,Hadewijch,2009,"1,000+",1103,77,71,25,3.3,52.0,,33,24,9,33,6.50,73.0
1556,tt0860454,MP3: Mera Pehla Pehla Pyaar,2007,500+,582,110,28,45,4,80.0,,1,0,1,1,,
1557,tt0192080,"The Good, the Bad, and Huckleberry Hound",1988,0,0,0,0,0,,,,0,0,0,0,,
1558,tt2057441,Mujhse Fraaandship Karoge,2011,100+,119,40,31,17,3.4,56.0,,1,1,0,1,,
1559,tt0486615,London Dreams,2009,500+,859,83,126,83,3,40.0,,4,1,3,4,,
1560,tt0098261,Scenes from the Class Struggle in Beverly Hills,1989,500+,766,27,17,13,3.6,61.0,,9,7,2,9,6.30,78.0
1561,tt1314228,Did You Hear About the Morgans?,2009,"250,000+",387663,3371,8909,3502,2.6,27.0,,122,15,107,122,3.60,12.0
1562,tt1748179,Red Lights,2012,"10,000+",11407,1802,3190,880,3,36.0,,94,29,65,94,4.90,31.0
1563,tt1220634,Resident Evil: Afterlife,2010,"100,000+",128561,12711,13598,7648,3.2,48.0,,108,23,85,108,4.10,21.0
1564,tt0117666,Sling Blade,1996,"50,000+",56205,7811,639,2749,4.3,92.0,,58,56,2,58,8.40,97.0
1565,tt0094631,Alien Nation,1988,"10,000+",15937,432,561,312,3.2,44.0,,32,17,15,32,5.40,53.0
1566,tt0366985,Rudraksh,2004,100+,168,5,9,1,2.2,38.0,,0,0,0,0,,
1567,tt0079417,Kramer mot Kramer,1979,"25,000+",43628,7104,879,1953,4.1,89.0,,101,90,11,101,8.20,89.0
1568,tt0495747,The Quick and the Undead,2006,500+,823,10,91,69,1.9,10.0,,1,0,1,1,,
1569,tt0175142,Scary Movie,2000,"250,000+",32582014,44031,58134,1097842,3,43.0,,117,60,57,117,5.50,51.0
1570,tt1956516,How to Start a Revolution,2011,100+,224,11,7,3,3.6,61.0,,3,1,2,3,,
1571,tt0102045,The Hitman,1991,"5,000+",5290,128,165,114,3.1,44.0,,8,1,7,8,3.10,13.0
1572,tt0151568,Topsy-Turvy,1999,"5,000+",5654,621,166,231,3.9,79.0,,89,80,9,89,7.80,90.0
1573,tt0218094,Cheaters,2000,500+,562,90,60,39,3.4,60.0,,5,4,1,5,6.60,80.0
1574,tt0115668,Bhishma,1996,0,0,0,0,0,,,,0,0,0,0,,
1575,tt0402348,Love's Enduring Promise,2004,"5,000+",8989,1006,160,397,4.3,86.0,,3,3,0,3,,
1576,tt0098253,Santa Sangre,1989,"5,000+",7580,1605,246,535,4.2,87.0,,43,37,6,43,7.40,86.0
1577,tt1246588,Loot,2008,Fewer than 50,26,0,12,2,1.7,0.0,,0,0,0,0,,
1578,tt0257818,The Jolly Boys' Last Stand,2000,100+,104,3,4,3,3.2,43.0,,1,1,0,1,,
1579,tt0452623,Gone Baby Gone,2007,"100,000+",210189,39528,6401,18919,4,86.0,,183,172,11,183,7.80,94.0
1580,tt0452623,Gone Baby Gone,2007,"100,000+",210189,39528,6401,18919,4,86.0,,183,172,11,183,7.80,94.0
1581,tt0089383,Joshua Then and Now,1985,250+,432,15,11,9,3.7,58.0,,3,2,1,3,,
1582,tt1119188,Little Zizou,2008,100+,149,16,16,14,3.3,50.0,,2,2,0,2,,
1583,tt0103785,Bed of Lies,1992,0,0,0,0,0,,,,0,0,0,0,,
1584,tt0076786,Suspiria,1977,"25,000+",36635,6945,1444,3080,4,83.0,,65,61,4,65,8.40,94.0
1585,tt0453365,FC Venus,2005,"1,000+",2187,150,189,73,3.1,45.0,,1,1,0,1,,
1586,tt0430651,Survive Style 5+,2004,"5,000+",6714,1205,95,540,4.4,93.0,,0,0,0,0,,
1587,tt0115814,Camping Cosmos,1996,100+,170,4,8,2,2.6,33.0,,0,0,0,0,,
1588,tt0272440,According to Spencer,2001,250+,286,9,32,10,2.6,22.0,,1,0,1,1,,
1589,tt0453150,Mazhai,2005,0,0,0,0,0,,,,0,0,0,0,,
1590,tt1286784,Dossier K.,2009,250+,260,52,40,22,3.4,57.0,,0,0,0,0,,
1591,tt1260567,Dark House,2009,250+,351,43,168,72,2.4,20.0,,5,2,3,5,4.40,40.0
1592,tt0270430,In His Life: The John Lennon Story,2000,500+,857,42,26,31,3.5,62.0,,0,0,0,0,,
1593,tt0099978,Laser Mission,1989,500+,923,42,131,70,2.3,24.0,,2,0,2,2,,
1594,tt0090259,El viaje a ninguna parte,1986,0,0,0,0,0,,,,2,2,0,2,,
1595,tt1235796,Ondine,2009,"10,000+",20559,1817,1205,711,3.4,60.0,,104,73,31,104,6.40,70.0
1596,tt0436607,The Motel,2005,"2,500+",4040,331,184,235,3.6,64.0,,32,28,4,32,7.00,88.0
1597,tt0096913,Best of the Best,1989,Fewer than 50,17,4,4,1,3.1,50.0,,0,0,0,0,,
1598,tt1578116,Atithi Tum Kab Jaoge?,2010,250+,457,72,108,66,3,40.0,,1,0,1,1,,
1599,tt0387237,G.I. Joe: Spy Troops the Movie,2003,500+,536,23,17,9,3.3,58.0,,0,0,0,0,,
1600,tt0120900,The Real Howard Spitz,1998,Fewer than 50,20,3,3,1,3.5,50.0,,2,0,2,2,,
1601,tt1186830,Agora,2009,"10,000+",21986,3339,1817,1355,3.5,65.0,,95,53,42,95,5.80,56.0
1602,tt0459186,Azhagi,2002,50+,69,3,5,1,3.2,38.0,,0,0,0,0,,
1603,tt0084293,Making Love,1982,"1,000+",1664,91,68,68,3.4,57.0,,25,14,11,25,4.90,56.0
1604,tt1969099,My Ex 2: Haunted Lover,2010,0,0,0,0,0,,,,0,0,0,0,,
1605,tt0140412,Nammavar,1994,Fewer than 50,1,1,0,0,,,,0,0,0,0,,
1606,tt0316768,Tiptoes,2002,"2,500+",3308,108,370,205,2.3,23.0,,10,2,8,10,4.00,20.0
1607,tt0101095,Fantaghirò,1991,0,0,0,0,0,,,,0,0,0,0,,
1608,tt0066476,The Touch of Satan,1971,500+,766,25,94,65,1.9,21.0,,1,0,1,1,,
1609,tt0131436,I Got the Hook Up,1998,"5,000+",7339,218,125,115,3.6,64.0,,12,2,10,12,3.30,17.0
1610,tt0279709,Budget Padmanabham,2001,0,0,0,0,0,,,,0,0,0,0,,
1611,tt1150947,"Lovely, Still",2008,"1,000+",1628,258,86,102,3.8,75.0,,22,16,6,22,5.60,73.0
1612,tt1587707,Exit Through the Gift Shop,2010,"10,000+",24763,10889,1041,2665,4.2,91.0,,116,111,5,116,8.10,96.0
1613,tt1551631,Prem Amar,2009,0,0,0,0,0,,,,0,0,0,0,,
1614,tt0120741,Jane Austen's Mafia!,1998,"10,000+",12066,565,626,386,3.1,47.0,,42,6,36,42,4.10,14.0
1615,tt0120741,Mafia!,1998,0,0,0,0,0,,,,0,0,0,0,,
1616,tt0254199,CQ,2001,"5,000+",5235,397,179,191,3.6,69.0,,76,50,26,76,6.10,66.0
1617,tt0067580,Pink Narcissus,1971,100+,230,31,11,7,3.8,74.0,,4,2,2,4,,
1618,tt0324133,Swimming Pool,2003,"25,000+",29917,2979,1470,1167,3.5,67.0,,155,129,26,155,7.00,83.0
1619,tt0110068,How the West Was Fun,1994,"1,000+",1477,103,83,42,3.5,55.0,,1,0,1,1,,
1620,tt0155468,Aararo Aariraro,1989,0,0,0,0,0,,,,0,0,0,0,,
1621,tt1587676,Gandha,2009,0,0,0,0,0,,,,0,0,0,0,,
1622,tt0056057,The Happy Thieves,1961,50+,63,2,7,2,2.7,22.0,,0,0,0,0,,
1623,tt0061217,Zontar: The Thing from Venus,1967,50+,58,5,19,10,2.2,21.0,,2,1,1,2,,
1624,tt1440749,Laughology,2009,Fewer than 50,25,3,2,1,3.5,60.0,,0,0,0,0,,
1625,tt0095107,Ernest Saves Christmas,1988,"25,000+",48257,610,826,766,3.1,42.0,,14,5,9,14,4.90,36.0
1626,tt0447166,The Gamers: Dorkness Rising,2008,"1,000+",1005,250,62,141,3.9,80.0,,0,0,0,0,,
1627,tt0067017,Dracula vs. Frankenstein,1971,"2,500+",3311,25,74,48,2.3,25.0,,5,0,5,5,3.00,0.0
1628,tt0843383,Twilight Dancers,2006,250+,371,2,0,1,,,,2,0,2,2,,
1629,tt0969322,Reign of the Gargoyles,2007,250+,304,8,33,16,2.1,20.0,,0,0,0,0,,
1630,tt0061194,Wild Wild Winter,1966,0,0,0,0,0,,,,0,0,0,0,,
1631,tt0090728,Big Trouble in Little China,1986,"100,000+",136803,12922,2764,6075,4,82.0,,66,49,17,66,6.50,74.0
1632,tt0090728,Big Trouble in Little China,1986,"100,000+",136803,12922,2764,6075,4,82.0,,66,49,17,66,6.50,74.0
1633,tt0125031,Cannibal Campout,1988,100+,140,7,18,7,2.4,28.0,,2,0,2,2,,
1634,tt1324999,The Twilight Saga: Breaking Dawn - Part 1,2011,"100,000+",187091,39820,26649,8913,3.5,60.0,,212,53,159,212,4.40,25.0
1635,tt0197626,Lick the Star,1998,Fewer than 50,1,1,0,0,,,,0,0,0,0,,
1636,tt0246740,Kora Kagaz,1974,50+,70,3,1,1,,,,0,0,0,0,,
1637,tt0297120,Firestarter: Rekindled,2002,"2,500+",2854,78,126,91,2.8,38.0,,4,3,1,4,,
1638,tt0290654,Hollywood Hong Kong,2001,500+,627,97,23,23,3.8,81.0,,0,0,0,0,,
1639,tt0246198,Rikshavodu,1995,0,0,0,0,0,,,,0,0,0,0,,
1640,tt0259579,Sri Madvirat Veera Brahmendra Swamy Charitra,1984,0,0,0,0,0,,,,0,0,0,0,,
1641,tt0104779,Bitter Moon,1992,"5,000+",9374,1903,463,473,4,80.0,,35,22,13,35,6.20,63.0
1642,tt1144824,Volcanic Sprint,2007,0,0,0,0,0,,,,0,0,0,0,,
1643,tt0170107,History Is Made at Night,1999,100+,167,8,6,2,3.6,57.0,,4,0,4,4,,
1644,tt0308644,Finding Neverland,2004,"250,000+",465560,40370,6137,19216,4.1,87.0,,206,170,36,206,7.50,83.0
1645,tt0308644,Finding Neverland,2004,"250,000+",465560,40370,6137,19216,4.1,87.0,,206,170,36,206,7.50,83.0
1646,tt0359750,Ninne Pelladatha,1996,0,0,0,0,0,,,,0,0,0,0,,
1647,tt1008010,The Narrows,2008,250+,499,70,84,54,3.2,46.0,,12,3,9,12,4.30,25.0
1648,tt0463650,Pandippada,2005,0,0,0,0,0,,,,0,0,0,0,,
1649,tt2359640,Aai,2004,Fewer than 50,36,1,2,0,,,,0,0,0,0,,
1650,tt0177721,Double Platinum,1999,"1,000+",1817,129,27,54,4.3,83.0,,3,1,2,3,,
1651,tt0082431,Galaxy of Terror,1981,"1,000+",1111,109,272,158,2.7,28.0,,14,4,10,14,4.50,29.0
1652,tt1413496,Revenge of the Electric Car,2011,"1,000+",1296,223,97,55,3.6,70.0,,42,29,13,42,6.00,69.0
1653,tt0189340,Against the Law,1997,Fewer than 50,12,1,1,0,,,,0,0,0,0,,
1654,tt0221563,Sorted,2000,500+,642,65,28,23,3.8,70.0,,4,2,2,4,,
1655,tt0079963,Suhaag,1979,0,0,0,0,0,,,,0,0,0,0,,
1656,tt0099250,Chicago Joe and the Showgirl,1990,500+,527,6,11,6,2.7,35.0,,4,1,3,4,,
1657,tt1645186,The Truth Below,2011,Fewer than 50,1,1,0,1,,,,0,0,0,0,,
1658,tt0091886,Salvador,1986,"5,000+",8574,1296,220,415,4,86.0,,0,0,0,0,,
1659,tt0107413,Life with Mikey,1993,"5,000+",8859,204,313,152,3.1,39.0,,12,3,9,12,4.00,25.0
1660,tt0088047,Scarred,1983,Fewer than 50,35,2,0,1,,,,0,0,0,0,,
1661,tt0093239,I've Heard the Mermaids Singing,1987,"1,000+",1124,95,47,44,3.6,67.0,,16,15,1,16,7.20,94.0
1662,tt0391483,Take Out,2004,0,0,0,0,0,,,,0,0,0,0,,
1663,tt0102703,Prayer of the Rollerboys,1990,"2,500+",2668,153,85,89,3.7,64.0,,2,0,2,2,,
1664,tt1023500,Doghouse,2009,"2,500+",4420,698,836,621,3.1,46.0,,23,11,12,23,4.50,48.0
1665,tt0340331,School of Life,2005,"10,000+",12172,562,241,307,3.7,70.0,,2,1,1,2,,
1666,tt0405336,Southland Tales,2006,"25,000+",27091,3780,5385,5471,2.8,41.0,,106,43,63,106,4.90,41.0
1667,tt0070795,A Thief in the Night,1972,100+,139,24,21,18,2.9,53.0,,0,0,0,0,,
1668,tt0261983,Session 9,2001,"10,000+",24514,2914,1695,1817,3.5,63.0,,75,50,25,75,6.40,67.0
1669,tt0281102,Pyaar Tune Kya Kiya...,2001,250+,356,12,19,8,3.2,39.0,,0,0,0,0,,
1670,tt1653913,Helldriver,2010,250+,344,33,64,37,2.7,34.0,,2,2,0,2,,
1671,tt0448206,Bunty Aur Babli,2005,"5,000+",7844,565,173,257,3.9,77.0,,6,5,1,6,6.70,83.0
1672,tt0155776,Jawbreaker,1999,"50,000+",56651,2045,1687,1605,3.4,55.0,,64,9,55,64,3.60,14.0
1673,tt0053418,Vice Raid,1959,Fewer than 50,14,0,10,4,2.5,0.0,,2,0,2,2,,
1674,tt0118127,Wedding Bell Blues,1996,"1,000+",1125,9,10,4,3.3,47.0,,5,2,3,5,5.10,40.0
1675,tt0072325,Truck Turner,1974,"1,000+",1442,158,59,99,3.8,73.0,,5,3,2,5,5.70,60.0
1676,tt1417032,Amalfi: Rewards of the Goddess,2009,0,0,0,0,0,,,,0,0,0,0,,
1677,tt0100811,Transylvania Twist,1989,250+,363,22,24,15,3.1,48.0,,3,1,2,3,,
1678,tt0087480,Invitation to Hell,1984,250+,406,15,51,18,2.6,23.0,,3,1,2,3,,
1679,tt1054636,Pasakiligal,2006,0,0,0,0,0,,,,0,0,0,0,,
1680,tt0363226,Zatoichi,2003,"25,000+",39490,4929,653,1679,4.1,88.0,,126,109,17,126,7.20,87.0
1681,tt0054788,David og Goliath,1960,50+,84,9,10,8,2.8,47.0,,1,0,1,1,,
1682,tt0090073,Stick,1985,250+,387,30,51,24,2.9,37.0,,8,3,5,8,4.30,38.0
1683,tt0186566,Space Cowboys,2000,"50,000+",73038,2828,2507,1389,3.3,53.0,,122,95,27,122,6.70,78.0
1684,tt0236461,Maangamizi: The Ancient One,2001,Fewer than 50,1,1,0,1,,,,0,0,0,0,,
1685,tt1220633,Pastor Brown,2009,50+,81,10,9,3,3.6,53.0,,0,0,0,0,,
1686,tt0104309,Frozen Assets,1992,Fewer than 50,47,3,9,2,2.3,25.0,,9,0,9,9,3.50,0.0
1687,tt0910576,Swan Lake,1982,250+,488,75,5,34,4.4,94.0,,0,0,0,0,,
1688,tt0306719,Demon Under Glass,2002,100+,224,7,9,12,2.9,44.0,,0,0,0,0,,
1689,tt0349747,The Lost Prince,2003,500+,684,101,30,47,3.8,77.0,,7,5,2,7,,71.0
1690,tt0286421,Achanak,1998,Fewer than 50,42,1,0,0,,,,0,0,0,0,,
1691,tt1325734,Dustbin Baby,2008,100+,223,56,11,24,4,84.0,,0,0,0,0,,
1692,tt0758751,Grey Gardens,2009,"2,500+",4365,1303,357,561,3.9,78.0,,32,28,4,32,8.20,88.0
1693,tt0214832,Kalicharan,1976,0,0,0,0,0,,,,0,0,0,0,,
1694,tt0489237,The Nanny Diaries,2007,"100,000+",142318,12534,12219,8581,3.3,51.0,,132,45,87,132,5.00,34.0
1695,tt0055024,It Happened Here,1964,Fewer than 50,3,2,1,0,,,,7,5,2,7,7.00,71.0
1696,tt0119271,Heaven or Vegas,1998,50+,67,2,1,0,,,,2,0,2,2,,
1697,tt1434447,Rocket Singh: Salesman of the Year,2009,"1,000+",1561,339,164,180,3.5,67.0,,8,7,1,8,6.50,88.0
1698,tt0238924,The Dangerous Lives of Altar Boys,2002,"10,000+",16409,1764,478,673,3.9,79.0,,106,81,25,106,6.50,76.0
1699,tt0065492,Brewster McCloud,1970,"1,000+",1733,282,64,116,4,82.0,,22,19,3,22,7.30,86.0
1700,tt0297169,Holiday in the Sun,2001,"50,000+",54440,1031,844,700,3.4,55.0,,4,1,3,4,,
1701,tt0105415,Singles,1992,"10,000+",21782,2482,940,1025,3.8,73.0,,52,41,11,52,6.90,79.0
1702,tt0810444,The Pumpkin Karver,2006,50+,50,3,13,9,2,19.0,,2,0,2,2,,
1703,tt0365736,See Grace Fly,2003,250+,282,7,2,5,3.9,78.0,,0,0,0,0,,
1704,tt0076782,Summerfield,1977,Fewer than 50,1,0,1,0,,,,0,0,0,0,,
1705,tt0080915,Image of the Beast,1981,50+,68,7,7,6,3.3,50.0,,0,0,0,0,,
1706,tt0079261,Hair,1979,"25,000+",29978,3746,539,1283,4.3,87.0,,62,51,11,62,7.80,82.0
1707,tt2241676,Restless,2012,0,0,0,0,0,,,,0,0,0,0,,
1708,tt2132641,Coma,2012,0,0,0,0,0,,,,0,0,0,0,,
1709,tt0107277,Josh and S.A.M.,1993,"1,000+",1412,52,56,35,3.3,48.0,,8,2,6,8,4.80,25.0
1710,tt0067633,Punishment Park,1971,"2,500+",3004,514,81,234,4.1,86.0,,13,12,1,13,7.40,92.0
1711,tt0077660,Harper Valley P.T.A.,1978,250+,477,31,26,16,3.5,54.0,,1,0,1,1,,
1712,tt0124317,Clover,1997,Fewer than 50,1,1,0,0,,,,0,0,0,0,,
1713,tt0826547,Great World of Sound,2007,"1,000+",1643,225,89,160,3.6,72.0,,43,35,8,43,6.90,81.0
1714,tt0175423,Aap Ki Kasam,1974,100+,108,8,2,2,4.1,80.0,,0,0,0,0,,
1715,tt0289415,Recess Christmas: Miracle on Third Street,2001,50+,88,13,21,12,3.1,38.0,,3,1,2,3,,
1716,tt0059255,Harum Scarum,1965,"1,000+",2103,29,69,56,2.7,29.0,,1,0,1,1,,
1717,tt0115952,Cosmic Voyage,1996,500+,849,37,20,29,3.6,65.0,,0,0,0,0,,
1718,tt1327176,Claustrophobia,2011,0,0,0,0,0,,,,0,0,0,0,,
1719,tt0147582,The Tale of Sweeney Todd,1997,"1,000+",1096,25,43,24,3,37.0,,0,0,0,0,,
1720,tt0304267,Kedma,2002,250+,430,22,15,9,3.5,59.0,,12,4,8,12,4.80,33.0
1721,tt0098649,Wicked Stepmother,1989,250+,444,12,52,20,2.4,19.0,,1,0,1,1,,
1722,tt0243595,Kill Me Later,2001,"1,000+",1747,132,56,63,3.8,70.0,,19,5,14,19,4.30,26.0
1723,tt2180295,Apio Verde,2013,0,0,0,0,0,,,,0,0,0,0,,
1724,tt1602098,Albert Nobbs,2011,"5,000+",9885,1681,1852,741,3.2,48.0,,158,88,70,158,6.00,56.0
1725,tt0123948,Cure,1997,"5,000+",5607,751,140,240,4,84.0,,62,58,4,62,7.50,94.0
1726,tt0239509,Julie Johnson,2001,250+,388,26,27,14,3.1,50.0,,3,1,2,3,,
1727,tt1828224,La Leyenda de la Llorona,2011,100+,119,45,22,13,4,67.0,,1,1,0,1,,
1728,tt1103982,The Girlfriend Experience,2009,"25,000+",33150,1005,1871,1156,2.8,35.0,,140,94,46,140,6.40,67.0
1729,tt1305840,Aloo Chaat,2009,100+,174,17,21,15,3.2,45.0,,1,0,1,1,,
1730,tt1205535,The Rebound,2009,0,0,0,0,0,,,,0,0,0,0,,
1731,tt0105078,Out on a Limb,1992,500+,767,50,59,31,3.1,46.0,,5,1,4,5,4.10,20.0
1732,tt0117244,Once You Meet a Stranger,1996,0,0,0,0,0,,,,0,0,0,0,,
1733,tt0114887,A Walk in the Clouds,1995,"50,000+",62276,3582,1186,1798,3.9,75.0,,28,13,15,28,5.80,46.0
1734,tt0064338,The Castle of Fu Manchu,1969,250+,351,7,72,32,1.6,9.0,,1,0,1,1,,
1735,tt0105428,Sleepwalkers,1992,"25,000+",26708,481,1050,597,2.7,31.0,,17,5,12,17,4.40,29.0
1736,tt0365125,A Dirty Shame,2004,"10,000+",12564,905,865,797,3.2,51.0,,114,62,52,114,5.70,54.0
1737,tt0923600,Baghead,2008,"2,500+",3057,442,471,389,3.1,49.0,,100,79,21,100,6.60,79.0
1738,tt1020559,Patagonia,2010,Fewer than 50,32,5,7,5,3.1,42.0,,11,5,6,11,5.30,45.0
1739,tt0217756,Ready to Rumble,2000,"25,000+",33595,1044,965,888,3.3,52.0,,71,16,55,71,4.00,23.0
1740,tt0060647,Made in U.S.A,1966,"1,000+",1762,248,167,112,3.4,60.0,,20,17,3,20,7.60,85.0
1741,tt0064683,Mondo Trasho,1969,500+,559,61,55,25,3.3,53.0,,7,3,4,7,5.20,43.0
1742,tt0808164,Bas Ek Pal,2006,500+,721,14,29,12,2.9,33.0,,0,0,0,0,,
1743,tt0119210,Switchback,1997,"5,000+",7480,287,341,158,3.2,46.0,,26,8,18,26,4.80,31.0
1744,tt0054696,The Boy Who Stole a Million,1960,0,0,0,0,0,,,,0,0,0,0,,
1745,tt0433035,Real Steel,2011,"100,000+",212357,94191,34839,7874,3.9,73.0,,237,143,94,237,5.90,60.0
1746,tt0939669,The Third Wave,2007,50+,65,4,0,2,,,,1,1,0,1,,
1747,tt1079444,Dead Like Me: Life After Death,2009,"10,000+",21308,660,1103,804,2.9,38.0,,3,2,1,3,,
1748,tt1373156,Karthik Calling Karthik,2010,"1,000+",1247,207,206,182,3.2,50.0,,5,4,1,5,5.80,80.0
1749,tt0067787,Star Spangled Girl,1971,50+,52,5,3,5,3.4,62.0,,0,0,0,0,,
1750,tt0211946,Berlin Calling,2008,Fewer than 50,7,6,1,1,4.2,86.0,,0,0,0,0,,
1751,tt0097474,Halloween 5: The Revenge of Michael Myers,1989,"50,000+",66033,1903,3365,1742,2.9,36.0,,26,3,23,26,3.60,12.0
1752,tt0149171,Strays,1997,"1,000+",1765,127,157,123,3,45.0,,5,2,3,5,5.10,40.0
1753,tt2137064,Lanka,2011,0,0,0,0,0,,,,0,0,0,0,,
1754,tt0922591,Roxy Hunter and the Mystery of the Moody Ghost,2007,250+,266,21,9,14,3.9,70.0,,1,1,0,1,,
1755,tt0128977,The Bumblebee Flies Anyway,1999,"1,000+",1953,126,85,67,3.5,60.0,,4,1,3,4,,
1756,tt0361127,The Woodsman,2004,"10,000+",20998,2376,698,1166,3.7,77.0,,133,117,16,133,7.30,88.0
1757,tt1295068,Prodigal Sons,2008,250+,478,128,34,62,3.8,79.0,,30,26,4,30,7.50,87.0
1758,tt0127751,Recoil,1998,100+,173,5,10,7,2.9,33.0,,0,0,0,0,,
1759,tt0115906,Citizen Ruth,1996,"5,000+",5353,547,198,207,3.7,73.0,,26,21,5,26,6.80,81.0
1760,tt0111787,Yankee Zulu,1993,100+,123,19,14,10,3.6,58.0,,0,0,0,0,,
1761,tt0368774,The Heart Is Deceitful Above All Things,2004,"5,000+",9381,855,359,518,3.8,70.0,,51,22,29,51,4.90,43.0
1762,tt0254099,The Anniversary Party,2001,"5,000+",6458,443,330,217,3.4,57.0,,114,69,45,114,5.80,61.0
1763,tt1123372,Cicak-Man,2006,50+,97,4,4,2,2.9,57.0,,0,0,0,0,,
1764,tt0241243,Les bicyclettes de Belsize,1968,0,0,0,0,0,,,,0,0,0,0,,
1765,tt1172206,Somers Town,2008,"10,000+",19169,913,307,470,3.7,75.0,,55,53,2,55,7.40,96.0
1766,tt1068680,Yes Man,2008,"250,000+",317915,30160,15847,19498,3.6,66.0,,155,71,84,155,5.30,46.0
1767,tt0310024,Project Viper,2002,50+,72,1,11,4,1.7,8.0,,2,0,2,2,,
1768,tt1653915,Nothing But the Truth,2008,0,0,0,0,0,,,,0,0,0,0,,
1769,tt1653915,Nothing But the Truth,2008,0,0,0,0,0,,,,0,0,0,0,,
1770,tt1653915,Nothing But the Truth,2008,0,0,0,0,0,,,,0,0,0,0,,
1771,tt0120784,Payback,1999,"50,000+",99062,4612,2108,2167,3.6,69.0,,77,43,34,77,5.90,56.0
1772,tt1653915,Nothing But the Truth,2008,0,0,0,0,0,,,,0,0,0,0,,
1773,tt0067321,Lady Frankenstein,1971,250+,453,19,73,43,2.4,20.0,,2,0,2,2,,
1774,tt0095262,Mobile Suit Gundam: Char's Counterattack,1988,250+,310,70,14,19,4,83.0,,1,1,0,1,,
1775,tt0264689,Home Room,2002,"5,000+",5470,358,101,204,3.9,78.0,,22,12,10,22,5.60,55.0
1776,tt1582621,The Holding,2011,50+,95,17,43,17,2.9,28.0,,2,2,0,2,,
1777,tt0092226,Wise Guys,1986,"2,500+",3270,111,157,80,3,41.0,,16,5,11,16,4.50,31.0
1778,tt0819129,Thrill of the Kill,2006,500+,543,6,16,8,2.8,27.0,,0,0,0,0,,
1779,tt1351099,Bicycle Dreams,2009,250+,277,10,0,2,4.4,100.0,,0,0,0,0,,
1780,tt1242861,Accidental Friendship,2008,100+,189,17,10,10,3.6,63.0,,0,0,0,0,,
1781,tt0097074,Cohen and Tate,1988,250+,294,40,29,23,3.3,58.0,,4,4,0,4,,
1782,tt0806029,Farewell,2009,0,0,0,0,0,,,,1,1,0,1,,
1783,tt1095421,Ramchand Pakistani,2008,250+,320,63,19,38,3.8,77.0,,3,1,2,3,,
1784,tt0091374,Lady Jane,1986,"5,000+",6122,542,167,255,3.9,76.0,,9,5,4,9,5.40,56.0
1785,tt0423169,Sherrybaby,2006,"25,000+",37577,1798,1349,1518,3.3,57.0,,66,50,16,66,6.70,76.0
1786,tt0318763,Timecop: The Berlin Decision,2003,"5,000+",6911,45,126,68,2.6,26.0,,2,0,2,2,,
1787,tt0158585,Dharmputra,1961,Fewer than 50,25,1,0,0,,,,0,0,0,0,,
1788,tt0100802,Total Recall,1990,"100,000+",245190,18194,4938,7881,3.8,79.0,,76,62,14,76,7.30,82.0
1789,tt0863091,Mukhsin,2006,500+,580,82,18,39,4,82.0,,1,1,0,1,,
1790,tt0120520,The Wings of the Dove,1997,"5,000+",5615,637,178,199,3.9,78.0,,34,29,5,34,7.90,85.0
1791,tt4318022,Irandu Mugam,2010,0,0,0,0,0,,,,0,0,0,0,,
1792,tt0892112,A Walk to Beautiful,2007,250+,405,61,4,22,4.3,94.0,,19,17,2,19,7.40,89.0
1793,tt0154197,Bama Vijayam,1967,Fewer than 50,19,1,1,1,,,,1,1,0,1,,
1794,tt0378109,Into the Blue,2005,"250,000+",326657,5629,4310,8318,3.4,57.0,,125,26,99,125,4.10,21.0
1795,tt0054910,Gunga Jumna,1961,Fewer than 50,4,2,2,2,,,,0,0,0,0,,
1796,tt0382561,Hair Show,2004,"5,000+",7113,175,79,112,3.9,69.0,,12,2,10,12,3.80,17.0
1797,tt0101591,Class of Nuke 'Em High Part II: Subhumanoid Meltdown,1991,250+,488,25,76,44,2.5,25.0,,1,0,1,1,,
1798,tt0364045,Taking Lives,2004,"50,000+",69573,3864,3237,2393,3.4,54.0,,158,34,124,158,4.60,22.0
1799,tt0059399,Lord Jim,1965,"1,000+",1800,86,68,53,3.4,56.0,,14,8,6,14,5.70,57.0
1800,tt2292959,The Canyons,2013,"2,500+",3200,172,1012,238,2,15.0,,94,20,74,94,4.00,21.0
1801,tt0214841,Karz,1980,500+,550,92,10,25,4.2,90.0,,0,0,0,0,,
1802,tt1060256,Ichi,2008,500+,842,208,142,107,3.4,59.0,,9,7,2,9,5.70,78.0
1803,tt0084096,The House Where Evil Dwells,1982,"1,000+",1507,12,46,24,2.3,21.0,,3,0,3,3,,
1804,tt0118956,Deep Rising,1998,"10,000+",22037,758,995,706,3.1,43.0,,34,11,23,34,4.20,32.0
1805,tt0329030,The Dust Factory,2004,"5,000+",5126,163,121,144,3.6,57.0,,11,1,10,11,3.20,9.0
1806,tt0154887,Mob Queen,1998,Fewer than 50,8,2,0,0,,,,5,2,3,5,4.20,40.0
1807,tt0273164,Daman: A Victim of Marital Violence,2001,50+,85,0,2,0,,,,0,0,0,0,,
1808,tt0102103,Impromptu,1991,"2,500+",4871,369,150,183,3.8,71.0,,19,14,5,19,6.10,74.0
1809,tt0108002,Rudy,1993,"100,000+",127421,15408,1783,5391,4.3,90.0,,48,37,11,48,6.90,77.0
1810,tt0420291,Keane,2004,"5,000+",5286,542,236,325,3.6,70.0,,62,51,11,62,7.00,82.0
1811,tt0446889,Aatank,1996,0,0,0,0,0,,,,0,0,0,0,,
1812,tt0294579,The Flats,2002,100+,115,12,5,7,3.7,71.0,,1,1,0,1,,
1813,tt1391655,759: Boy Scouts of Harlem,2009,Fewer than 50,2,2,0,0,,,,0,0,0,0,,
1814,tt1726669,Killer Joe,2011,"50,000+",80354,7631,4882,2025,3.4,61.0,,172,138,34,172,7.00,80.0
1815,tt0208629,Nuremberg,2000,"1,000+",2329,193,73,87,3.8,73.0,,4,3,1,4,,
1816,tt0165113,Bonsoir,1994,0,0,0,0,0,,,,0,0,0,0,,
1817,tt0057200,Johnny Cool,1963,100+,243,12,15,14,3.2,44.0,,6,3,3,6,4.10,50.0
1818,tt0095288,Heartbreak Hotel,1988,"1,000+",1556,38,38,28,3.3,49.0,,13,5,8,13,4.40,38.0
1819,tt0117608,Sgt. Bilko,1996,"25,000+",32980,825,937,520,3.2,47.0,,40,12,28,40,4.60,30.0
1820,tt0356680,The Family Stone,2005,"250,000+",404033,10364,6126,10324,3.5,63.0,,160,83,77,160,5.90,52.0
1821,tt1109523,Tapestries of Hope,2009,Fewer than 50,14,3,0,1,,,,0,0,0,0,,
1822,tt0356680,The Family Stone,2005,"250,000+",404033,10364,6126,10324,3.5,63.0,,160,83,77,160,5.90,52.0
1823,tt1753995,Just Friends?,2009,0,0,0,0,0,,,,0,0,0,0,,
1824,tt0437777,Something New,2006,"100,000+",101255,2187,834,1351,3.8,72.0,,109,66,43,109,6.00,61.0
1825,tt1777612,Demons Never Die,2011,250+,460,181,120,33,3.6,60.0,,8,1,7,8,4.20,13.0
1826,tt0084784,That Championship Season,1982,50+,84,8,8,5,3.2,50.0,,7,5,2,7,6.20,71.0
1827,tt0128801,Under Wraps,1997,"1,000+",1520,103,72,50,3.6,59.0,,1,0,1,1,,
1828,tt1691920,I Melt with You,2011,"1,000+",2013,355,471,234,2.9,43.0,,45,7,38,45,3.60,16.0
1829,tt0499262,Takva,2006,Fewer than 50,15,11,2,1,3.7,85.0,,2,2,0,2,,
1830,tt0116687,Jaya Ganga,1996,0,0,0,0,0,,,,2,2,0,2,,
1831,tt1575647,Nuvvu Vasthavani,2000,0,0,0,0,0,,,,0,0,0,0,,
1832,tt0088944,Commando,1985,0,0,0,0,0,,,,0,0,0,0,,
1833,tt0064602,The Lost Man,1969,Fewer than 50,38,4,4,3,3.5,50.0,,3,1,2,3,,
1834,tt0266239,Alien: Resurrection,2000,"250,000+",263837,7440,11527,7327,3,39.0,,86,46,40,86,5.70,53.0
1835,tt0088944,Commando,1985,0,0,0,0,0,,,,0,0,0,0,,
1836,tt0997047,College Road Trip,2008,"100,000+",191407,3952,3917,2547,3.2,50.0,,74,9,65,74,3.40,12.0
1837,tt1268224,An Inconvenient Tax,2011,100+,145,3,7,3,2.4,30.0,,0,0,0,0,,
1838,tt0361696,Raise Your Voice,2004,"250,000+",383434,11706,4832,11225,3.8,71.0,,83,13,70,83,3.80,16.0
1839,tt1057535,Marina of the Zabbaleen,2008,250+,426,3,2,4,3.7,60.0,,2,2,0,2,,
1840,tt0461688,Murder in the Hamptons,2005,500+,504,18,27,15,3.1,40.0,,0,0,0,0,,
1841,tt0334226,Remake,2003,50+,70,2,4,2,2.8,33.0,,0,0,0,0,,
1842,tt0068617,Fuzz,1972,100+,218,9,49,25,2.3,16.0,,3,3,0,3,,
1843,tt0243220,Disappearing Acts,2000,"2,500+",4859,328,60,142,4.2,85.0,,5,3,2,5,7.30,60.0
1844,tt1418157,Jeevana Chaitra,1992,0,0,0,0,0,,,,0,0,0,0,,
1845,tt1298594,The Presence,2010,250+,441,60,233,115,2.2,20.0,,1,1,0,1,,
1846,tt0068339,Carry on Matron,1972,"5,000+",6591,123,69,82,3.6,64.0,,0,0,0,0,,
1847,tt0054727,Carry on Regardless,1961,500+,858,38,55,26,3.3,41.0,,0,0,0,0,,
1848,tt0065524,Carry on Loving,1970,500+,582,54,57,28,3.4,49.0,,0,0,0,0,,
1849,tt0091681,One More Saturday Night,1986,100+,225,5,8,2,3,38.0,,0,0,0,0,,
1850,tt1925431,Fire with Fire,2012,"1,000+",2013,547,971,259,2.9,36.0,,15,1,14,15,3.20,7.0
1851,tt0099740,Hardware,1990,"5,000+",5470,499,453,388,3.2,52.0,,13,6,7,13,5.70,46.0
1852,tt0410134,Jhoothi Shaan,1991,0,0,0,0,1,,,,0,0,0,0,,
1853,tt1024188,Cartouches gauloises,2007,100+,101,7,4,4,3.4,64.0,,0,0,0,0,,
1854,tt0077300,Carry on Emmannuelle,1978,500+,775,13,65,23,2.2,17.0,,0,0,0,0,,
1855,tt0282178,Earth vs. the Spider,2001,500+,760,24,99,52,2.4,20.0,,4,2,2,4,,
1856,tt0132933,Dynamite Brothers,1974,"1,000+",1141,1,11,9,2,8.0,,2,2,0,2,,
1857,tt0116365,The Frighteners,1996,"50,000+",63172,4948,1992,2356,3.7,71.0,,43,29,14,43,6.30,67.0
1858,tt0061738,Gunfight in Abilene,1967,Fewer than 50,1,1,0,1,,,,0,0,0,0,,
1859,tt1592876,Score: A Hockey Musical,2010,250+,272,55,64,59,3,46.0,,4,3,1,4,,
1860,tt0097441,Glory,1989,"50,000+",60468,11637,895,3618,4.3,93.0,,55,52,3,55,7.90,95.0
1861,tt0250282,Teddy Bears' Picnic,2001,"1,000+",1144,7,11,7,2.8,39.0,,19,0,19,19,3.00,0.0
1862,tt0780607,The Signal,2007,"5,000+",9757,1587,1156,1445,3.3,58.0,,71,42,29,71,6.10,59.0
1863,tt0319500,Himmat,1996,Fewer than 50,44,0,1,0,,,,0,0,0,0,,
1864,tt0102820,Rush,1991,"5,000+",8385,614,243,244,3.8,72.0,,28,20,8,28,6.20,71.0
1865,tt1729603,Come Rain Come Shine,2010,Fewer than 50,25,8,7,2,3.2,53.0,,0,0,0,0,,
1866,tt3592248,Bhalo Theko,2003,Fewer than 50,1,0,1,1,,,,0,0,0,0,,
1867,tt0365390,Finding John Christmas,2003,100+,241,19,15,11,3.7,56.0,,0,0,0,0,,
1868,tt0251355,Pushpaka Vimana,1987,0,0,0,0,0,,,,0,0,0,0,,
1869,tt1840417,The Words,2012,"25,000+",48619,4024,4161,1060,3.3,49.0,,128,31,97,128,4.60,24.0
1870,tt0196267,Cruel Intentions 2,2000,"25,000+",48810,420,1625,889,2.3,21.0,,12,2,10,12,3.60,17.0
1871,tt0200641,Flexing with Monty,2010,50+,64,4,10,4,2.2,29.0,,0,0,0,0,,
1872,tt0103157,The Unborn,1991,"1,000+",1611,19,55,36,2.6,26.0,,4,1,3,4,,
1873,tt0091055,Firewalker,1986,"5,000+",7160,122,251,135,2.8,33.0,,13,1,12,13,3.00,8.0
1874,tt1213910,Bhale Dongalu,2008,Fewer than 50,4,0,1,0,,,,0,0,0,0,,
1875,tt2196254,Jatt & Juliet,2012,250+,324,130,17,21,4.4,88.0,,0,0,0,0,,
1876,tt0083343,Martial Club,1981,Fewer than 50,36,6,5,4,3.3,55.0,,0,0,0,0,,
1877,tt0076931,Wombling Free,1977,100+,236,8,6,6,3.6,62.0,,0,0,0,0,,
1878,tt0337578,Baghban,2003,0,0,0,0,0,,,,0,0,0,0,,
1879,tt0402374,Metallic Blues,2004,50+,80,5,6,1,3.3,45.0,,1,1,0,1,,
1880,tt0113617,Last of the Dogmen,1995,"5,000+",9737,411,105,237,4.1,80.0,,13,9,4,13,5.80,69.0
1881,tt0433562,Family Plan,2005,250+,333,30,25,8,3.4,55.0,,0,0,0,0,,
1882,tt0055444,Shola Aur Shabnam,1961,0,0,0,0,0,,,,0,0,0,0,,
1883,tt0445776,U-Carmen eKhayelitsha,2005,"1,000+",1901,39,18,21,3.6,68.0,,21,20,1,21,7.50,95.0
1884,tt0149740,Parshuramer Kuthar,1989,0,0,0,0,0,,,,0,0,0,0,,
1885,tt0422950,Phir Milenge,2004,500+,663,47,33,26,3.4,59.0,,2,2,0,2,,
1886,tt1405412,Hardwired,2009,"1,000+",1269,87,288,144,2.4,23.0,,2,0,2,2,,
1887,tt0200515,Camp Blood,2000,100+,196,3,20,9,2,13.0,,0,0,0,0,,
1888,tt0069848,Carry on Girls,1973,500+,618,68,56,38,3.4,55.0,,0,0,0,0,,
1889,tt0117061,Mistrial,1996,"1,000+",1002,1,18,3,2.2,5.0,,1,0,1,1,,
1890,tt0090577,Aap Ke Saath,1986,0,0,0,0,0,,,,0,0,0,0,,
1891,tt0449004,Devon's Ghost: Legend of the Bloody Boy,2005,250+,296,8,19,14,2.8,30.0,,1,0,1,1,,
1892,tt0097910,Moon 44,1990,500+,712,45,97,33,2.6,31.0,,5,0,5,5,3.30,0.0
1893,tt0118615,Anaconda,1997,"250,000+",422705,2718,8636,8370,2.5,24.0,,54,22,32,54,4.90,41.0
1894,tt0337971,Deewangee,2002,100+,129,12,13,4,3.1,48.0,,0,0,0,0,,
1895,tt0217654,Militia,2000,50+,88,1,11,2,1.8,8.0,,1,0,1,1,,
1896,tt0119327,Hugo Pool,1997,"2,500+",3105,87,108,60,3.1,45.0,,17,5,12,17,4.10,29.0
1897,tt0310991,Deep Shock,2003,250+,381,4,38,23,1.6,10.0,,0,0,0,0,,
1898,tt0484877,Wedding Daze,2006,"10,000+",21544,1492,2473,1701,2.9,38.0,,12,4,8,12,4.20,33.0
1899,tt1630255,Puthiya Mugham,2009,Fewer than 50,7,2,2,0,,,,0,0,0,0,,
1900,tt0484877,Wedding Daze,2006,"10,000+",21544,1492,2473,1701,2.9,38.0,,12,4,8,12,4.20,33.0
1901,tt0069103,Pocket Money,1972,250+,328,19,44,26,2.8,30.0,,8,4,4,8,5.60,50.0
1902,tt0352925,Tongan Ninja,2002,"1,000+",1639,112,48,97,3.7,70.0,,1,1,0,1,,
1903,tt0475276,United 93,2006,"100,000+",129486,12786,2678,6658,4,83.0,,212,191,21,212,8.20,90.0
1904,tt0928194,Arabikkatha,2007,0,0,0,0,0,,,,0,0,0,0,,
1905,tt0480249,I Am Legend,2007,"250,000+",1130645,257307,119819,92285,3.7,68.0,,215,146,69,215,6.30,68.0
1906,tt0411487,"Hindi pa tapos ang labada, darling",1994,100+,134,5,1,0,3.8,83.0,,0,0,0,0,,
1907,tt0070518,Pat Garrett og Billy the Kid,1973,"5,000+",7692,1162,251,457,4,82.0,,57,32,25,57,7.20,56.0
1908,tt0090293,Warning Sign,1985,500+,821,44,59,41,3.1,42.0,,10,2,8,10,4.50,20.0
1909,tt0113965,Never Talk to Strangers,1995,"5,000+",5470,171,264,127,3,39.0,,20,3,17,20,3.60,15.0
1910,tt0930071,Last Stop for Paul,2006,250+,493,58,33,44,3.5,64.0,,13,9,4,13,6.50,69.0
1911,tt0388976,Call Me: The Rise and Fall of Heidi Fleiss,2004,"1,000+",1307,38,46,38,3.4,45.0,,0,0,0,0,,
1912,tt0325352,I'll Be There,2003,"1,000+",2441,104,79,92,3.4,57.0,,6,3,3,6,5.40,50.0
1913,tt0060760,"Not with My Wife, You Don't!",1966,50+,97,5,7,5,3.1,42.0,,0,0,0,0,,
1914,tt1315216,Jesse Stone: No Remorse,2010,250+,297,77,56,28,3.5,58.0,,0,0,0,0,,
1915,tt3171702,Cheluvina Chittara,2007,100+,174,3,0,1,,,,0,0,0,0,,
1916,tt0239254,Becoming Dick,2000,0,0,0,0,0,,,,0,0,0,0,,
1917,tt0851578,Paprika,2006,"25,000+",41277,9066,1300,4288,4.1,87.0,,91,78,13,91,7.30,86.0
1918,tt0187115,Kshana Kshanam,1991,0,0,0,0,0,,,,0,0,0,0,,
1919,tt0112068,McLeod's Daughters,1996,50+,64,16,3,2,4,84.0,,0,0,0,0,,
1920,tt1520498,The Oogieloves in the Big Balloon Adventure,2012,"2,500+",4904,333,201,266,3.4,62.0,,23,7,16,23,3.80,30.0
1921,tt0126203,At the End of the Rainbow,1965,Fewer than 50,1,0,1,1,,,,0,0,0,0,,
1922,tt0114317,Sabse Bada Khiladi,1995,100+,209,9,3,3,3.9,75.0,,0,0,0,0,,
1923,tt0105410,"Silent Night, Deadly Night 5: The Toy Maker",1991,"2,500+",2564,39,129,76,2.4,23.0,,2,1,1,2,,
1924,tt0246687,Hu Tu Tu,1999,100+,104,6,1,2,3.9,86.0,,0,0,0,0,,
1925,tt0466669,Almost Normal,2005,500+,950,54,74,64,3.1,42.0,,0,0,0,0,,
1926,tt0397355,Buena vida (Delivery),2004,Fewer than 50,46,8,4,2,3.5,67.0,,0,0,0,0,,
1927,tt0100455,Rainbow Drive,1990,50+,54,0,4,0,,,,0,0,0,0,,
1928,tt0993841,Dead Air,2009,"10,000+",13190,67,188,99,2.7,26.0,,1,1,0,1,,
1929,tt0993841,Dead Air,2009,"10,000+",13190,67,188,99,2.7,26.0,,1,1,0,1,,
1930,tt0271607,Kuttettan,1990,0,0,0,0,0,,,,0,0,0,0,,
1931,tt0427038,Carlito's Way: Rise to Power,2005,"10,000+",12362,413,409,270,3.2,50.0,,6,2,4,6,4.30,33.0
1932,tt0357289,Videsi Nair Swadesi Nair,2002,0,0,0,0,0,,,,0,0,0,0,,
1933,tt0455967,John Tucker Must Die,2006,"250,000+",550994,46381,20647,29842,3.7,69.0,,94,26,68,94,4.50,28.0
1934,tt0880464,Iqraar: By Chance,2006,50+,89,1,2,0,,,,0,0,0,0,,
1935,tt0120126,"Sick: The Life & Death of Bob Flanagan, Supermasochist",1997,"1,000+",1827,211,28,121,4.1,88.0,,25,23,2,25,7.80,92.0
1936,tt0104844,Meet the Parents,1992,Fewer than 50,45,1,0,1,,,,1,1,0,1,,
1937,tt1159926,City of Life,2009,Fewer than 50,46,12,5,4,3.5,71.0,,0,0,0,0,,
1938,tt0780593,Pumpkinhead: Ashes to Ashes,2006,"2,500+",2961,62,197,106,2.5,24.0,,4,0,4,4,,
1939,tt0924213,Chota Mumbai,2007,100+,195,9,3,2,3.6,75.0,,0,0,0,0,,
1940,tt0114212,O Quatrilho,1995,250+,255,18,18,5,3.2,50.0,,1,0,1,1,,
1941,tt0246989,Tomcats,2001,"10,000+",22978,595,805,412,2.9,42.0,,77,11,66,77,3.40,14.0
1942,tt1389127,Texas Killing Fields,2011,"5,000+",5066,508,1360,355,2.8,27.0,,44,17,27,44,5.10,39.0
1943,tt0053809,Faces in the Dark,1960,Fewer than 50,1,1,0,1,,,,0,0,0,0,,
1944,tt0179761,Demolition University,1997,500+,659,7,25,13,2.4,22.0,,0,0,0,0,,
1945,tt0144084,American Psycho,2000,"250,000+",306252,48868,8894,19482,4,85.0,,154,104,50,154,6.20,68.0
1946,tt0144084,American Psycho,2000,"250,000+",306252,48868,8894,19482,4,85.0,,154,104,50,154,6.20,68.0
1947,tt0159696,Relax... It's Just Sex,1998,"1,000+",2329,117,55,63,3.6,68.0,,16,9,7,16,6.10,56.0
1948,tt0783515,The Education of Charlie Banks,2007,"5,000+",8553,366,439,275,3.2,45.0,,31,15,16,31,5.20,48.0
1949,tt0892318,Letters to Juliet,2010,"250,000+",258190,10281,6394,4033,3.6,62.0,,162,68,94,162,5.20,42.0
1950,tt0369445,The Gamers,2002,Fewer than 50,3,3,0,0,,,,0,0,0,0,,
1951,tt1503179,Thillalangadi,2010,Fewer than 50,28,2,9,0,2.7,18.0,,0,0,0,0,,
1952,tt1681687,The 19th Wife,2010,100+,110,14,34,6,2.6,29.0,,0,0,0,0,,
1953,tt1764198,Best Laid Plans,2012,100+,136,35,57,29,3,38.0,,6,3,3,6,4.40,50.0
1954,tt0119679,Miss Evers' Boys,1997,250+,487,63,26,24,3.8,71.0,,1,1,0,1,,
1955,tt0219400,Waking Up in Reno,2002,"5,000+",6062,131,293,111,2.8,31.0,,38,4,34,38,3.70,11.0
1956,tt0425027,Flywheel,2003,Fewer than 50,5,3,2,2,3.4,60.0,,0,0,0,0,,
1957,tt0374294,Triple agent,2004,500+,605,25,19,13,3.3,57.0,,11,9,2,11,6.30,82.0
1958,tt0110516,Milk Money,1994,"10,000+",18066,335,577,281,2.9,37.0,,42,5,37,42,3.30,12.0
1959,tt0758798,Weirdsville,2007,"2,500+",3563,475,317,415,3.4,60.0,,33,19,14,33,5.40,58.0
1960,tt6551244,Suryavamsam,1997,0,0,0,0,0,,,,0,0,0,0,,
1961,tt6551244,Suryavamsam,1997,0,0,0,0,0,,,,0,0,0,0,,
1962,tt0080750,Foolin' Around,1980,Fewer than 50,18,5,2,1,4.1,71.0,,2,0,2,2,,
1963,tt1629284,Hanamizuki,2010,100+,184,54,37,27,3.5,59.0,,0,0,0,0,,
1964,tt1340795,Safe Harbor,2009,Fewer than 50,14,2,0,1,,,,0,0,0,0,,
1965,tt0155074,Pyar Ka Mandir,1988,0,0,0,0,0,,,,0,0,0,0,,
1966,tt0094131,They Still Call Me Bruce,1987,100+,136,9,12,5,2.9,43.0,,0,0,0,0,,
1967,tt0092085,Thrashin',1986,"2,500+",3102,284,112,182,3.9,72.0,,2,1,1,2,,
1968,tt1446714,Prometheus,2012,"250,000+",264095,71682,33093,20042,3.6,68.0,,315,231,84,315,7.00,73.0
1969,tt0274812,Secretary,2002,"50,000+",60591,11226,2417,4619,4,82.0,,158,123,35,158,6.90,78.0
1970,tt0283003,Spun,2002,"50,000+",56732,6032,2045,2518,3.8,75.0,,79,29,50,79,5.00,37.0
1971,tt0477051,Norbit,2007,"250,000+",660670,19489,17376,22311,3.2,53.0,,123,11,112,123,3.60,9.0
1972,tt0100135,Men at Work,1990,"25,000+",34026,638,795,528,3.2,44.0,,28,9,19,28,4.10,32.0
1973,tt0102761,Raw Nerve,1991,50+,59,0,4,2,,,,1,1,0,1,,
1974,tt0068595,Flesh Gordon,1974,"2,500+",2893,480,156,105,4.2,75.0,,6,4,2,6,5.00,67.0
1975,tt0827714,Jaane Hoga Kya,2006,50+,97,2,3,4,2.2,40.0,,0,0,0,0,,
1976,tt0437250,The Memory Thief,2007,100+,240,16,20,18,3.2,43.0,,15,12,3,15,6.70,80.0
1977,tt1789083,The Weight of Chains,2010,50+,73,35,16,10,3.6,69.0,,0,0,0,0,,
1978,tt0105249,Return to the Lost World,1992,100+,122,3,15,5,2.4,17.0,,0,0,0,0,,
1979,tt1031947,Munyurangabo,2007,500+,918,43,27,24,3.5,61.0,,31,29,2,31,7.80,94.0
1980,tt0291729,Appunni,1984,0,0,0,0,0,,,,0,0,0,0,,
1981,tt0253827,The Martins,2001,500+,976,52,48,44,3.3,52.0,,2,1,1,2,,
1982,tt0896968,Red: The Dark Side,2007,250+,251,9,12,6,3.3,43.0,,0,0,0,0,,
1983,tt0351576,The Postcard Bandit,2003,100+,161,12,2,7,4.2,86.0,,0,0,0,0,,
1984,tt0480242,Dan in Real Life,2007,"250,000+",385632,33506,15250,21112,3.6,69.0,,169,110,59,169,6.20,65.0
1985,tt0465624,My Super Ex-Girlfriend,2006,"250,000+",366829,5376,12220,9641,2.7,31.0,,132,53,79,132,5.10,40.0
1986,tt0090792,The Canterville Ghost,1986,100+,154,18,13,7,3.5,58.0,,0,0,0,0,,
1987,tt0106727,Dirty Weekend,1993,50+,85,4,12,2,2.4,25.0,,1,0,1,1,,
1988,tt0342735,Manderlay,2005,"10,000+",16560,1765,597,554,3.8,75.0,,105,53,52,105,5.70,50.0
1989,tt0090022,Silverado,1985,"10,000+",23370,2357,601,878,3.9,80.0,,36,28,8,36,6.80,78.0
1990,tt0787475,Hot Rod,2007,"250,000+",304843,18214,10314,13415,3.5,64.0,,119,47,72,119,5.10,39.0
1991,tt0869921,Angels Fall,2007,Fewer than 50,13,1,2,2,,,,1,0,1,1,,
1992,tt0430357,Miami Vice,2006,"250,000+",360392,8071,10664,11087,3,43.0,,226,107,119,226,5.70,47.0
1993,tt1869226,100% Love,2011,0,0,0,0,0,,,,0,0,0,0,,
1994,tt1869226,100% Love,2011,0,0,0,0,0,,,,0,0,0,0,,
1995,tt0286112,Shaolin Soccer,2001,"50,000+",69444,10363,1988,3993,4,84.0,,95,85,10,95,7.10,89.0
1996,tt0330843,Saathiya,2002,"5,000+",5276,437,91,141,4.1,83.0,,2,2,0,2,,
1997,tt0058530,Robinson Crusoe on Mars,1964,"1,000+",1720,291,181,164,3.5,62.0,,17,16,1,17,6.50,94.0
1998,tt0261289,Serving Sara,2002,"25,000+",27122,348,966,403,2.6,26.0,,113,5,108,113,3.20,4.0
1999,tt0363409,Aan: Men at Work,2004,100+,242,11,13,3,2.7,46.0,,0,0,0,0,,
2000,tt0104298,Freddie as F.R.O.7.,1992,100+,248,20,23,18,3.2,47.0,,0,0,0,0,,
2001,tt1482216,Patient X,2009,Fewer than 50,43,1,8,5,1.9,11.0,,0,0,0,0,,
2002,tt0374639,Incident at Loch Ness,2004,"2,500+",3946,373,191,236,3.5,66.0,,46,29,17,46,6.20,63.0
2003,tt1675439,Lloyd the Conqueror,2011,Fewer than 50,33,11,13,7,3.1,46.0,,5,4,1,5,4.80,80.0
2004,tt0099310,Coupe de Ville,1990,"1,000+",1586,110,44,55,3.9,71.0,,8,2,6,8,3.80,25.0
2005,tt0054649,Babes in Toyland,1961,"10,000+",10356,306,213,237,3.5,59.0,,11,4,7,11,4.70,36.0
2006,tt26933001,Persuasion,1995,"10,000+",22876,2345,466,1013,4.1,83.0,,30,26,4,30,7.70,87.0
2007,tt0186654,Universal Soldier II: Brothers in Arms,1998,"1,000+",1022,12,126,33,1.7,9.0,,7,0,7,7,4.00,0.0
2008,tt0397501,King Solomon's Mines,2004,"5,000+",5065,71,89,66,3.1,44.0,,0,0,0,0,,
2009,tt0096244,Tequila Sunrise,1988,"25,000+",27590,642,970,352,3.1,40.0,,33,17,16,33,5.10,52.0
2010,tt0085450,Doctor Detroit,1983,"2,500+",4095,127,190,128,3,40.0,,6,2,4,6,5.00,33.0
2011,tt0246719,Julie Walking Home,2002,500+,567,25,24,27,3.2,51.0,,7,2,5,7,5.40,29.0
2012,tt1579650,Pavitra Bandham,1996,0,0,0,0,0,,,,0,0,0,0,,
2013,tt0095936,Qayamat Se Qayamat Tak,1988,"2,500+",3592,264,46,87,4.2,85.0,,1,1,0,1,,
2014,tt0357392,The Other Boleyn Girl,2003,"1,000+",1034,70,63,51,3.3,53.0,,0,0,0,0,,
2015,tt0266465,A Man Apart,2003,"50,000+",85428,2764,1727,1495,3.6,62.0,,131,14,117,131,4.00,11.0
2016,tt0056691,Who's Got the Action?,1962,Fewer than 50,29,3,4,2,3.2,43.0,,0,0,0,0,,
2017,tt1229238,Mission: Impossible - Ghost Protocol,2011,"250,000+",474322,245653,77365,13459,3.9,76.0,,253,236,17,253,7.70,93.0
2018,tt0082502,The Harlem Globetrotters on Gilligan's Island,1981,100+,196,10,13,11,2.9,43.0,,0,0,0,0,,
2019,tt0054755,A Cold Wind in August,1961,Fewer than 50,20,3,4,3,3.1,43.0,,2,2,0,2,,
2020,tt0280830,Kelviyum Naaney Badhilum Naaney,1982,0,0,0,0,0,,,,0,0,0,0,,
2021,tt1183701,They Killed Sister Dorothy,2008,100+,180,20,4,7,3.7,83.0,,8,8,0,8,7.80,100.0
2022,tt2243537,A Haunted House,2013,"50,000+",91870,8604,8323,2010,3.2,51.0,,52,5,47,52,2.90,10.0
2023,tt2243537,A Haunted House,2013,"50,000+",91870,8604,8323,2010,3.2,51.0,,52,5,47,52,2.90,10.0
2024,tt0110604,Mute Witness,1995,"2,500+",3167,218,112,114,3.5,66.0,,24,20,4,24,7.10,83.0
2025,tt0805564,Lars and the Real Girl,2007,"100,000+",105884,25497,4827,13332,4,84.0,,140,114,26,140,7.20,81.0
2026,tt0416666,The Crop,2004,Fewer than 50,3,1,0,0,,,,1,1,0,1,,
2027,tt0245830,Chettaniki Kallu Levu,1981,0,0,0,0,0,,,,0,0,0,0,,
2028,tt0460873,The Moon and the Stars,2007,"1,000+",1578,7,9,5,3.2,44.0,,0,0,0,0,,
2029,tt0148706,Saraswatichandra,1968,50+,84,2,3,2,3.4,40.0,,0,0,0,0,,
2030,tt0168192,The Stewardesses,1969,0,0,0,0,0,,,,1,0,1,1,,
2031,tt0111666,War of the Buttons,1994,"5,000+",6044,506,47,222,4.3,92.0,,2,2,0,2,,
2032,tt1327701,Ben 10: Alien Swarm,2009,500+,846,175,186,110,3.3,48.0,,0,0,0,0,,
2033,tt0282744,Mike Bassett: England Manager,2001,"2,500+",4844,353,114,185,3.9,76.0,,5,2,3,5,4.80,40.0
2034,tt1555058,Collaborator,2011,"1,000+",1668,60,39,25,3.5,61.0,,26,19,7,26,6.10,73.0
2035,tt0091059,The Navigator,1986,500+,959,162,45,81,3.9,78.0,,8,7,1,8,6.80,88.0
2036,tt0093692,Over the Top,1987,"25,000+",45875,1819,1860,1624,3.3,49.0,,31,10,21,31,4.70,32.0
2037,tt0323944,Shattered Glass,2003,"10,000+",23044,2917,769,1303,3.8,79.0,,166,153,13,166,7.70,92.0
2038,tt0357926,Mr. X in Bombay,1964,0,0,0,0,0,,,,0,0,0,0,,
2039,tt1143110,High Life,2009,500+,632,123,159,104,3,44.0,,5,4,1,5,6.60,80.0
2040,tt0934516,Meri Adaalat,2001,0,0,0,0,0,,,,0,0,0,0,,
2041,tt0395424,3 Needles,2005,"2,500+",2949,190,88,131,3.6,68.0,,38,13,25,38,4.80,34.0
2042,tt0389074,Kim Possible: A Sitch in Time,2003,"5,000+",6635,263,117,115,3.8,69.0,,0,0,0,0,,
2043,tt0325982,Play'd: A Hip Hop Story,2002,100+,119,17,1,2,4.4,94.0,,1,1,0,1,,
2044,tt0099697,Graveyard Shift,1990,"5,000+",9965,155,513,246,2.5,23.0,,7,0,7,7,3.50,0.0
2045,tt0071286,A Case of Rape,1974,0,0,0,0,0,,,,0,0,0,0,,
2046,tt0065194,Wake Me When the War Is Over,1969,0,0,0,0,0,,,,0,0,0,0,,
2047,tt0206917,The Man Who Cried,2000,"25,000+",25787,1326,940,749,3.4,59.0,,69,24,45,69,4.70,35.0
2048,tt0278712,Shubha Yathra,1990,0,0,0,0,0,,,,0,0,0,0,,
2049,tt1784576,Parayan Marannathu...,2009,0,0,0,0,0,,,,0,0,0,0,,
2050,tt0424345,Clerks II,2006,"250,000+",285968,31559,6173,15606,4,84.0,,167,105,62,167,6.10,63.0
2051,tt0457297,The Butterfly Effect 2,2006,"100,000+",115612,1448,4007,2612,2.4,27.0,,2,1,1,2,,
2052,tt0254481,Koi... Mil Gaya,2003,"5,000+",7206,535,169,290,3.9,76.0,,10,8,2,10,5.40,80.0
2053,tt0084090,Inseminoid,1981,"1,000+",1053,18,116,65,2.1,13.0,,2,1,1,2,,
2054,tt0106452,Body Snatchers,1993,"10,000+",13910,474,627,311,3.2,43.0,,30,21,9,30,6.20,70.0
2055,tt0064211,Daughter of the Mind,1969,Fewer than 50,1,0,1,0,,,,0,0,0,0,,
2056,tt1156337,Swagatam,2008,0,0,0,0,0,,,,0,0,0,0,,
2057,tt1131743,Necrosis,2009,250+,301,9,81,41,1.9,10.0,,3,1,2,3,,
2058,tt0420230,Swarabhishekam,2004,0,0,0,0,0,,,,0,0,0,0,,
2059,tt0116130,Down Periscope,1996,"25,000+",40226,1615,983,985,3.5,62.0,,35,4,31,35,4.10,11.0
2060,tt0385961,Premonition,2005,"250,000+",468961,17981,18274,22831,3.2,50.0,,161,13,148,161,3.90,8.0
2061,tt0247444,Juwanna Mann,2002,"5,000+",8358,307,476,237,2.8,39.0,,84,8,76,84,3.40,10.0
2062,tt0063361,Nobody's Perfect,1968,0,0,0,0,0,,,,0,0,0,0,,
2063,tt1032746,Ace of Hearts,2008,500+,535,74,37,62,3.7,66.0,,2,1,1,2,,
2064,tt0118770,Breach of Faith: A Family of Cops II,1997,50+,81,2,13,3,2.8,13.0,,2,0,2,2,,
2065,tt0089265,The Heavenly Kid,1985,"5,000+",6626,239,133,159,3.7,64.0,,10,3,7,10,4.50,30.0
2066,tt0101698,Defending Your Life,1991,"10,000+",10023,1615,337,594,4,83.0,,42,41,1,42,7.80,98.0
2067,tt0248428,Shiva,1989,0,0,0,0,0,,,,0,0,0,0,,
2068,tt0122427,Chaalbaaz,1989,250+,448,30,13,15,3.8,70.0,,0,0,0,0,,
2069,tt0372334,House of D,2004,"5,000+",9708,1076,398,561,3.8,73.0,,102,10,92,102,3.80,10.0
2070,tt2220560,Nuvva Nena,2012,Fewer than 50,9,3,2,0,3.5,60.0,,0,0,0,0,,
2071,tt1541160,Flypaper,2011,"2,500+",3503,746,1032,346,3,42.0,,20,3,17,20,4.30,15.0
2072,tt1792543,The Reunion,2011,100+,114,53,27,6,3.5,66.0,,8,8,0,8,6.90,100.0
2073,tt0349878,Netaji Subhas Chandra Bose: The Forgotten Hero,2005,0,0,0,0,0,,,,0,0,0,0,,
2074,tt0496806,Ocean's Thirteen,2007,"250,000+",1532959,138429,46184,95184,3.7,75.0,,201,141,60,201,6.40,70.0
2075,tt0126388,Legionnaire,1998,"10,000+",11951,254,594,186,2.7,30.0,,7,2,5,7,4.30,29.0
2076,tt0086541,Videodrome,1983,"25,000+",41390,6687,1649,2686,3.9,80.0,,58,48,10,58,7.50,83.0
2077,tt0087589,Lassiter,1984,250+,309,19,44,11,3,30.0,,15,8,7,15,5.10,53.0
2078,tt0434915,Ek Paheli,1971,0,0,0,0,0,,,,0,0,0,0,,
2079,tt0462395,Larry the Cable Guy: Health Inspector,2006,"25,000+",49407,1066,978,1286,3.2,52.0,,39,2,37,39,2.70,5.0
2080,tt0183869,Taxi 2,2000,"10,000+",16095,1333,564,335,3.7,70.0,,3,2,1,3,,
2081,tt0086979,Blood Simple,1984,"25,000+",39319,7520,1030,2191,4,88.0,,109,102,7,109,8.30,94.0
2082,tt0081423,Revenge of the Stepford Wives,1980,100+,108,3,8,1,3.1,27.0,,1,1,0,1,,
2083,tt0111219,Sleeping with Strangers,1994,0,0,0,0,0,,,,0,0,0,0,,
2084,tt0202381,Guest House Paradiso,1999,"5,000+",7873,469,235,379,3.7,67.0,,1,0,1,1,,
2085,tt0762110,Irina Palm,2007,"5,000+",5694,1052,319,419,3.7,77.0,,48,31,17,48,6.00,65.0
2086,tt0211957,Blue Money,1972,0,0,0,0,0,,,,0,0,0,0,,
2087,tt1401607,The Con Artist,2010,100+,111,13,36,14,2.5,27.0,,0,0,0,0,,
2088,tt0367479,After the Sunset,2004,"25,000+",42524,1863,1739,1108,3.3,52.0,,137,24,113,137,4.50,18.0
2089,tt0120498,What the Deaf Man Heard,1997,500+,708,95,14,29,4.2,88.0,,0,0,0,0,,
2090,tt0848557,Diary of the Dead,2007,"25,000+",27309,3762,5420,4997,2.9,41.0,,131,80,51,131,6.20,61.0
2091,tt0354981,Two Brothers,2001,"25,000+",32391,1329,444,909,3.9,75.0,,113,88,25,113,6.60,78.0
2092,tt0122529,Henry Fool,1997,"5,000+",5540,704,149,255,4,83.0,,28,25,3,28,7.40,89.0
2093,tt1010448,Paano kita iibigin,2007,250+,285,10,9,8,3.5,53.0,,0,0,0,0,,
2094,tt1259521,The Cabin in the Woods,2011,"100,000+",208236,51486,18506,13193,3.8,74.0,,293,270,23,293,7.90,92.0
2095,tt1259521,The Cabin in the Woods,2011,"100,000+",208236,51486,18506,13193,3.8,74.0,,293,270,23,293,7.90,92.0
2096,tt0111825,Zero Tolerance,1994,50+,94,11,2,5,4,85.0,,0,0,0,0,,
2097,tt0139525,Phool Aur Patthar,1966,50+,54,1,0,0,,,,0,0,0,0,,
2098,tt0289848,Analyze That,2002,"100,000+",190297,1940,3063,1634,3,39.0,,149,39,110,149,4.70,26.0
2099,tt1229345,Cedar Boys,2009,100+,196,25,22,24,3.3,53.0,,3,2,1,3,,
2100,tt0116823,Larger Than Life,1996,"5,000+",7774,172,401,129,2.8,30.0,,18,2,16,18,4.10,11.0
2101,tt0339147,Highwaymen,2004,"5,000+",5858,216,362,223,2.9,37.0,,15,2,13,15,3.70,13.0
2102,tt1099196,Dil Dosti Etc,2007,500+,544,68,71,47,3.3,49.0,,1,0,1,1,,
2103,tt0235625,Nireekshana,1982,0,0,0,0,0,,,,0,0,0,0,,
2104,tt0106466,Born Yesterday,1993,"5,000+",5996,62,166,77,2.7,27.0,,28,7,21,28,4.10,25.0
2105,tt0349115,Baaz: A Bird in Danger,2003,Fewer than 50,17,2,4,0,2.8,33.0,,0,0,0,0,,
2106,tt0105034,The Nutt House,1992,50+,89,3,6,4,2.9,33.0,,0,0,0,0,,
2107,tt0107220,Inside Monkey Zetterland,1992,100+,234,7,5,5,3.7,58.0,,8,6,2,8,5.90,75.0
2108,tt0085515,Eyes of Fire,1983,100+,125,24,13,17,3.5,65.0,,4,4,0,4,,
2109,tt0112508,Billy Madison,1995,"250,000+",766198,39594,10491,20772,4,79.0,,48,19,29,48,4.80,40.0
2110,tt0262304,Brahma Puthrudu,1988,Fewer than 50,1,1,0,0,,,,0,0,0,0,,
2111,tt1240982,Your Highness,2011,"50,000+",54423,5592,11026,3877,2.8,34.0,,184,50,134,184,4.30,27.0
2112,tt0089139,Fever Pitch,1985,100+,102,2,6,2,2.4,25.0,,7,1,6,7,2.10,14.0
2113,tt0355181,Alancherry Thambrakkal,1995,0,0,0,0,0,,,,0,0,0,0,,
2114,tt0093175,Hello Again,1987,"5,000+",5912,108,115,91,3.2,48.0,,21,2,19,21,3.70,10.0
2115,tt0070334,The Long Goodbye,1973,"10,000+",10393,2181,323,679,4.1,87.0,,56,53,3,56,8.50,95.0
2116,tt0144550,The Pentagon Wars,1998,500+,559,127,24,40,3.9,84.0,,1,1,0,1,,
2117,tt0317640,The Hebrew Hammer,2003,500+,993,628,362,391,3.6,64.0,,26,13,13,26,4.90,50.0
2118,tt1606390,All Things Fall Apart,2011,500+,582,163,119,64,3.4,58.0,,3,1,2,3,,
2119,tt0155319,Unnal Mudiyum Thambi,1988,0,0,0,0,0,,,,0,0,0,0,,
2120,tt1135487,Duplicity,2009,0,0,0,0,0,,,,0,0,0,0,,
2121,tt0086405,Table for Five,1983,500+,609,22,15,13,3.6,59.0,,6,4,2,6,5.40,67.0
2122,tt2325981,Sundhara Travels,2002,0,0,0,0,0,,,,0,0,0,0,,
2123,tt0081485,Serial,1980,100+,173,24,7,13,4,77.0,,5,3,2,5,6.10,60.0
2124,tt1601792,Aa Naluguru,2004,0,0,0,0,0,,,,0,0,0,0,,
2125,tt0110160,Is There Life Out There?,1994,"1,000+",1292,68,6,22,4.6,92.0,,0,0,0,0,,
2126,tt1226753,The Debt,2010,"25,000+",35967,7810,4031,2180,3.5,66.0,,185,141,44,185,6.60,76.0
2127,tt1226753,The Debt,2010,"25,000+",35967,7810,4031,2180,3.5,66.0,,185,141,44,185,6.60,76.0
2128,tt0223954,The Prime Gig,2000,"1,000+",1521,47,91,52,3,34.0,,9,4,5,9,5.60,44.0
2129,tt0493430,Jackass Number Two,2006,"250,000+",436529,22591,5580,16942,4,80.0,,102,67,35,102,6.10,66.0
2130,tt0781434,Navarasa,2005,0,0,0,0,0,,,,0,0,0,0,,
2131,tt0195714,Final Destination,2000,"250,000+",483956,21778,10102,14005,3.7,68.0,,97,35,62,97,4.90,36.0
2132,tt0195714,Final Destination,2000,"250,000+",483956,21778,10102,14005,3.7,68.0,,97,35,62,97,4.90,36.0
2133,tt0492463,In Between Days,2006,"1,000+",1206,53,44,42,3.3,55.0,,29,25,4,29,7.20,86.0
2134,tt0308506,Like Mike,2002,"50,000+",68047,1463,1376,1130,3.3,52.0,,97,55,42,97,5.60,57.0
2135,tt0109443,Clean Slate,1994,0,0,0,0,0,,,,0,0,0,0,,
2136,tt0058222,I'd Rather Be Rich,1964,"1,000+",1000,10,5,8,3.9,67.0,,1,1,0,1,,
2137,tt0094383,Zombie High,1987,100+,206,4,54,19,2.1,7.0,,2,0,2,2,,
2138,tt1392737,Ex$pendable,2010,Fewer than 50,37,2,0,1,,,,0,0,0,0,,
2139,tt0120757,The Mod Squad,1999,"10,000+",13725,111,542,193,2.3,17.0,,64,2,62,64,3.00,3.0
2140,tt0362225,Tell No One,2006,"25,000+",33690,7751,1168,3560,4,87.0,,120,112,8,120,7.60,93.0
2141,tt0372326,Hollywood Wives: The New Generation,2003,Fewer than 50,17,0,2,2,,,,0,0,0,0,,
2142,tt0963191,Poi,2006,Fewer than 50,28,0,1,0,,,,0,0,0,0,,
2143,tt0119988,Caught Up,1998,"1,000+",1841,45,38,26,3.4,54.0,,8,0,8,8,3.70,0.0
2144,tt1202245,Beyond the Fire,2009,Fewer than 50,15,2,5,3,2.6,29.0,,9,1,8,9,3.60,11.0
2145,tt0371190,See Jane Date,2003,"1,000+",1154,77,77,59,3.3,50.0,,1,0,1,1,,
2146,tt0838231,Unfinished Sky,2007,500+,622,176,38,99,3.8,82.0,,9,8,1,9,6.60,89.0
2147,tt0226847,Jaanam Samjha Karo,1999,500+,643,9,28,3,2.6,24.0,,0,0,0,0,,
2148,tt1611914,Miss You Like Crazy,2010,0,0,0,0,0,,,,0,0,0,0,,
2149,tt0354965,Gudumba Shankar,2004,0,0,0,0,0,,,,0,0,0,0,,
2150,tt0076079,The Getting of Wisdom,1977,Fewer than 50,18,4,4,4,3.1,50.0,,5,4,1,5,5.80,80.0
2151,tt0455407,The Crazies,2010,"100,000+",199707,14466,11125,7513,3.4,56.0,,155,110,45,155,6.30,71.0
2152,tt0100087,Madhouse,1990,500+,981,71,89,51,3.1,44.0,,7,0,7,7,3.10,0.0
2153,tt1164647,Space Buddies,2009,"1,000+",1714,172,159,137,3.3,52.0,,3,2,1,3,,
2154,tt0363547,Dawn of the Dead,2004,"250,000+",404519,28847,8560,17531,3.8,77.0,,195,149,46,195,6.80,76.0
2155,tt9042310,Manathodu Mazhaikalam,2006,0,0,0,0,0,,,,0,0,0,0,,
2156,tt0371932,Sarkari Mehman,1979,0,0,0,0,0,,,,0,0,0,0,,
2157,tt0307987,Bad Santa,2003,"100,000+",201197,11223,3707,6352,3.8,75.0,,220,172,48,220,6.80,78.0
2158,tt0087182,Dune,1984,"50,000+",71397,7516,4031,4317,3.6,65.0,,77,34,43,77,5.60,44.0
2159,tt1010278,The Courageous Heart of Irena Sendler,2009,500+,532,151,59,44,3.8,72.0,,0,0,0,0,,
2160,tt0832318,What Goes Up,2009,"10,000+",12057,100,220,110,2.6,31.0,,30,5,25,30,3.60,17.0
2161,tt0340178,Jaal: The Trap,2003,50+,69,1,2,0,,,,0,0,0,0,,
2162,tt0095613,Memories of Me,1988,"1,000+",1043,21,25,14,3.2,47.0,,2,1,1,2,,
2163,tt0077834,Laserblast,1978,250+,446,34,188,104,1.7,15.0,,4,0,4,4,,
2164,tt0925245,Heatstroke,2008,100+,108,4,27,13,1.7,13.0,,0,0,0,0,,
2165,tt0074597,The Gumball Rally,1976,"2,500+",4414,212,113,150,3.7,65.0,,13,4,9,13,4.60,31.0
2166,tt1305583,Our Family Wedding,2010,"50,000+",77717,1959,2119,1011,3.2,48.0,,88,13,75,88,3.70,15.0
2167,tt1392197,Marmaduke,2010,"50,000+",78363,2147,2996,1363,3,42.0,,104,9,95,104,3.30,9.0
2168,tt1680138,Mega Python vs. Gatoroid,2011,250+,310,30,145,70,1.9,17.0,,1,0,1,1,,
2169,tt0086998,Breakin',1984,"5,000+",9259,818,298,481,4,73.0,,9,3,6,9,4.50,33.0
2170,tt1584016,Catfish,2010,"25,000+",25749,7462,3120,3101,3.6,71.0,,156,125,31,156,7.10,80.0
2171,tt1148200,Chain Letter,2010,"2,500+",2778,529,633,248,2.9,45.0,,14,4,10,14,3.80,29.0
2172,tt0071675,It's Alive,1974,"5,000+",6201,246,358,265,3,41.0,,24,16,8,24,6.00,67.0
2173,tt0488887,Last Exit,2006,100+,210,21,23,20,3.3,48.0,,0,0,0,0,,
2174,tt0488887,Last Exit,2006,100+,210,21,23,20,3.3,48.0,,0,0,0,0,,
2175,tt0083900,The Escape Artist,1982,"1,000+",1317,25,15,14,3.6,62.0,,5,4,1,5,6.50,80.0
2176,tt0385813,A Killer Within,2004,500+,666,11,18,13,2.8,38.0,,0,0,0,0,,
2177,tt0116289,Feeling Minnesota,1996,"10,000+",10800,225,602,191,2.7,27.0,,21,3,18,21,3.70,14.0
2178,tt0062207,Robbery,1967,50+,83,18,4,9,3.8,82.0,,5,4,1,5,6.40,80.0
2179,tt0913394,"Housewife, 49",2005,100+,140,29,8,12,3.8,78.0,,0,0,0,0,,
2180,tt0266971,The Slaughter Rule,2002,500+,966,92,120,37,3.1,43.0,,31,23,8,31,5.90,74.0
2181,tt0845492,My Name Is Anthony Gonsalves,2008,250+,286,4,14,8,2.7,22.0,,1,0,1,1,,
2182,tt0284419,Rakhi Aur Hathkadi,1972,0,0,0,0,0,,,,0,0,0,0,,
2183,tt0463934,Cake: A Wedding Story,2007,0,0,0,0,0,,,,0,0,0,0,,
2184,tt0083722,Cat People,1982,"10,000+",10390,560,670,435,3.1,45.0,,58,37,21,58,6.10,64.0
2185,tt0453556,TMNT,2007,"250,000+",368387,20465,13477,17047,3.5,60.0,,121,43,78,121,5.00,36.0
2186,tt2325915,Poove Unakkaga,1996,0,0,0,0,0,,,,0,0,0,0,,
2187,tt14579102,The Railway Children,2000,250+,371,48,11,25,4,81.0,,1,1,0,1,,
2188,tt0057542,Summer Magic,1963,"2,500+",4529,263,84,134,3.9,76.0,,4,3,1,4,,
2189,tt0065037,The Sterile Cuckoo,1969,500+,812,67,36,43,3.6,65.0,,8,7,1,8,6.60,88.0
2190,tt0332658,Intermission,2003,"10,000+",10442,1408,460,613,3.8,75.0,,99,73,26,99,6.60,74.0
2191,tt1126591,Burlesque,2010,"50,000+",66301,11412,6498,4483,3.6,64.0,,177,65,112,177,4.90,37.0
2192,tt0451983,Zeher,2005,250+,403,20,21,4,3.2,50.0,,0,0,0,0,,
2193,tt0100507,Rocky V,1990,"250,000+",268521,4177,9415,6244,2.7,31.0,,39,12,27,39,4.20,31.0
2194,tt1126591,Burlesque,2010,"50,000+",66301,11412,6498,4483,3.6,64.0,,177,65,112,177,4.90,37.0
2195,tt0273804,Mehndi,1998,0,0,0,0,0,,,,0,0,0,0,,
2196,tt0165982,Sinbad: Legend of the Seven Seas,2003,"50,000+",56578,1828,1407,897,3.4,56.0,,128,57,71,128,5.60,45.0
2197,tt1126591,Burlesque,2010,"50,000+",66301,11412,6498,4483,3.6,64.0,,177,65,112,177,4.90,37.0
2198,tt0282698,Love Liza,2002,"5,000+",7138,816,252,418,3.8,76.0,,87,47,40,87,5.90,54.0
2199,tt0086636,Zeder,1983,Fewer than 50,30,6,2,1,4,75.0,,0,0,0,0,,
2200,tt1126591,Burlesque,2010,"50,000+",66301,11412,6498,4483,3.6,64.0,,177,65,112,177,4.90,37.0
2201,tt1340108,Killer Bean Forever,2008,100+,178,171,7,100,4.7,96.0,,0,0,0,0,,
2202,tt4338888,Yuvan Yuvathi,2011,Fewer than 50,3,1,2,1,,,,0,0,0,0,,
2203,tt0193283,The Last Man on Planet Earth,1999,Fewer than 50,34,2,5,1,2.1,29.0,,1,0,1,1,,
2204,tt1592281,Take This Waltz,2011,"10,000+",16668,3165,2329,854,3.3,58.0,,141,111,30,141,7.00,79.0
2205,tt0395668,Miss 420,1998,0,0,0,0,0,,,,0,0,0,0,,
2206,tt0365183,Falling Angels,2003,"1,000+",1252,98,50,48,3.6,66.0,,8,5,3,8,5.40,63.0
2207,tt0090196,Transylvania 6-5000,1985,"5,000+",7655,223,319,253,3,41.0,,11,2,9,11,4.00,18.0
2208,tt0449018,The Final Season,2007,"2,500+",2968,409,201,312,3.7,67.0,,51,13,38,51,4.40,25.0
2209,tt0122961,The Second Arrival,1998,500+,852,18,93,40,2,16.0,,4,0,4,4,,
2210,tt0119598,The Maker,1997,250+,429,18,16,7,3.3,53.0,,4,3,1,4,,
2211,tt0454431,Chocolate: Deep Dark Secrets,2005,0,0,0,0,0,,,,0,0,0,0,,
2212,tt0349079,Alila,2003,500+,737,20,25,11,3.1,44.0,,17,7,10,17,5.30,41.0
2213,tt0465761,Slither,1974,250+,338,34,26,17,3.5,57.0,,9,6,3,9,6.40,67.0
2214,tt0066193,The Out of Towners,1970,"2,500+",4352,347,152,199,3.7,70.0,,16,10,6,16,5.90,63.0
2215,tt9160406,Azhagar Malai,2009,0,0,0,0,0,,,,0,0,0,0,,
2216,tt0316054,Jatt Jeona Mour,1992,Fewer than 50,1,1,0,0,,,,0,0,0,0,,
2217,tt0083745,"Come Back to the 5 & Dime Jimmy Dean, Jimmy Dean",1982,"2,500+",2586,189,44,89,4.1,81.0,,7,6,1,7,9.00,86.0
2218,tt1447499,Matching Jack,2010,"1,000+",1020,57,44,25,3.3,56.0,,13,9,4,13,6.40,69.0
2219,tt0401422,Finding Nemo,2003,"250,000+",33356856,276267,43291,1434748,3.8,86.0,,270,268,2,270,8.70,99.0
2220,tt0119935,Preaching to the Perverted,1997,"1,000+",1520,183,37,110,4.2,83.0,,4,2,2,4,,
2221,tt0203425,Crocodile,2000,"2,500+",4690,40,182,108,2.2,18.0,,4,1,3,4,,
2222,tt0869019,Candles on Bay Street,2006,500+,571,55,23,29,3.7,71.0,,0,0,0,0,,
2223,tt0214704,Gandhinagar 2nd Street,1986,0,0,0,0,0,,,,0,0,0,0,,
2224,tt0363563,Devata,1978,0,0,0,0,0,,,,0,0,0,0,,
2225,tt0397044,Blood and Chocolate,2007,"100,000+",158375,4639,4330,4803,3.2,52.0,,73,8,65,73,3.60,11.0
2226,tt0222029,If You Believe,1999,250+,455,12,11,9,3.3,52.0,,0,0,0,0,,
2227,tt0095721,Never Say Die,1988,Fewer than 50,8,0,1,0,,,,0,0,0,0,,
2228,tt0350047,Reign of Fire,2002,"100,000+",132416,5057,5273,4249,3.2,49.0,,173,72,101,173,5.20,42.0
2229,tt0842926,The Kids Are All Right,2010,"50,000+",63683,15019,5407,4672,3.7,74.0,,228,210,18,228,7.80,92.0
2230,tt0488046,Fatal Deviation,1998,Fewer than 50,3,3,0,1,,,,0,0,0,0,,
2231,tt0061101,Tokyo Drifter,1966,"5,000+",5429,670,175,287,3.9,79.0,,14,13,1,14,7.30,93.0
2232,tt0772193,Primeval,2007,"50,000+",64267,939,2029,1459,2.7,32.0,,57,11,46,57,3.60,19.0
2233,tt0843326,Bommarillu,2006,"1,000+",1275,225,9,62,4.5,96.0,,0,0,0,0,,
2234,tt1132472,My Big Love,2008,0,0,0,0,0,,,,0,0,0,0,,
2235,tt0335008,Coast to Coast,2003,100+,121,3,11,3,2.4,21.0,,1,1,0,1,,
2236,tt1735335,Darwin,2011,50+,61,18,4,4,4,82.0,,10,8,2,10,7.70,80.0
2237,tt0069162,The Rats Are Coming - The Werewolves Are Here,1972,100+,116,1,8,6,1.8,11.0,,0,0,0,0,,
2238,tt0466460,Khosla Ka Ghosla!,2006,"2,500+",2807,362,42,128,4.2,90.0,,2,2,0,2,,
2239,tt0250292,Cheats,2002,"5,000+",5917,406,131,215,3.9,75.0,,4,0,4,4,,
2240,tt0111102,Second Best,1994,250+,321,45,12,15,3.8,79.0,,5,5,0,5,6.60,100.0
2241,tt0102910,Shock 'Em Dead,1991,250+,353,21,24,14,3.3,47.0,,0,0,0,0,,
2242,tt0219126,The Learning Curve,1999,0,0,0,0,0,,,,1,0,1,1,,
2243,tt1797548,Yeh Faasley,2011,0,0,0,0,0,,,,0,0,0,0,,
2244,tt0795376,Eating Out 2: Sloppy Seconds,2006,"2,500+",4704,435,261,267,3.6,63.0,,16,7,9,16,5.10,44.0
2245,tt0211492,The Luzhin Defence,2000,"1,000+",1259,134,60,55,3.6,69.0,,72,41,31,72,5.90,57.0
2246,tt0467111,A Broken Sole,2006,100+,111,0,1,1,,,,4,0,4,4,,
2247,tt0245674,Thir13en Ghosts,2001,"250,000+",262947,4669,4930,6428,3.2,49.0,,95,18,77,95,3.70,19.0
2248,tt0293703,When Dinosaurs Roamed America,2001,"1,000+",1036,37,14,24,3.9,73.0,,0,0,0,0,,
2249,tt0059403,Love Has Many Faces,1965,Fewer than 50,41,3,5,4,3.2,38.0,,0,0,0,0,,
2250,tt0119631,A Match Made in Heaven,1997,"2,500+",4365,1024,425,583,3.7,71.0,,9,7,2,9,6.40,78.0
2251,tt0131646,Wing Commander,1999,"10,000+",19900,285,830,511,2.3,26.0,,51,5,46,51,3.30,10.0
2252,tt0159373,Cotton Mary,1999,500+,564,6,8,9,2.7,43.0,,33,12,21,33,4.90,36.0
2253,tt0418151,Shake Rattle & Roll IV,1992,Fewer than 50,41,2,3,1,3.1,40.0,,0,0,0,0,,
2254,tt0056941,Come Fly with Me,1963,100+,163,9,7,6,3.5,56.0,,0,0,0,0,,
2255,tt1111833,Super High Me,2007,"5,000+",6188,1127,1080,871,3.3,51.0,,8,5,3,8,5.50,63.0
2256,tt0217630,Loser,2000,"50,000+",52098,837,1535,876,2.9,35.0,,96,23,73,96,4.30,24.0
2257,tt0082612,Kill and Kill Again,1981,"1,000+",1512,16,21,13,3.3,43.0,,0,0,0,0,,
2258,tt10160116,Naan Pesa Ninaipathellam,1993,0,0,0,0,0,,,,0,0,0,0,,
2259,tt0117111,Muqaddar,1996,0,0,0,0,0,,,,0,0,0,0,,
2260,tt0876112,Flushed Away,2006,"100,000+",249930,11244,6078,8042,3.6,65.0,,139,101,38,139,6.70,73.0
2261,tt0227005,Made,2001,"10,000+",18455,1529,776,769,3.6,66.0,,106,75,31,106,6.30,71.0
2262,tt0245825,Chal Mere Bhai,2000,0,0,0,0,0,,,,0,0,0,0,,
2263,tt0216019,Namkeen,1982,0,0,0,0,0,,,,0,0,0,0,,
2264,tt0842929,Paranoid Park,2007,"10,000+",21878,3996,2142,2352,3.5,65.0,,124,95,29,124,7.00,77.0
2265,tt0308129,Conspiracy of Silence,2003,500+,524,14,13,7,3.4,52.0,,25,9,16,25,5.40,36.0
2266,tt0365653,Dinocroc,2004,250+,442,31,73,39,2.6,29.0,,2,0,2,2,,
2267,tt1174704,Partly Cloudy,2008,Fewer than 50,49,27,6,1,3.9,82.0,,0,0,0,0,,
2268,tt0102313,The Linguini Incident,1991,500+,552,80,25,39,3.8,76.0,,4,1,3,4,,
2269,tt0107683,Night Train to Venice,1993,500+,738,7,47,27,1.6,13.0,,0,0,0,0,,
2270,tt0076489,"Oh, God!",1977,"5,000+",8284,341,232,217,3.5,59.0,,28,21,7,28,6.20,75.0
2271,tt0109526,Dallas Doll,1994,Fewer than 50,1,1,0,0,,,,0,0,0,0,,
2272,tt0125209,I Think I Do,1997,"1,000+",1168,60,31,31,3.7,66.0,,5,1,4,5,4.00,20.0
2273,tt0114929,White Wolves II: Legend of the Wild,1996,250+,474,4,5,1,3.2,44.0,,0,0,0,0,,
2274,tt0378793,Speak,2004,"2,500+",4551,1548,434,410,3.9,78.0,,5,4,1,5,8.00,80.0
2275,tt0116848,The Legend of Gator Face,1996,100+,144,9,8,10,3.2,53.0,,0,0,0,0,,
2276,tt0129868,Dennis the Menace Strikes Again!,1998,"10,000+",10706,57,185,98,2.4,24.0,,3,1,2,3,,
2277,tt0271481,Ee Thanutha Veluppan Kalathu,1990,0,0,0,0,0,,,,0,0,0,0,,
2278,tt0188674,Human Traffic,1999,"25,000+",33200,4599,570,1908,4.3,89.0,,30,17,13,30,6.30,57.0
2279,tt0156114,Sundara Kandam,1992,0,0,0,0,0,,,,0,0,0,0,,
2280,tt0084633,Savannah Smiles,1982,"2,500+",2987,277,34,174,4.3,89.0,,1,0,1,1,,
2281,tt0423837,Aswang,1992,100+,234,9,19,19,2.7,32.0,,1,0,1,1,,
2282,tt0068805,The King of Marvin Gardens,1972,"1,000+",1961,185,135,103,3.4,58.0,,32,22,10,32,6.90,69.0
2283,tt0061387,Battle Beneath the Earth,1967,Fewer than 50,22,0,14,6,2,0.0,,1,1,0,1,,
2284,tt0460394,Aithe,2003,Fewer than 50,34,2,0,1,,,,0,0,0,0,,
2285,tt0072684,Barry Lyndon,1975,"25,000+",45306,9954,897,2594,4.4,92.0,,84,73,11,84,8.30,87.0
2286,tt0451187,Room 6,2006,"2,500+",2955,64,277,138,2.3,19.0,,5,1,4,5,4.10,20.0
2287,tt0086565,Wait Till Your Mother Gets Home!,1983,Fewer than 50,35,2,1,1,,,,0,0,0,0,,
2288,tt0351977,Walking Tall,2004,"100,000+",229981,5704,3919,4880,3.5,59.0,,136,36,100,136,4.50,26.0
2289,tt0971170,La león,2007,250+,287,20,13,12,3.4,61.0,,6,5,1,6,6.50,83.0
2290,tt0104837,Meatballs 4,1992,"1,000+",1089,26,84,39,2.4,24.0,,2,0,2,2,,
2291,tt0064691,Moon Zero Two,1969,100+,166,2,51,29,2.1,4.0,,0,0,0,0,,
2292,tt0056089,I Thank a Fool,1962,Fewer than 50,13,2,2,1,,,,0,0,0,0,,
2293,tt0451833,No Entry,2005,"5,000+",7069,312,112,149,3.8,74.0,,4,2,2,4,,
2294,tt0060955,Seconds,1966,"2,500+",4515,796,119,286,4.1,87.0,,61,48,13,61,8.30,79.0
2295,tt0197384,Crime + Punishment in Suburbia,2000,"2,500+",3033,163,121,105,3.5,58.0,,29,6,23,29,3.70,21.0
2296,tt0457400,Land of the Lost,2009,"250,000+",542871,5658,11999,7831,2.7,32.0,,193,50,143,193,4.20,26.0
2297,tt0291711,Agnidevan,1995,0,0,0,0,0,,,,0,0,0,0,,
2298,tt0064156,Chastity,1969,100+,234,11,16,13,3.3,41.0,,5,0,5,5,3.40,0.0
2299,tt0276276,Lawless Heart,2001,500+,581,43,31,27,3.6,58.0,,53,46,7,53,7.20,87.0
2300,tt0110841,A Place for Annie,1994,100+,138,13,6,7,3.9,68.0,,0,0,0,0,,
2301,tt0203019,Men of Honor,2000,"50,000+",77396,6343,1498,2013,4,81.0,,105,44,61,105,5.30,42.0
2302,tt1252380,Camp Rock 2: The Final Jam,2010,"10,000+",22176,1089,879,454,3.4,55.0,,8,5,3,8,6.10,63.0
2303,tt1286146,The Eagle Path,2010,100+,187,9,6,2,3.7,60.0,,0,0,0,0,,
2304,tt0303785,Bollywood/Hollywood,2002,"5,000+",6244,286,207,188,3.4,58.0,,46,19,27,46,4.90,41.0
2305,tt0780622,Teeth,2007,"25,000+",34968,4673,5643,5185,3,45.0,,71,57,14,71,6.50,80.0
2306,tt0282593,I'm with Lucy,2002,"5,000+",5155,200,252,150,3.1,44.0,,2,0,2,2,,
2307,tt1559025,Amish Grace,2010,250+,342,106,37,42,3.8,75.0,,1,1,0,1,,
2308,tt0107824,The Pickle,1993,100+,108,4,14,6,2.7,22.0,,5,1,4,5,4.40,20.0
2309,tt0101874,Final Approach,1991,100+,248,27,12,13,3.6,69.0,,1,0,1,1,,
2310,tt0778661,Daddy's Little Girls,2007,"100,000+",225976,8816,2123,4761,4.1,81.0,,54,14,40,54,4.90,26.0
2311,tt1047832,Linewatch,2008,"1,000+",1406,76,195,115,2.7,28.0,,0,0,0,0,,
2312,tt0802948,American Crime,2007,250+,477,14,59,34,2.3,19.0,,1,0,1,1,,
2313,tt0213096,Muppet Classic Theater,1994,50+,93,30,11,9,4,73.0,,0,0,0,0,,
2314,tt0499570,Slipstream,2007,"2,500+",3526,214,526,443,2.4,29.0,,41,11,30,41,4.40,27.0
2315,tt0178196,Aap Ki Khatir,1977,0,0,0,0,0,,,,0,0,0,0,,
2316,tt0061626,Enter Laughing,1967,Fewer than 50,39,6,10,4,3,38.0,,14,7,7,14,5.30,50.0
2317,tt0339419,The Mudge Boy,2003,"1,000+",2363,334,125,129,3.7,73.0,,26,20,6,26,6.40,77.0
2318,tt0899106,Love happens,2009,"100,000+",125429,2886,4968,2310,2.9,37.0,,111,18,93,111,3.80,16.0
2319,tt0099649,Getting Married in Buffalo Jump,1990,500+,655,5,5,6,3.6,50.0,,0,0,0,0,,
2320,tt0116684,Jane Eyre,1996,"1,000+",1924,218,108,102,3.7,67.0,,2,1,1,2,,
2321,tt1308729,Bullet to the Head,2012,"25,000+",27907,3676,5765,1155,3,39.0,,147,66,81,147,5.10,45.0
2322,tt0066730,10 Rillington Place,1971,"1,000+",1923,364,67,183,4,84.0,,13,8,5,13,6.90,62.0
2323,tt0477647,Footy Legends,2006,500+,897,49,35,46,3.4,58.0,,0,0,0,0,,
2324,tt0101672,Dead On: Relentless II,1992,50+,67,1,11,2,2.5,8.0,,0,0,0,0,,
2325,tt0139809,The Thirteenth Floor,1999,"25,000+",30544,1861,1049,881,3.5,64.0,,63,18,45,63,4.50,29.0
2326,tt1407158,Biswaprakash,1999,0,0,0,0,0,,,,0,0,0,0,,
2327,tt0110076,Hum Aapke Hain Koun..!,1994,"5,000+",6887,665,78,184,4.4,90.0,,3,3,0,3,,
2328,tt0822858,Sublime,2007,"5,000+",6956,408,679,625,2.8,38.0,,6,2,4,6,5.00,33.0
2329,tt0087089,The Cotton Club,1984,"5,000+",7273,557,459,204,3.3,55.0,,31,23,8,31,6.50,74.0
2330,tt0057581,The Thrill of It All,1963,"2,500+",4609,243,92,116,3.8,73.0,,9,8,1,9,6.30,89.0
2331,tt0117628,She's the One,1996,"10,000+",13997,597,868,326,3,41.0,,53,33,20,53,5.90,62.0
2332,tt1020055,Night Train,2009,100+,138,18,12,9,3.3,60.0,,1,0,1,1,,
2333,tt1020055,Night Train,2009,100+,138,18,12,9,3.3,60.0,,1,0,1,1,,
2334,tt0096466,The Wrong Guys,1988,"1,000+",1182,39,39,31,3.3,50.0,,0,0,0,0,,
2335,tt0765141,La question humaine,2007,0,0,0,0,0,,,,0,0,0,0,,
2336,tt0847897,The Stone Angel,2007,"2,500+",3027,198,141,180,3.4,58.0,,25,11,14,25,5.50,44.0
2337,tt0119843,Oscar og Lucinda,1997,"5,000+",5382,389,208,165,3.6,65.0,,33,22,11,33,6.60,67.0
2338,tt0071541,Geetaa Mera Naam,1974,Fewer than 50,1,1,0,0,,,,0,0,0,0,,
2339,tt0061758,Hells Angels on Wheels,1967,"2,500+",2647,51,85,50,2.9,38.0,,7,2,5,7,4.40,29.0
2340,tt0438205,Mad Hot Ballroom,2005,"5,000+",8370,909,181,502,4,83.0,,121,102,19,121,7.20,84.0
2341,tt0433883,The Black Hole,2006,Fewer than 50,2,2,0,0,,,,0,0,0,0,,
2342,tt1733125,Dungeons & Dragons: The Book of Vile Darkness,2012,50+,66,13,35,10,2.5,27.0,,0,0,0,0,,
2343,tt0067245,The Incredible 2-Headed Transplant,1971,100+,188,14,40,31,2.5,26.0,,0,0,0,0,,
2344,tt1298650,Pirates of the Caribbean: On Stranger Tides,2011,"100,000+",200446,35532,30678,12483,3.4,54.0,,278,91,187,278,5.00,33.0
2345,tt0248547,Tholi Prema,1998,0,0,0,0,0,,,,0,0,0,0,,
2346,tt0099197,By Dawn's Early Light,1990,"1,000+",1093,123,44,64,3.8,74.0,,0,0,0,0,,
2347,tt1087527,Trucker,2008,"1,000+",1548,304,226,182,3.4,57.0,,36,21,15,36,5.80,58.0
2348,tt0807054,It's a Free World...,2007,"2,500+",4133,852,353,400,3.6,71.0,,22,19,3,22,6.60,86.0
2349,tt0274636,The Luck of the Irish,2001,"5,000+",5225,293,264,173,3.3,53.0,,3,3,0,3,,
2350,tt0069198,The Ruling Class,1972,"2,500+",4044,505,85,251,4.1,86.0,,13,10,3,13,7.10,77.0
2351,tt1320253,The Expendables,2010,"250,000+",297718,110581,61633,14261,3.7,64.0,,212,88,124,212,5.30,42.0
2352,tt0092263,A Better Tomorrow,1986,"10,000+",18851,2243,265,799,4.1,89.0,,14,13,1,14,7.30,93.0
2353,tt0122690,Ronin,1998,"100,000+",121067,12316,3167,4348,3.9,80.0,,73,51,22,73,6.40,70.0
2354,tt0096936,Blades,1989,500+,993,13,22,22,2.8,37.0,,2,1,1,2,,
2355,tt0197924,The Substitute 3: Winner Takes All,1999,500+,531,13,59,13,2.5,18.0,,3,1,2,3,,
2356,tt0077986,Newsfront,1978,100+,161,21,16,14,3.4,57.0,,5,4,1,5,6.90,80.0
2357,tt0101516,Bugsy,1991,"10,000+",10285,1099,491,369,3.6,69.0,,64,54,10,64,7.00,84.0
2358,tt0092767,Cold Steel,1987,"1,000+",1742,3,25,8,2.2,11.0,,4,0,4,4,,
2359,tt0191996,Essex Boys,2000,"2,500+",4894,275,172,183,3.6,61.0,,6,1,5,6,4.50,17.0
2360,tt0063060,Hellfighters,1968,"5,000+",7062,278,97,135,3.9,74.0,,8,1,7,8,4.10,13.0
2361,tt0441773,Kung Fu Panda,2008,"250,000+",586234,76279,16047,33221,4,83.0,,190,165,25,190,7.10,87.0
2362,tt0441773,Kung Fu Panda,2008,"250,000+",586234,76279,16047,33221,4,83.0,,190,165,25,190,7.10,87.0
2363,tt0928193,San Saba,2008,50+,96,3,4,2,2.9,33.0,,0,0,0,0,,
2364,tt1034431,Bheemaa,2008,0,0,0,0,0,,,,0,0,0,0,,
2365,tt0865297,The Black Balloon,2008,"2,500+",4693,1088,211,506,3.9,84.0,,41,35,6,41,6.90,85.0
2366,tt0339412,Mr. 3000,2004,"25,000+",27323,498,1177,471,2.8,30.0,,113,62,51,113,5.80,55.0
2367,tt0180093,Requiem for a Dream,2000,"250,000+",329036,91165,7280,28631,4.4,93.0,,139,109,30,139,7.40,78.0
2368,tt1587431,Ticked-Off Trannies with Knives,2010,500+,704,59,72,33,3.1,45.0,,7,5,2,7,6.40,71.0
2369,tt0374660,Footpath,2003,100+,210,5,9,4,2.5,36.0,,1,0,1,1,,
2370,tt0079844,Salem's Lot,1979,"25,000+",32016,1452,793,928,3.6,65.0,,18,16,2,18,6.70,89.0
2371,tt1411853,Finding Me,2009,Fewer than 50,14,1,1,0,,,,1,0,1,1,,
2372,tt0093974,"Silent Night, Deadly Night 2",1987,"5,000+",6748,163,425,302,2.3,28.0,,9,2,7,9,4.20,22.0
2373,tt0093159,A Hazard of Hearts,1987,100+,200,23,16,8,3.5,59.0,,0,0,0,0,,
2374,tt0085622,The Grey Fox,1982,500+,777,58,18,21,4.1,76.0,,29,29,0,29,7.90,100.0
2375,tt0320321,Pulan Visaaranai,1990,0,0,0,0,0,,,,0,0,0,0,,
2376,tt0109619,Dialogues with Madwomen,1994,0,0,0,0,0,,,,0,0,0,0,,
2377,tt0091213,Hollywood Vice Squad,1986,50+,93,2,10,6,2.5,17.0,,2,0,2,2,,
2378,tt0097328,Family Business,1989,"5,000+",7806,156,408,111,2.8,28.0,,17,6,11,17,5.10,35.0
2379,tt0245171,Invincible,2001,"2,500+",4694,200,188,123,3.2,51.0,,51,28,23,51,5.90,55.0
2380,tt0245171,Invincible,2001,"2,500+",4694,200,188,123,3.2,51.0,,51,28,23,51,5.90,55.0
2381,tt0245171,Invincible,2001,"2,500+",4694,200,188,123,3.2,51.0,,51,28,23,51,5.90,55.0
2382,tt0155723,A Good Baby,1999,"1,000+",1152,11,6,11,3.6,65.0,,3,1,2,3,,
2383,tt0245171,Invincible,2001,"2,500+",4694,200,188,123,3.2,51.0,,51,28,23,51,5.90,55.0
2384,tt0428620,Half-Life,2008,250+,322,31,24,31,3.2,56.0,,4,3,1,4,,
2385,tt1107860,The Maiden Heist,2009,"50,000+",76751,633,1083,554,3,37.0,,2,1,1,2,,
2386,tt0074751,King Kong,1976,"50,000+",57707,926,2039,1244,2.8,31.0,,49,26,23,49,5.00,53.0
2387,tt0384491,Samay: When Time Strikes,2003,250+,426,27,7,12,3.9,79.0,,0,0,0,0,,
2388,tt0095716,Necromancer,1988,"1,000+",1321,2,9,12,2.3,18.0,,0,0,0,0,,
2389,tt0109402,The Chase,1994,"10,000+",20054,461,783,405,3,37.0,,20,8,12,20,4.80,40.0
2390,tt0236019,Better Than Sex,2000,"2,500+",3872,150,68,76,3.7,69.0,,34,16,18,34,5.00,47.0
2391,tt0120844,Star Trek: Insurrection,1998,"50,000+",63003,3070,3879,1997,3.2,44.0,,78,43,35,78,5.80,55.0
2392,tt0142641,Malice in Wonderland,1982,100+,104,5,2,6,3.4,71.0,,0,0,0,0,,
2393,tt0438123,Mom at Sixteen,2005,"5,000+",7815,460,125,286,4.1,79.0,,0,0,0,0,,
2394,tt0095063,Dream Demon,1988,50+,62,8,10,4,3.2,44.0,,2,1,1,2,,
2395,tt2140203,Wolf Children,2012,"2,500+",2977,1700,142,281,4.3,92.0,,19,18,1,19,8.50,95.0
2396,tt0213512,Bhargavi Nilayam,1964,Fewer than 50,1,1,0,0,,,,0,0,0,0,,
2397,tt1104834,Basement Jack,2009,100+,198,9,62,31,2,13.0,,0,0,0,0,,
2398,tt1536410,Faces in the Crowd,2011,"1,000+",1795,419,814,269,2.9,34.0,,5,0,5,5,3.20,0.0
2399,tt0243655,Wet Hot American Summer,2001,"25,000+",39736,6559,2134,2698,3.9,75.0,,76,29,47,76,5.00,38.0
2400,tt0058954,The Beach Girls and the Monster,1965,50+,63,6,13,10,2.6,32.0,,2,0,2,2,,
2401,tt0117965,The Trigger Effect,1996,"1,000+",2480,100,132,57,3.1,43.0,,26,19,7,26,6.40,73.0
2402,tt0058672,Topkapi,1964,"1,000+",2160,248,119,137,3.6,68.0,,20,18,2,20,7.70,90.0
2403,tt0451060,Frankenstein vs. the Creature from Blood Cove,2005,100+,138,1,3,1,,,,2,1,1,2,,
2404,tt0273516,Dada Sahib,2000,0,0,0,0,0,,,,0,0,0,0,,
2405,tt1336000,Madagascar: Escape 2 Africa,2008,"250,000+",366548,19993,10340,11092,3.6,66.0,,156,100,56,156,5.90,64.0
2406,tt0066895,Carry on at Your Convenience,1971,"1,000+",1205,151,60,66,3.8,72.0,,1,0,1,1,,
2407,tt0949751,Maskeli Besler: Irak,2007,100+,110,0,16,0,1.6,0.0,,0,0,0,0,,
2408,tt0949751,Maskeli Besler: Irak,2007,100+,110,0,16,0,1.6,0.0,,0,0,0,0,,
2409,tt1307068,Seeking a Friend for the End of the World,2012,"50,000+",91208,9622,8635,2652,3.3,53.0,,176,97,79,176,6.10,55.0
2410,tt0106308,Army of Darkness,1992,"100,000+",219123,22030,3420,11659,4.2,87.0,,87,59,28,87,6.60,68.0
2411,tt0409459,Watchmen,2009,"250,000+",1058391,63514,25545,47828,3.7,71.0,,311,202,109,311,6.40,65.0
2412,tt0059091,Dead Birds,1963,50+,79,2,4,2,3,33.0,,0,0,0,0,,
2413,tt0109839,Freedom on My Mind,1994,100+,159,10,3,4,3.9,77.0,,5,5,0,5,8.00,100.0
2414,tt0145937,Naqoyqatsi,2002,"2,500+",4194,420,180,149,3.7,70.0,,52,25,27,52,5.80,48.0
2415,tt0368578,Are We There Yet?,2005,"250,000+",402163,3804,4686,6261,3,45.0,,115,13,102,115,3.40,11.0
2416,tt0250790,Turn of Faith,2002,250+,287,1,6,3,2.7,14.0,,1,0,1,1,,
2417,tt1179056,A Nightmare on Elm Street,2010,"100,000+",200223,18514,24460,9300,3,43.0,,184,26,158,184,3.80,14.0
2418,tt0236964,Akashadoothu,1993,0,0,0,0,0,,,,0,0,0,0,,
2419,tt0177483,Aadmi,1993,0,0,0,0,0,,,,0,0,0,0,,
2420,tt0810922,Take Me Home Tonight,2011,"25,000+",37064,3769,5199,1655,3.1,42.0,,113,32,81,113,4.60,28.0
2421,tt2100380,A Smile as Big as the Moon,2012,50+,60,21,8,5,3.8,72.0,,0,0,0,0,,
2422,tt0810922,Take Me Home Tonight,2011,"25,000+",37064,3769,5199,1655,3.1,42.0,,113,32,81,113,4.60,28.0
2423,tt1185242,Finding Bliss,2009,500+,990,75,178,67,2.8,30.0,,20,6,14,20,3.80,30.0
2424,tt1467349,Jordon Saffron: Taste This!,2009,Fewer than 50,18,2,2,2,,,,1,0,1,1,,
2425,tt0083629,The Beast Within,1982,"1,000+",1616,76,150,79,2.7,34.0,,12,2,10,12,4.30,17.0
2426,tt0114916,When Night Is Falling,1995,"2,500+",4927,473,117,192,4,80.0,,17,9,8,17,5.70,53.0
2427,tt0080711,Fade to Black,1980,"1,000+",1014,73,97,58,3.1,43.0,,12,5,7,12,4.90,42.0
2428,tt1440129,Battleship,2012,"250,000+",456916,31365,26460,8970,3.4,54.0,,229,77,152,229,4.60,34.0
2429,tt10427030,Veettoda Mappillai,2001,0,0,0,0,0,,,,0,0,0,0,,
2430,tt0278475,Haunted Castle,2001,500+,585,15,17,12,2.8,47.0,,12,3,9,12,5.10,25.0
2431,tt0055556,"Two Living, One Dead",1961,0,0,0,0,0,,,,0,0,0,0,,
2432,tt1629757,Chasing Mavericks,2012,"10,000+",19022,3987,1687,586,3.8,70.0,,82,27,55,82,4.90,33.0
2433,tt0811080,Speed Racer,2008,"250,000+",401681,15092,10016,14405,3.4,60.0,,218,91,127,218,5.20,42.0
2434,tt0341266,Bhoot,2003,500+,582,43,49,24,3.2,47.0,,7,5,2,7,5.60,71.0
2435,tt0811080,Speed Racer,2008,"250,000+",401681,15092,10016,14405,3.4,60.0,,218,91,127,218,5.20,42.0
2436,tt0088947,Compromising Positions,1985,50+,99,8,16,8,2.7,33.0,,18,10,8,18,5.20,56.0
2437,tt0318283,Alex & Emma,2003,"50,000+",62762,825,1192,761,3,41.0,,140,15,125,140,3.80,11.0
2438,tt0791303,Genova,2008,"1,000+",2316,320,461,249,3,41.0,,45,35,10,45,6.30,78.0
2439,tt0328877,Hell on Heels: The Battle of Mary Kay,2002,100+,134,6,12,4,3,33.0,,2,2,0,2,,
2440,tt0102800,Robot Jox,1989,"5,000+",5399,270,370,308,3,42.0,,5,2,3,5,4.60,40.0
2441,tt0221838,Borstal Boy,2000,"1,000+",1657,116,72,69,3.5,62.0,,33,15,18,33,5.70,45.0
2442,tt0074878,A Matter of Time,1976,100+,196,6,14,6,2.8,30.0,,9,5,4,9,5.00,56.0
2443,tt0085980,My Tutor,1983,"1,000+",1607,43,70,50,3,38.0,,0,0,0,0,,
2444,tt1023481,Step Up 2: The Streets,2008,"100,000+",190954,27141,8463,14588,4,76.0,,65,18,47,65,4.90,28.0
2445,tt1608631,Rechipo,2009,Fewer than 50,5,1,1,0,,,,0,0,0,0,,
2446,tt0435150,The Lost Tape: Andy's Terrifying Last Days Revealed,2004,0,0,0,0,0,,,,0,0,0,0,,
2447,tt0245832,Chinnari Mutha,1993,0,0,0,0,0,,,,0,0,0,0,,
2448,tt0264898,Miguel/Michelle,1998,0,0,0,0,0,,,,0,0,0,0,,
2449,tt1048174,The World Unseen,2007,"1,000+",1008,157,71,53,3.7,69.0,,27,8,19,27,4.50,30.0
2450,tt0331338,16 Years of Alcohol,2003,"2,500+",2542,138,65,82,3.7,68.0,,15,12,3,15,6.50,80.0
2451,tt0091474,Manhunter,1986,"50,000+",53458,4539,1355,2191,3.8,77.0,,49,46,3,49,8.10,94.0
2452,tt0076202,Intimate Strangers,1977,Fewer than 50,28,2,1,2,,,,0,0,0,0,,
2453,tt0365957,You Got Served,2004,"100,000+",243280,15541,6840,9898,3.7,69.0,,71,10,61,71,4.00,14.0
2454,tt0058525,Rio Conchos,1964,100+,117,17,17,17,3.2,50.0,,7,3,4,7,5.50,43.0
2455,tt1127177,Croc,2007,250+,392,24,95,59,2.4,20.0,,3,0,3,3,,
2456,tt0397551,My Bollywood Bride,2006,"1,000+",1585,39,86,62,2.6,31.0,,0,0,0,0,,
2457,tt1825698,Bulong,2011,50+,51,4,7,7,3.1,36.0,,0,0,0,0,,
2458,tt0062663,L'amour fou,1969,250+,448,35,3,8,4.4,92.0,,11,10,1,11,7.90,91.0
2459,tt0311110,It Runs in the Family,2003,"5,000+",5806,101,251,103,2.8,29.0,,99,29,70,99,4.80,29.0
2460,tt0452701,Undoing,2006,250+,373,8,24,15,2.5,25.0,,13,4,9,13,4.80,31.0
2461,tt2294567,Dhammu,2012,Fewer than 50,1,0,1,0,,,,0,0,0,0,,
2462,tt1078927,Shark Swarm,2008,250+,484,28,97,68,2.1,22.0,,2,0,2,2,,
2463,tt0275207,Aye Auto,1990,0,0,0,0,0,,,,0,0,0,0,,
2464,tt0151582,The Minus Man,1999,"2,500+",4065,206,248,165,3.1,46.0,,36,21,15,36,6.10,58.0
2465,tt0415908,Kaal,2005,"2,500+",3036,85,103,59,3,45.0,,0,0,0,0,,
2466,tt0785004,Just Married: Marriage Was Only the Beginning!,2007,500+,855,29,41,32,3,41.0,,0,0,0,0,,
2467,tt0415908,Kaal,2005,"2,500+",3036,85,103,59,3,45.0,,0,0,0,0,,
2468,tt0258100,Run Ronnie Run,2002,"5,000+",7656,830,330,523,3.8,72.0,,7,5,2,7,6.40,71.0
2469,tt0082350,An Eye for an Eye,1981,"5,000+",8393,68,107,80,3.1,39.0,,4,1,3,4,,
2470,tt1279105,Ramaa: The Saviour,2010,0,0,0,0,0,,,,0,0,0,0,,
2471,tt0201899,A Rumor of Angels,2000,"1,000+",1317,71,24,40,3.9,75.0,,28,9,19,28,4.60,32.0
2472,tt0417871,Klimt,2006,"2,500+",3716,124,311,183,2.5,29.0,,25,8,17,25,5.00,32.0
2473,tt0068156,1776,1972,"5,000+",8511,1018,198,581,4.1,84.0,,19,13,6,19,7.10,68.0
2474,tt0129686,Hornblower: The Even Chance,1998,"1,000+",1023,177,16,57,4.3,92.0,,0,0,0,0,,
2475,tt1778304,Paranormal Activity 3,2011,"50,000+",74897,12597,12126,5274,3.2,51.0,,126,83,43,126,6.00,66.0
2476,tt1606286,Mantra,2007,0,0,0,0,0,,,,0,0,0,0,,
2477,tt0072783,Chupke Chupke,1975,500+,609,172,16,37,4.4,91.0,,2,2,0,2,,
2478,tt0399934,Zombie Honeymoon,2004,"2,500+",4703,160,338,264,2.6,32.0,,10,8,2,10,6.90,80.0
2479,tt1434435,Mother's Day,2010,"10,000+",11631,1126,1039,502,3.3,52.0,,45,19,26,45,4.80,42.0
2480,tt0240347,Arante Mulla Kochu Mulla,1984,0,0,0,0,0,,,,0,0,0,0,,
2481,tt0114473,Sleepstalker,1995,0,0,0,0,0,,,,0,0,0,0,,
2482,tt0364961,Assassination of Richard Nixon,2004,"10,000+",13353,1471,655,771,3.6,69.0,,131,89,42,131,6.60,68.0
2483,tt0280968,My Dear Kuttichaathan,1984,0,0,0,0,0,,,,0,0,0,0,,
2484,tt0322700,I Love Your Work,2003,"5,000+",5102,126,162,143,3,44.0,,30,7,23,30,4.90,23.0
2485,tt0240772,Ocean's Eleven,2001,"250,000+",32601771,105526,26939,969989,3.6,80.0,,186,155,31,186,7.00,83.0
2486,tt0075632,Adalat,1976,Fewer than 50,13,4,2,0,3.7,67.0,,0,0,0,0,,
2487,tt0102187,Karate Cop,1991,500+,522,16,21,21,3,43.0,,0,0,0,0,,
2488,tt0206877,Lava Kusa,1963,0,0,0,0,0,,,,0,0,0,0,,
2489,tt0088074,Secret Honor,1984,"1,000+",2019,225,64,111,3.8,78.0,,13,10,3,13,7.60,77.0
2490,tt0081757,The Wildcats of St. Trinian's,1980,500+,513,7,4,5,3.9,64.0,,0,0,0,0,,
2491,tt0388395,Schultze Gets the Blues,2003,"2,500+",3056,299,111,178,3.7,73.0,,62,45,17,62,6.90,73.0
2492,tt0141109,Jack Frost,1998,"50,000+",64799,1088,1643,1389,2.9,40.0,,58,11,47,58,3.90,19.0
2493,tt0141109,Jack Frost,1998,"50,000+",64799,1088,1643,1389,2.9,40.0,,58,11,47,58,3.90,19.0
2494,tt0093793,Project X,1987,"5,000+",8789,451,363,234,3.4,55.0,,19,14,5,19,6.00,74.0
2495,tt0845554,Yanda Kartavya Aahe,2006,Fewer than 50,11,0,1,0,,,,0,0,0,0,,
2496,tt0359440,Hukumat,1987,0,0,0,0,0,,,,0,0,0,0,,
2497,tt0397882,Ab Tumhare Hawale Watan Saathiyo,2004,Fewer than 50,1,1,0,0,,,,0,0,0,0,,
2498,tt0104822,Martial Law,1990,Fewer than 50,28,5,11,8,2.9,31.0,,0,0,0,0,,
2499,tt0109067,The Air Up There,1994,"10,000+",19855,251,470,224,3,35.0,,28,6,22,28,3.90,21.0
2500,tt0097728,Leningrad Cowboys Go America,1989,"1,000+",2031,453,81,96,4,85.0,,6,6,0,6,7.50,100.0
2501,tt0079639,The North Avenue Irregulars,1979,"1,000+",1084,81,23,50,4,78.0,,9,7,2,9,5.30,78.0
2502,tt0353935,Ramji Rao Speaking,1989,Fewer than 50,1,1,0,0,,,,0,0,0,0,,
2503,tt0475394,Smokin' Aces,2006,"250,000+",338306,26823,16313,18892,3.5,62.0,,158,49,109,158,4.50,31.0
2504,tt0272241,The Piano Man's Daughter,2003,50+,64,1,0,0,,,,0,0,0,0,,
2505,tt0102089,I Still Dream of Jeannie,1991,Fewer than 50,30,5,9,2,2.9,36.0,,0,0,0,0,,
2506,tt0446083,10 MPH,2007,500+,543,50,28,30,3.5,64.0,,5,4,1,5,7.40,80.0
2507,tt0308808,Revolution OS,2001,"1,000+",1070,112,33,47,3.9,77.0,,14,6,8,14,5.80,43.0
2508,tt0158356,Warrant,1975,0,0,0,0,0,,,,0,0,0,0,,
2509,tt0288488,Cover Story,2002,250+,403,3,11,2,2.5,21.0,,0,0,0,0,,
2510,tt1560985,The Devil Inside,2012,"25,000+",45234,3074,10747,3294,2.1,22.0,,89,5,84,89,3.00,6.0
2511,tt0284479,Shararat,2002,100+,127,1,4,2,2.7,20.0,,0,0,0,0,,
2512,tt0284479,Shararat,2002,100+,127,1,4,2,2.7,20.0,,0,0,0,0,,
2513,tt0055097,Look in Any Window,1961,Fewer than 50,1,1,0,0,,,,0,0,0,0,,
2514,tt0804529,Sleep Dealer,2008,"100,000+",116329,404,399,311,3.3,50.0,,33,24,9,33,6.00,73.0
2515,tt0105226,Red Rock West,1993,"5,000+",8266,931,308,283,3.7,75.0,,39,38,1,39,7.50,97.0
2516,tt0831298,I Flunked Sunday School,2006,250+,319,2,0,1,,,,0,0,0,0,,
2517,tt0054295,Seven Thieves,1960,50+,82,10,23,9,3.1,30.0,,4,1,3,4,,
2518,tt0355954,Riding the Bullet,2004,"5,000+",7866,247,489,302,2.8,34.0,,22,5,17,22,4.10,23.0
2519,tt0461936,Don,2006,100+,105,4,4,2,3.1,50.0,,0,0,0,0,,
2520,tt0266712,Laila Majnu,1976,100+,177,10,4,3,4,71.0,,0,0,0,0,,
2521,tt0079236,The Great Gambler,1979,250+,365,17,8,4,3.8,68.0,,0,0,0,0,,
2522,tt0132347,Mystery Men,1999,"100,000+",133399,4574,3473,3813,3.4,57.0,,105,63,42,105,5.80,60.0
2523,tt0772157,Broken English,2007,"10,000+",23979,1848,1139,1095,3.5,62.0,,72,46,26,72,6.30,64.0
2524,tt0131331,Bumbarash,1972,Fewer than 50,1,1,0,0,,,,0,0,0,0,,
2525,tt0063041,Hammerhead,1968,Fewer than 50,3,1,2,1,,,,0,0,0,0,,
2526,tt1213928,Tahaan,2008,100+,239,39,10,30,3.8,80.0,,1,1,0,1,,
2527,tt0083310,Wacko,1982,500+,574,14,21,12,2.9,40.0,,3,2,1,3,,
2528,tt0244750,The Railway Children,1968,"2,500+",4138,281,61,142,4.1,82.0,,16,16,0,16,8.30,100.0
2529,tt1879012,Night of the Living Dead 3D: Re-Animation,2012,100+,102,7,81,31,1.7,8.0,,0,0,0,0,,
2530,tt0101798,Edward II,1991,"1,000+",1355,163,56,60,3.7,75.0,,11,11,0,11,7.60,100.0
2531,tt1709157,The Lost Valentine,2011,500+,546,236,72,79,3.9,77.0,,0,0,0,0,,
2532,tt1690455,Dark Horse,2011,"2,500+",3512,345,498,171,3,41.0,,79,55,24,79,6.20,70.0
2533,tt0193854,A Shot at Glory,2000,"1,000+",1680,88,48,62,3.5,65.0,,21,14,7,21,6.00,67.0
2534,tt0103303,Year of the Gun,1991,"1,000+",1681,17,49,20,2.8,26.0,,7,2,5,7,4.60,29.0
2535,tt1636826,Project X,2012,"50,000+",95589,18446,11960,4181,3.5,61.0,,143,41,102,143,4.40,29.0
2536,tt0412922,Little Manhattan,2005,"10,000+",22787,2964,491,1466,4.1,86.0,,31,24,7,31,6.60,77.0
2537,tt0839928,No Place Like Home,2006,50+,66,0,1,0,,,,0,0,0,0,,
2538,tt0808500,Thuruppu Gulan,2006,0,0,0,0,0,,,,0,0,0,0,,
2539,tt0108316,Texas,1994,100+,112,6,10,2,2.8,38.0,,1,0,1,1,,
2540,tt0107249,Jaagruti,1993,50+,69,0,3,0,,,,0,0,0,0,,
2541,tt0481273,The Curiosity of Chance,2006,500+,831,145,93,81,3.6,61.0,,1,1,0,1,,
2542,tt0069436,Ulzana's Raid,1972,"1,000+",1201,104,53,40,3.5,66.0,,10,9,1,10,6.60,90.0
2543,tt0440590,Loha,1997,100+,135,5,1,1,4.4,83.0,,0,0,0,0,,
2544,tt0482913,Bus Conductor,2005,0,0,0,0,0,,,,0,0,0,0,,
2545,tt0185547,Ninth Street,1999,250+,277,3,1,2,,,,0,0,0,0,,
2546,tt0065970,The Lawyer,1970,0,0,0,0,0,,,,0,0,0,0,,
2547,tt0100740,Tales from the Darkside: The Movie,1990,"5,000+",9355,456,574,307,3.1,44.0,,24,11,13,24,4.90,46.0
2548,tt1587857,Shatru,1984,0,0,0,0,0,,,,0,0,0,0,,
2549,tt0790808,Forbidden Lie$,2007,"1,000+",2249,101,15,64,4,87.0,,35,32,3,35,7.60,91.0
2550,tt1636629,The 7 Adventures of Sinbad,2010,100+,209,3,63,24,1.4,5.0,,0,0,0,0,,
2551,tt0239670,Mortel transfert,2001,100+,241,16,18,5,3.1,47.0,,2,1,1,2,,
2552,tt0112625,Candyman: Farewell to the Flesh,1995,"50,000+",51660,318,748,456,2.8,30.0,,32,7,25,32,4.30,22.0
2553,tt1500491,Death Race 2,2010,"2,500+",4003,758,1284,531,2.9,37.0,,6,1,5,6,3.90,17.0
2554,tt0923954,Truth About Kerry,2010,Fewer than 50,32,5,10,2,2.7,33.0,,0,0,0,0,,
2555,tt0092605,Baby Boom,1987,"25,000+",28482,912,566,480,3.6,62.0,,46,31,15,46,6.00,67.0
2556,tt0105215,Rain Without Thunder,1992,100+,212,9,5,3,3.6,64.0,,6,3,3,6,5.70,50.0
2557,tt0098184,Relentless,1989,"1,000+",1486,21,43,29,3,33.0,,6,3,3,6,5.10,50.0
2558,tt0079822,Roller Boogie,1979,"1,000+",2422,103,87,109,3.4,54.0,,7,0,7,7,3.00,0.0
2559,tt1887807,Mappillai,2011,0,0,0,0,0,,,,0,0,0,0,,
2560,tt1046953,"Maaf, Saya Menghamili Istri Anda",2007,0,0,0,0,0,,,,0,0,0,0,,
2561,tt0892113,Waris Shah: Ishq Daa Waaris,2006,250+,470,28,7,12,4.2,80.0,,0,0,0,0,,
2562,tt0073418,Murder on Flight 502,1975,100+,117,4,8,5,2.8,33.0,,0,0,0,0,,
2563,tt1024715,Choke,2008,0,0,0,0,0,,,,0,0,0,0,,
2564,tt0280720,The Guru,2002,"10,000+",19129,533,804,412,2.9,40.0,,89,51,38,89,5.70,57.0
2565,tt0832296,Anumanaspadam,2007,100+,149,0,1,0,,,,0,0,0,0,,
2566,tt1817676,Girl in Progress,2012,"50,000+",56941,1651,1459,184,3.5,53.0,,45,15,30,45,4.60,33.0
2567,tt1251743,Salvation Boulevard,2011,"1,000+",1331,86,284,69,2.6,23.0,,36,8,28,36,4.30,22.0
2568,tt0088402,The Wild Life,1984,500+,839,70,99,54,3.1,41.0,,1,0,1,1,,
2569,tt0077890,The Magic of Lassie,1978,250+,385,20,11,8,3.8,65.0,,0,0,0,0,,
2570,tt0118768,The Brave,1997,"10,000+",13359,656,316,341,3.7,68.0,,6,2,4,6,4.30,33.0
2571,tt1677707,I'll Be There,2010,0,0,0,0,0,,,,0,0,0,0,,
2572,tt0225071,Angel Eyes,2001,"50,000+",66186,901,1082,724,3.1,46.0,,132,42,90,132,4.80,32.0
2573,tt0097813,Main Tera Dushman,1989,0,0,0,0,0,,,,0,0,0,0,,
2574,tt1458175,The Next Three Days,2010,"50,000+",51864,10910,5707,3937,3.6,66.0,,170,85,85,170,5.80,50.0
2575,tt0406816,The Guardian,2006,"250,000+",423197,17074,4164,13004,4,80.0,,150,55,95,150,5.20,37.0
2576,tt0099578,The First Power,1990,"5,000+",5894,99,121,81,3.1,45.0,,12,3,9,12,3.60,25.0
2577,tt0062790,The Charge of the Light Brigade,1968,"1,000+",1627,94,62,68,3.5,60.0,,5,3,2,5,6.50,60.0
2578,tt0758746,Friday the 13th,2009,"100,000+",222267,9491,10926,11095,3.1,47.0,,176,44,132,176,4.20,25.0
2579,tt2384356,No Entry: Pudhe Dhoka Aahey,2012,Fewer than 50,12,1,1,0,,,,0,0,0,0,,
2580,tt0315850,El bonaerense,2002,100+,105,15,18,3,3.4,45.0,,11,10,1,11,6.70,91.0
2581,tt0062432,The Venetian Affair,1966,Fewer than 50,40,5,10,6,2.6,33.0,,0,0,0,0,,
2582,tt0056210,Mafioso,1962,500+,778,170,42,80,3.8,80.0,,49,47,2,49,8.20,96.0
2583,tt0063970,100 Rifler,1969,500+,882,56,78,50,3.1,42.0,,2,0,2,2,,
2584,tt0381864,Ahista Ahista,1981,0,0,0,0,0,,,,0,0,0,0,,
2585,tt0446687,Driving Lessons,2006,"100,000+",194288,4054,1641,3417,3.7,71.0,,75,36,39,75,5.20,48.0
2586,tt0065582,Cover Me Babe,1970,50+,95,1,2,1,,,,0,0,0,0,,
2587,tt0293435,Murder by Numbers,2004,"50,000+",61992,2540,2653,1552,3.2,49.0,,128,38,90,128,5.30,30.0
2588,tt0386792,Something the Lord Made,2004,"5,000+",9024,1419,107,599,4.3,93.0,,2,2,0,2,,
2589,tt0351885,Tweek City,2005,500+,610,13,21,19,2.8,38.0,,0,0,0,0,,
2590,tt0120618,Breakfast of Champions,1999,"5,000+",6017,142,310,181,2.5,31.0,,48,12,36,48,4.50,25.0
2591,tt0902274,Death on Demand,2008,250+,283,9,40,24,2,18.0,,1,0,1,1,,
2592,tt0411295,Doggy Poo,2003,"1,000+",2061,66,48,75,3.5,58.0,,2,2,0,2,,
2593,tt0410764,Tideland,2005,"25,000+",45333,3652,2092,2802,3.5,64.0,,77,23,54,77,4.50,30.0
2594,tt0068217,Anuraag,1972,0,0,0,0,0,,,,0,0,0,0,,
2595,tt1541995,Snow Flower and the Secret Fan,2011,"5,000+",6418,386,425,198,3.2,48.0,,90,20,70,90,4.50,22.0
2596,tt0447999,Hot Tamale,2006,"2,500+",2725,30,53,37,2.9,36.0,,0,0,0,0,,
2597,tt0783598,Until Death,2007,"2,500+",3771,220,351,254,2.9,39.0,,2,1,1,2,,
2598,tt1041829,The Proposal,2009,0,0,0,0,0,,,,0,0,0,0,,
2599,tt12826796,Sahasram,2010,0,0,0,0,0,,,,0,0,0,0,,
2600,tt0382717,Life of the Party,2005,250+,351,13,20,17,2.9,39.0,,1,0,1,1,,
2601,tt0925248,In the Shadow of the Moon,2007,"5,000+",6164,1412,141,859,4.2,91.0,,112,106,6,112,7.90,95.0
2602,tt0059944,Zebra in the Kitchen,1965,250+,263,6,7,6,3.1,46.0,,0,0,0,0,,
2603,tt0120382,The Truman Show,1998,"250,000+",585108,52494,6586,19738,4.1,89.0,,162,153,9,162,8.50,94.0
2604,tt1545315,Needle,2010,Fewer than 50,1,0,1,0,,,,0,0,0,0,,
2605,tt0073091,The Happy Hooker,1975,Fewer than 50,2,0,2,0,,,,1,0,1,1,,
2606,tt0160216,A Dog of Flanders,1999,500+,825,54,30,32,3.5,64.0,,25,6,19,25,5.00,24.0
2607,tt0120157,Soldier,1998,Fewer than 50,27,13,14,8,3.2,48.0,,2,2,0,2,,
2608,tt0928390,Imaginary Playmate,2006,250+,263,27,28,16,3,49.0,,0,0,0,0,,
2609,tt0156903,Pooja Ke Phool,1964,0,0,0,0,0,,,,0,0,0,0,,
2610,tt0104612,A Killer Among Friends,1992,Fewer than 50,22,3,3,0,3.8,50.0,,1,1,0,1,,
2611,tt0093778,The Princess Academy,1987,Fewer than 50,14,3,3,3,2.3,50.0,,0,0,0,0,,
2612,tt0896534,Deadgirl,2008,"2,500+",3450,636,937,661,2.9,40.0,,19,7,12,19,4.70,37.0
2613,tt0127497,Dancehall Queen,1997,"2,500+",3824,225,38,107,4.3,85.0,,3,3,0,3,,
2614,tt0297450,VeggieTales: The Ultimate Silly Song Countdown,2001,"2,500+",2814,143,20,71,4.3,88.0,,0,0,0,0,,
2615,tt0061653,Fathom,1967,250+,417,32,46,36,3.2,41.0,,6,2,4,6,5.00,33.0
2616,tt0165929,Romeo Must Die,2000,"100,000+",192296,4102,2669,3025,3.5,61.0,,94,30,64,94,4.80,32.0
2617,tt0203523,George Lucas in Love,1999,"2,500+",3837,170,35,77,4,83.0,,9,7,2,9,6.90,78.0
2618,tt0310805,The Brotherhood III: Young Demons,2002,100+,145,4,9,7,2.2,31.0,,0,0,0,0,,
2619,tt0310805,The Brotherhood III: Young Demons,2002,100+,145,4,9,7,2.2,31.0,,0,0,0,0,,
2620,tt0054095,The Mountain Road,1960,Fewer than 50,27,9,6,4,3.4,60.0,,1,1,0,1,,
2621,tt0117659,Sins of Silence,1996,250+,260,6,5,4,3.7,55.0,,0,0,0,0,,
2622,tt0160672,Joe the King,1999,"1,000+",1493,121,48,64,3.7,72.0,,28,19,9,28,6.20,68.0
2623,tt0071850,Mixed Company,1974,50+,71,3,2,2,4.2,60.0,,0,0,0,0,,
2624,tt1017430,Days of Wrath,2008,250+,436,115,31,39,3.8,79.0,,7,7,0,7,7.20,100.0
2625,tt0343095,This Girl's Life,2003,"1,000+",1868,125,160,107,3.1,44.0,,8,4,4,8,5.60,50.0
2626,tt0314706,Soora Samhaaram,1988,0,0,0,0,0,,,,0,0,0,0,,
2627,tt0234407,Our Song,2000,"1,000+",1162,91,21,29,4,81.0,,55,50,5,55,7.30,91.0
2628,tt0075859,The Clones of Bruce Lee,1980,Fewer than 50,35,2,5,4,2.2,29.0,,0,0,0,0,,
2629,tt0420015,Nine Lives,2005,"10,000+",21729,632,307,313,3.6,67.0,,87,66,21,87,6.90,76.0
2630,tt0420015,Nine Lives,2005,"10,000+",21729,632,307,313,3.6,67.0,,87,66,21,87,6.90,76.0
2631,tt0445236,The Brotherhood IV: The Complex,2005,100+,207,5,10,4,2.7,33.0,,0,0,0,0,,
2632,tt0098073,Penn & Teller Get Killed,1989,250+,489,86,62,41,3.4,58.0,,8,2,6,8,4.60,25.0
2633,tt0083717,Cannery Row,1982,500+,987,119,48,55,3.8,71.0,,8,6,2,8,6.60,75.0
2634,tt0243664,Wit,2001,"5,000+",7840,1236,128,552,4.3,91.0,,12,10,2,12,6.50,83.0
2635,tt0383304,Deepwater,2005,"2,500+",4125,63,129,91,2.8,33.0,,4,4,0,4,,
2636,tt0128453,Savage Harvest,1994,50+,98,4,4,4,2.8,50.0,,2,0,2,2,,
2637,tt0402850,The Big White,2005,"5,000+",7864,639,503,401,3.3,56.0,,10,3,7,10,4.00,30.0
2638,tt0109021,8 Seconds,1994,"50,000+",56362,3662,246,1740,4.6,94.0,,13,4,9,13,5.20,31.0
2639,tt0055987,Five Finger Exercise,1962,Fewer than 50,4,1,1,0,,,,2,0,2,2,,
2640,tt0101742,Deewana Mujh Sa Nahin,1990,250+,441,8,13,1,2.8,38.0,,0,0,0,0,,
2641,tt0068990,Napoleon and Samantha,1972,"1,000+",1668,23,29,22,3.1,44.0,,1,1,0,1,,
2642,tt0088683,Agnes of God,1985,"5,000+",6804,249,209,131,3.3,54.0,,31,13,18,31,5.80,42.0
2643,tt2077833,Rowdy Rathore,2012,"2,500+",2552,214,173,91,3.3,55.0,,13,7,6,13,4.60,54.0
2644,tt0427470,The Lookout,2007,"50,000+",80783,9382,3356,4961,3.7,74.0,,168,146,22,168,7.30,87.0
2645,tt0464106,Manmadhan,2004,Fewer than 50,1,1,0,0,,,,0,0,0,0,,
2646,tt0070198,House of the Living Dead,1974,250+,451,2,14,8,2,12.0,,0,0,0,0,,
2647,tt0098354,Society,1989,"2,500+",4353,572,380,297,3.6,60.0,,14,9,5,14,5.70,64.0
2648,tt0283534,The Parole Officer,2001,"5,000+",6190,359,213,223,3.5,63.0,,7,4,3,7,6.00,57.0
2649,tt1351669,Talentime,2009,50+,54,14,1,5,4.3,93.0,,1,0,1,1,,
2650,tt0423294,Surf's Up,2007,"250,000+",631499,25896,11217,17978,3.7,70.0,,148,117,31,148,6.70,79.0
2651,tt0847167,The Girl in the Park,2007,"1,000+",1514,187,271,165,3.1,41.0,,14,10,4,14,5.70,71.0
2652,tt0246805,Navarathri,1964,0,0,0,0,0,,,,0,0,0,0,,
2653,tt0914845,Familiar Strangers,2008,250+,403,36,40,28,3.3,48.0,,5,2,3,5,5.00,40.0
2654,tt0080010,Test pilota Pirxa,1979,50+,57,11,5,4,3.4,69.0,,1,1,0,1,,
2655,tt0765447,Evening,2007,"100,000+",123723,4013,4286,4170,3.2,48.0,,129,35,94,129,4.90,27.0
2656,tt0213149,Pearl Harbor,2001,"250,000+",905740,31270,15912,28654,3.6,66.0,,194,46,148,194,4.50,24.0
2657,tt1013752,Fast & Furious,2009,"250,000+",492158,28667,14265,19354,3.7,67.0,,179,51,128,179,4.60,28.0
2658,tt0469899,Dr. Chopper,2005,100+,106,5,13,6,2.2,28.0,,0,0,0,0,,
2659,tt0119842,Orphans,1998,500+,520,87,26,40,3.9,77.0,,19,9,10,19,6.30,47.0
2660,tt0297389,Poster Boy,2004,"1,000+",1490,85,98,87,3.1,47.0,,20,6,14,20,4.50,30.0
2661,tt0073692,Shampoo,1975,"5,000+",6528,466,414,288,3.3,53.0,,39,26,13,39,6.60,67.0
2662,tt0116213,Eraser,1996,"100,000+",126871,2340,3584,1828,3.1,39.0,,54,23,31,54,5.10,43.0
2663,tt0285487,Crazy as Hell,2002,"1,000+",1078,59,47,51,3.4,56.0,,15,8,7,15,5.40,53.0
2664,tt0384597,Pulival Kalyanam,2003,0,0,0,0,0,,,,0,0,0,0,,
2665,tt0388500,Beauty Shop,2005,"50,000+",65193,2427,1486,1678,3.6,62.0,,119,45,74,119,5.30,38.0
2666,tt1085382,Chicago Overcoat,2009,100+,147,58,33,22,3.8,64.0,,0,0,0,0,,
2667,tt1821329,Arjunan Saakshi,2011,Fewer than 50,12,2,2,0,,,,0,0,0,0,,
2668,tt0454970,Turistas,2006,"50,000+",83534,1526,3904,3039,2.6,28.0,,106,20,86,106,4.00,19.0
2669,tt0420223,Stranger Than Fiction,2006,"250,000+",402242,53096,9668,29416,4,85.0,,177,130,47,177,6.90,73.0
2670,tt0126765,23,1998,"5,000+",5551,341,95,102,3.9,78.0,,1,1,0,1,,
2671,tt0420223,Stranger Than Fiction,2006,"250,000+",402242,53096,9668,29416,4,85.0,,177,130,47,177,6.90,73.0
2672,tt0102989,Straight Out of Brooklyn,1991,500+,965,35,23,17,3.5,60.0,,10,8,2,10,6.30,80.0
2673,tt0120695,From Dusk Till Dawn 3: The Hangman's Daughter,1999,"10,000+",14518,240,786,285,2.5,23.0,,9,2,7,9,5.30,22.0
2674,tt1132626,Saw V,2008,"100,000+",239801,9515,8840,7423,3.3,52.0,,77,10,67,77,3.10,13.0
2675,tt1381767,Flicka 2,2010,500+,787,188,74,53,3.9,72.0,,3,2,1,3,,
2676,tt0103763,Balwaan,1992,0,0,0,0,0,,,,0,0,0,0,,
2677,tt0103859,Boomerang,1992,0,0,0,0,0,,,,0,0,0,0,,
2678,tt0421729,Big Momma's House 2,2006,"250,000+",564810,6868,5082,12767,3.4,58.0,,74,4,70,74,3.10,5.0
2679,tt12828476,Killadi Raman,2011,0,0,0,0,0,,,,0,0,0,0,,
2680,tt1346256,Crazy Gopalan,2008,Fewer than 50,19,1,0,0,,,,0,0,0,0,,
2681,tt0438981,Silsiilay,2005,250+,330,5,15,2,2.5,25.0,,0,0,0,0,,
2682,tt0103239,Wedlock,1991,"2,500+",3068,72,128,52,3,36.0,,3,2,1,3,,
2683,tt0326835,Dot the I,2003,"5,000+",8348,1216,390,520,3.9,76.0,,58,15,43,58,4.70,26.0
2684,tt0206238,Raaz,1967,100+,121,3,0,1,,,,0,0,0,0,,
2685,tt0390614,Waqt: The Race Against Time,2005,"2,500+",2805,185,77,88,3.7,71.0,,1,1,0,1,,
2686,tt0147004,Little Voice,1998,"10,000+",12725,1075,376,450,3.7,74.0,,50,40,10,50,7.10,80.0
2687,tt0080741,"Fist of Fear, Touch of Death",1980,"1,000+",2234,26,40,30,2.7,39.0,,2,0,2,2,,
2688,tt0409034,Marilyn Hotchkiss' Ballroom Dancing & Charm School,2005,"2,500+",4972,296,181,254,3.5,62.0,,59,13,46,59,4.80,22.0
2689,tt0393596,Pixel Perfect,2004,"5,000+",8976,290,180,215,3.6,62.0,,1,0,1,1,,
2690,tt0088300,Sidewalks of Bangkok,1984,50+,81,1,6,1,1.9,14.0,,0,0,0,0,,
2691,tt0106655,Damini,1993,100+,150,19,3,3,4,86.0,,0,0,0,0,,
2692,tt0368413,Echoes of Innocence,2005,250+,312,10,6,7,3.8,62.0,,7,0,7,7,3.10,0.0
2693,tt0460732,Caffeine,2006,"2,500+",4476,179,279,240,2.9,39.0,,9,0,9,9,3.20,0.0
2694,tt0109078,Alien Nation: Dark Horizon,1994,100+,126,15,10,1,3.6,60.0,,0,0,0,0,,
2695,tt0054817,Five Minutes to Live,1961,100+,121,12,27,18,2.7,32.0,,2,1,1,2,,
2696,tt0117190,No Greater Love,1995,Fewer than 50,32,3,10,2,2.9,23.0,,0,0,0,0,,
2697,tt0462329,The Hard Corps,2006,"2,500+",4463,124,260,129,2.8,32.0,,2,2,0,2,,
2698,tt1102316,One More Chance,2007,"1,000+",1061,137,11,75,4.4,93.0,,0,0,0,0,,
2699,tt1102316,One More Chance,2007,"1,000+",1061,137,11,75,4.4,93.0,,0,0,0,0,,
2700,tt0071532,The Gambler,1974,"1,000+",1258,165,50,52,3.7,77.0,,11,9,2,11,7.30,82.0
2701,tt0757953,White Lady,2006,500+,652,14,9,9,3.2,61.0,,0,0,0,0,,
2702,tt1577065,Sinbad and the Minotaur,2011,50+,96,7,33,10,2,18.0,,0,0,0,0,,
2703,tt0059715,Story of a Prostitute,1965,250+,382,67,16,22,3.9,81.0,,3,3,0,3,,
2704,tt2009407,A Aa E Ee,2009,0,0,0,0,0,,,,0,0,0,0,,
2705,tt0888019,Five Across the Eyes,2006,500+,504,24,132,110,1.6,15.0,,2,1,1,2,,
2706,tt0403203,Kiss of Death,1997,"5,000+",9411,363,603,221,3,38.0,,40,27,13,40,6.70,68.0
2707,tt0066847,Blood Thirst,1971,Fewer than 50,48,2,5,3,2.7,29.0,,1,0,1,1,,
2708,tt0473705,State of Play,2009,"100,000+",124543,12204,4545,6342,3.6,73.0,,216,182,34,216,6.90,84.0
2709,tt1226240,A Late Quartet,2012,"5,000+",9493,1274,531,302,3.6,71.0,,112,86,26,112,6.50,77.0
2710,tt1217590,An Old Fashioned Thanksgiving,2008,100+,186,23,21,19,3.6,52.0,,0,0,0,0,,
2711,tt0997033,Athisayan,2007,0,0,0,0,0,,,,0,0,0,0,,
2712,tt0910936,Pineapple Express,2008,"250,000+",302736,39143,14420,20822,3.7,73.0,,202,138,64,202,6.30,68.0
2713,tt0068014,Zeppelin,1971,100+,101,13,13,4,3.2,50.0,,4,3,1,4,,
2714,tt0108568,Wild Cactus,1993,50+,59,3,0,0,,,,0,0,0,0,,
2715,tt0119905,The Players Club,1998,"25,000+",29489,1999,353,626,4.3,85.0,,17,6,11,17,5.20,35.0
2716,tt1598822,New Year's Eve,2011,"50,000+",81408,8119,9920,2416,3.1,45.0,,142,10,132,142,3.20,7.0
2717,tt0183884,This Is Not a Test,1962,100+,175,10,23,15,2.9,30.0,,0,0,0,0,,
2718,tt1601235,Togetherness Supreme,2010,Fewer than 50,5,1,0,1,,,,0,0,0,0,,
2719,tt0309593,Final Destination 2,2003,"250,000+",450024,12619,9080,11262,3.4,58.0,,111,56,55,111,5.00,50.0
2720,tt0988595,27 Dresses,2008,"250,000+",606192,142481,108364,27288,3.4,57.0,,154,62,92,154,5.00,40.0
2721,tt0174360,Zombie Bloodbath,1993,100+,164,8,16,8,2.4,33.0,,0,0,0,0,,
2722,tt0055490,Susan Slade,1961,50+,80,10,9,5,3.2,53.0,,0,0,0,0,,
2723,tt0284034,Demonlover,2002,"2,500+",2947,144,214,143,2.9,40.0,,85,45,40,85,5.70,53.0
2724,tt0078078,Petey Wheatstraw,1977,"1,000+",1196,48,43,52,3.4,53.0,,2,2,0,2,,
2725,tt0441741,The Cabinet of Dr. Caligari,2005,"1,000+",1570,116,65,76,3.5,64.0,,6,2,4,6,4.60,33.0
2726,tt0446266,Achuvinte Amma,2005,0,0,0,0,0,,,,0,0,0,0,,
2727,tt1203517,The Graves,2009,250+,461,26,187,83,2,12.0,,2,0,2,2,,
2728,tt0112469,Beastmaster III: The Eye of Braxus,1996,100+,112,10,33,8,2.4,23.0,,0,0,0,0,,
2729,tt0438315,Peaceful Warrior,2006,"25,000+",43070,2857,899,1895,3.9,76.0,,71,18,53,71,4.70,25.0
2730,tt0213682,Taboo,1999,"1,000+",2071,28,133,70,2,18.0,,4,0,4,4,,
2731,tt1132288,The Tenth Circle,2008,250+,406,41,81,37,2.9,34.0,,1,0,1,1,,
2732,tt0392465,Mozart and the Whale,2005,"5,000+",9304,1511,385,763,3.9,80.0,,4,2,2,4,,
2733,tt0107870,Prehysteria!,1993,"1,000+",1240,50,77,52,3,39.0,,2,1,1,2,,
2734,tt0055571,Underworld U.S.A.,1961,500+,587,80,18,36,3.9,82.0,,5,5,0,5,7.40,100.0
2735,tt0404163,Even Money,2006,"5,000+",6553,192,479,329,2.7,29.0,,34,8,26,34,4.00,24.0
2736,tt0089092,Enemy Mine,1985,"10,000+",21551,1662,773,827,3.6,68.0,,27,16,11,27,5.70,59.0
2737,tt1713452,Half Moon,2010,Fewer than 50,19,1,6,3,1.6,14.0,,2,2,0,2,,
2738,tt0096321,Twister,1989,"10,000+",19264,65,81,135,3,45.0,,0,0,0,0,,
2739,tt0424823,Balls of Fury,2007,"250,000+",324055,9207,19135,12360,2.7,33.0,,131,28,103,131,4.40,21.0
2740,tt0841108,Hannah Takes the Stairs,2007,"2,500+",2811,156,195,132,3,45.0,,46,27,19,46,5.80,59.0
2741,tt0831840,Ahista Ahista,2006,100+,246,21,18,9,3.2,54.0,,0,0,0,0,,
2742,tt1020937,Awarapan,2007,"1,000+",2483,334,66,161,4.2,84.0,,1,0,1,1,,
2743,tt0055872,The Creation of the Humanoids,1962,100+,136,18,22,18,3.1,45.0,,1,1,0,1,,
2744,tt0997170,Ore Kadal,2007,100+,106,7,2,0,4,78.0,,0,0,0,0,,
2745,tt0828151,Molly: An American Girl on the Home Front,2006,500+,698,91,43,38,3.8,68.0,,0,0,0,0,,
2746,tt0114467,Skyscraper,1996,"1,000+",1294,34,51,39,2.7,40.0,,3,0,3,3,,
2747,tt0082594,Kaalia,1981,250+,285,16,7,3,3.8,70.0,,0,0,0,0,,
2748,tt0062503,Work Is a Four Letter Word,1968,Fewer than 50,15,2,2,3,,,,0,0,0,0,,
2749,tt0370263,Alien vs. Predator,2004,"250,000+",431058,11493,18183,16675,2.9,39.0,,146,32,114,146,4.30,22.0
2750,tt0068425,The Cremators,1972,50+,70,1,7,3,1.5,12.0,,1,0,1,1,,
2751,tt0361772,Jeete Hain Shaan Se,1988,0,0,0,0,0,,,,0,0,0,0,,
2752,tt1927165,Thoonga Nagaram,2011,0,0,0,0,0,,,,0,0,0,0,,
2753,tt0802821,Pandemic,2007,50+,65,7,11,6,2.9,39.0,,0,0,0,0,,
2754,tt0106379,Being Human,1994,"2,500+",3227,86,120,63,3,42.0,,13,7,6,13,5.10,54.0
2755,tt1830786,Rascals,2011,500+,840,16,57,22,2.3,22.0,,2,0,2,2,,
2756,tt0495351,In the Shadow of the Palms - Iraq,2005,0,0,0,0,0,,,,0,0,0,0,,
2757,tt0929235,At the Death House Door,2008,250+,359,56,13,33,4,81.0,,11,11,0,11,7.70,100.0
2758,tt0116324,Flirting with Disaster,1996,"5,000+",9657,1208,551,441,3.6,69.0,,56,49,7,56,7.60,88.0
2759,tt0808342,The Last Trimester,2007,100+,125,14,13,9,3.2,52.0,,0,0,0,0,,
2760,tt0112443,Bad Company,1995,"5,000+",5715,38,85,27,2.8,31.0,,11,3,8,11,4.20,27.0
2761,tt0315775,Anne B. Real,2003,100+,110,8,11,6,2.8,42.0,,0,0,0,0,,
2762,tt1405493,Bor Asbe Ekhuni,2008,0,0,0,0,0,,,,0,0,0,0,,
2763,tt0157460,Chitchor,1976,50+,64,6,0,1,4.1,100.0,,1,1,0,1,,
2764,tt0370986,Mysterious Skin,2004,"25,000+",38037,7372,925,2801,4.1,89.0,,113,98,15,113,7.40,87.0
2765,tt0184510,Get Bruce,1999,500+,931,25,32,9,2.9,44.0,,18,13,5,18,6.40,72.0
2766,tt0070634,The Satanic Rites of Dracula,1973,"2,500+",3833,112,263,171,2.7,30.0,,6,2,4,6,5.00,33.0
2767,tt0118763,The Boys Club,1996,"1,000+",1135,37,36,18,3.4,51.0,,4,2,2,4,,
2768,tt1626135,Balls to the Wall,2011,50+,64,2,22,7,1.9,8.0,,0,0,0,0,,
2769,tt0978759,Frozen River,2008,"50,000+",85897,2821,970,1666,3.7,74.0,,139,123,16,139,7.30,88.0
2770,tt2015462,Payback Season,2012,100+,118,7,50,9,2,12.0,,12,1,11,12,3.50,8.0
2771,tt0353671,Ljeto u zlatnoj dolini,2003,Fewer than 50,8,2,3,0,3.5,40.0,,1,0,1,1,,
2772,tt0256276,Possession,2002,"5,000+",8223,721,529,348,3.4,58.0,,156,99,57,156,6.30,63.0
2773,tt1334537,Humpday,2009,"10,000+",18760,659,639,465,3.1,51.0,,137,108,29,137,6.70,79.0
2774,tt0463379,Testosteroni,2004,500+,554,120,68,33,3.5,64.0,,0,0,0,0,,
2775,tt0069795,Blackenstein,1973,100+,137,5,44,21,1.9,10.0,,3,0,3,3,,
2776,tt0995863,Rest Stop: Don't Look Back,2008,"1,000+",1505,88,303,193,2.5,22.0,,1,1,0,1,,
2777,tt0074799,The Likely Lads,1976,250+,466,29,8,13,3.9,78.0,,0,0,0,0,,
2778,tt0086232,Sahara,1983,500+,502,40,32,21,3.3,56.0,,1,0,1,1,,
2779,tt1204031,Defying Gravity,2008,50+,67,2,5,5,2.9,29.0,,0,0,0,0,,
2780,tt0109518,Cyborg Cop II,1994,100+,109,3,19,7,2.2,14.0,,0,0,0,0,,
2781,tt0409527,Shabd,2005,"1,000+",2358,64,71,44,3.2,47.0,,0,0,0,0,,
2782,tt0150216,Cradle Will Rock,1999,"5,000+",6945,507,207,209,3.7,71.0,,74,48,26,74,6.30,65.0
2783,tt0071993,The Phantom of Hollywood,1974,0,0,0,0,0,,,,0,0,0,0,,
2784,tt0404802,The Notorious Bettie Page,2005,"50,000+",50110,1138,1103,1087,3.3,51.0,,134,78,56,134,6.00,58.0
2785,tt0379265,Outing Riley,2004,50+,52,12,6,5,3.7,67.0,,3,2,1,3,,
2786,tt0373801,Dost,1989,0,0,0,0,0,,,,0,0,0,0,,
2787,tt4108028,Seventh Son,2014,"50,000+",53762,2991,5895,1020,2.8,34.0,,121,14,107,121,3.80,12.0
2788,tt0099969,Lambada,1990,"2,500+",2670,42,59,48,2.8,42.0,,2,0,2,2,,
2789,tt0099969,Lambada,1990,"2,500+",2670,42,59,48,2.8,42.0,,2,0,2,2,,
2790,tt0099969,Lambada,1990,"2,500+",2670,42,59,48,2.8,42.0,,2,0,2,2,,
2791,tt0202677,The Way of the Gun,2000,"25,000+",31414,2263,967,1162,3.7,70.0,,134,61,73,134,5.50,46.0
2792,tt0099969,Lambada,1990,"2,500+",2670,42,59,48,2.8,42.0,,2,0,2,2,,
2793,tt0817230,Valentine's Day,2010,"250,000+",287418,15849,17754,9481,3.2,47.0,,191,34,157,191,4.00,18.0
2794,tt0084690,Six Pack,1982,"1,000+",2470,197,79,91,3.9,72.0,,1,1,0,1,,
2795,tt1666308,Golimar,2010,0,0,0,0,1,,,,0,0,0,0,,
2796,tt0086848,Achamillai Achamillai,1984,0,0,0,0,0,,,,0,0,0,0,,
2797,tt0250371,The Other Side of Heaven,2001,"10,000+",10152,654,234,376,3.9,74.0,,43,13,30,43,4.80,30.0
2798,tt0316763,Thunderstruck,2004,"1,000+",1605,104,38,91,3.8,73.0,,7,4,3,7,5.30,57.0
2799,tt0055305,Pit of Darkness,1961,Fewer than 50,3,2,0,1,,,,0,0,0,0,,
2800,tt0455538,How to Lose Friends & Alienate People,2008,"25,000+",48771,3731,5089,3584,3.1,42.0,,114,42,72,114,5.00,37.0
2801,tt0189744,Miss Julie,1999,"1,000+",1009,50,47,33,3.1,52.0,,23,9,14,23,5.60,39.0
2802,tt0460435,In a Dark Place,2006,"1,000+",1723,35,308,210,1.8,10.0,,2,1,1,2,,
2803,tt0065504,The Bushbaby,1969,Fewer than 50,10,1,2,1,,,,0,0,0,0,,
2804,tt0067810,Sweet Sweetback's Baadasssss Song,1971,"2,500+",3426,255,279,226,3.2,48.0,,28,21,7,28,6.80,75.0
2805,tt1506966,Parthan Kanda Paralokam,2008,0,0,0,0,0,,,,0,0,0,0,,
2806,tt0160401,In Too Deep,1999,"5,000+",7542,571,192,207,4,75.0,,57,22,35,57,5.00,39.0
2807,tt2098782,Pilla Zamindar,2011,Fewer than 50,25,12,3,1,3.9,80.0,,0,0,0,0,,
2808,tt0109403,Chasers,1994,"2,500+",3958,54,205,51,2.5,21.0,,6,2,4,6,4.10,33.0
2809,tt0216971,Peruvazhiyambalam,1979,0,0,0,0,0,,,,0,0,0,0,,
2810,tt0169299,Terror Firmer,1999,"2,500+",4949,375,122,215,3.9,75.0,,5,4,1,5,5.70,80.0
2811,tt0110632,Natural Born Killers,1994,"100,000+",217742,23287,5575,8911,4,81.0,,45,23,22,45,5.80,51.0
2812,tt0074995,Ode to Billy Joe,1976,500+,921,107,28,45,4.1,79.0,,9,4,5,9,5.10,44.0
2813,tt0119642,Mean Guns,1997,"2,500+",3543,123,112,109,3.3,52.0,,3,1,2,3,,
2814,tt0176783,Gossip,2000,"10,000+",19070,698,799,466,3.2,47.0,,67,19,48,67,4.50,28.0
2815,tt0301181,Deliver Us from Eva,2003,"10,000+",20017,1109,357,562,3.9,76.0,,83,36,47,83,5.30,43.0
2816,tt0108307,Teenage Catgirls in Heat,1994,100+,181,6,21,6,1.9,22.0,,4,1,3,4,,
2817,tt0263238,Crisis: Behind a Presidential Commitment,1963,250+,488,29,9,8,3.8,76.0,,2,2,0,2,,
2818,tt1340635,Black Lightning,2008,500+,557,144,124,97,3.3,54.0,,1,1,0,1,,
2819,tt0059211,Gamperaliya,1963,Fewer than 50,6,5,0,1,4.1,100.0,,0,0,0,0,,
2820,tt0424107,The Garage,2006,100+,174,10,3,7,4,77.0,,0,0,0,0,,
2821,tt1238291,Five Minutes of Heaven,2009,"10,000+",21582,838,554,442,3.4,60.0,,45,34,11,45,6.50,76.0
2822,tt0301777,Robot Stories,2003,"1,000+",1345,56,47,44,3.2,54.0,,43,32,11,43,6.70,74.0
2823,tt1085779,The Hole,2009,"10,000+",14761,1836,2171,836,3.2,46.0,,37,30,7,37,6.40,81.0
2824,tt0093015,Dragons Forever,1988,"5,000+",5892,354,96,181,3.9,79.0,,6,4,2,6,5.60,67.0
2825,tt0401385,Say Uncle,2005,"10,000+",17579,45,65,76,2.9,41.0,,19,3,16,19,4.00,16.0
2826,tt0101684,Deadly Desire,1991,Fewer than 50,12,0,1,0,,,,0,0,0,0,,
2827,tt0311411,Kranti,2002,50+,58,1,1,1,,,,0,0,0,0,,
2828,tt0065867,Husbands,1970,"1,000+",2167,334,89,101,4,79.0,,34,22,12,34,6.30,65.0
2829,tt0091964,Sky Pirates,1986,500+,847,4,14,9,2.3,22.0,,0,0,0,0,,
2830,tt0378284,Machuca,2004,"5,000+",6634,1265,120,356,4.2,91.0,,38,33,5,38,7.50,87.0
2831,tt1789746,Divizionz,2007,0,0,0,0,0,,,,0,0,0,0,,
2832,tt0114745,The Tuskegee Airmen,1995,"2,500+",4832,498,135,155,3.9,79.0,,7,6,1,7,6.20,86.0
2833,tt0066140,Night Slaves,1970,0,0,0,0,0,,,,0,0,0,0,,
2834,tt1114277,Up the Yangtze,2007,"1,000+",2433,448,90,265,3.9,83.0,,53,51,2,53,7.70,96.0
2835,tt0456658,Shanghai Dreams,2005,500+,680,58,35,29,3.5,62.0,,6,4,2,6,6.30,67.0
2836,tt0976051,The Reader,2008,"100,000+",207082,20014,5250,10255,3.8,79.0,,203,128,75,203,6.40,63.0
2837,tt0056282,No Exit,1962,0,0,0,0,0,,,,1,1,0,1,,
2838,tt0116287,Fear,1996,"50,000+",61022,3862,2286,2385,3.6,63.0,,39,18,21,39,5.20,46.0
2839,tt0787515,Strength and Honour,2007,250+,287,85,36,18,3.7,70.0,,17,1,16,17,3.70,6.0
2840,tt0441782,Restraint,2008,"1,000+",1817,202,273,157,3,43.0,,2,2,0,2,,
2841,tt0093560,The Monster Squad,1987,"25,000+",35894,3826,1109,2421,4,78.0,,26,15,11,26,5.70,58.0
2842,tt0057518,Son of Flubber,1962,"2,500+",4653,93,107,61,3.2,47.0,,8,7,1,8,6.50,88.0
2843,tt0241686,Lovedolls Superstar,1986,0,0,0,0,0,,,,1,1,0,1,,
2844,tt0106513,Candles in the Dark,1993,Fewer than 50,2,0,1,0,,,,0,0,0,0,,
2845,tt0084266,Dragon Lord,1982,"1,000+",1804,123,95,53,3.4,56.0,,4,3,1,4,,
2846,tt0084695,The Slumber Party Massacre,1982,"5,000+",6542,402,474,369,3.1,46.0,,21,9,12,21,4.60,43.0
2847,tt0068173,The Adventures of Barry McKenzie,1972,250+,382,37,37,27,3.3,50.0,,1,1,0,1,,
2848,tt0064923,Sam Whiskey,1969,"1,000+",1251,11,32,13,2.9,26.0,,1,0,1,1,,
2849,tt0891592,Street Fighter: The Legend of Chun-Li,2009,"100,000+",207497,960,4487,3006,2.1,18.0,,62,2,60,62,2.40,3.0
2850,tt0425210,Lucky Number Slevin,2006,"250,000+",337008,47983,7469,18765,4.1,87.0,,154,80,74,154,5.90,52.0
2851,tt0119166,Fun Bar Karaoke,1997,100+,137,14,1,2,3.8,93.0,,0,0,0,0,,
2852,tt0211938,Bait,2000,100+,109,0,1,0,,,,0,0,0,0,,
2853,tt1285131,Pandurangadu,2008,0,0,0,0,0,,,,0,0,0,0,,
2854,tt0335245,The Ladykillers,2004,"50,000+",65768,3429,4588,2572,3,43.0,,190,103,87,190,6.10,54.0
2855,tt1743708,Petrang kabayo,2010,Fewer than 50,46,7,7,7,2.9,50.0,,0,0,0,0,,
2856,tt0059774,Synanon,1965,Fewer than 50,7,1,0,0,,,,0,0,0,0,,
2857,tt0489560,Shaadi Se Pehle,2006,"1,000+",1252,32,42,25,3.1,43.0,,0,0,0,0,,
2858,tt0808348,Life Support,2007,"2,500+",2577,268,65,136,4,80.0,,4,3,1,4,,
2859,tt0119428,Judwaa,1997,Fewer than 50,2,1,1,0,,,,0,0,0,0,,
2860,tt2210443,Asuravithu,2012,0,0,0,0,0,,,,0,0,0,0,,
2861,tt0058669,Tomorrow at Ten,1963,Fewer than 50,10,1,1,1,,,,1,0,1,1,,
2862,tt6128116,Like a Virgin,2008,250+,425,35,10,12,3.8,78.0,,0,0,0,0,,
2863,tt0476527,Bluffmaster!,2005,"2,500+",4419,241,77,98,3.8,76.0,,3,2,1,3,,
2864,tt0230838,Sweet November,2001,"50,000+",94692,8062,2563,2892,3.9,76.0,,99,15,84,99,3.60,15.0
2865,tt0118891,Country Justice,1996,50+,87,3,3,0,3.4,50.0,,0,0,0,0,,
2866,tt1058743,Pretty Bird,2008,250+,409,18,94,36,2.2,16.0,,5,1,4,5,5.00,20.0
2867,tt0055601,Viridiana,1961,"5,000+",6846,1543,167,409,4.3,90.0,,29,28,1,29,8.90,97.0
2868,tt0107080,Harmony Cats,1992,Fewer than 50,41,0,1,0,,,,0,0,0,0,,
2869,tt1114698,Tom and Jerry: A Nutcracker Tale,2007,250+,322,60,35,14,3.6,63.0,,4,2,2,4,,
2870,tt0324127,Suspect Zero,2004,"10,000+",11782,645,1058,558,2.9,38.0,,128,23,105,128,4.40,18.0
2871,tt0070395,Miracle on 34th Street,1973,50+,88,7,7,0,3.4,50.0,,0,0,0,0,,
2872,tt0104812,Map of the Human Heart,1992,"1,000+",2281,217,52,91,4,81.0,,23,18,5,23,6.80,78.0
2873,tt0420509,Aura,2005,0,0,0,0,0,,,,0,0,0,0,,
2874,tt0765120,My Blueberry Nights,2007,"25,000+",32312,7344,4742,4450,3.4,61.0,,133,61,72,133,5.40,46.0
2875,tt0091384,The Last Frontier,1986,0,0,0,0,0,,,,0,0,0,0,,
2876,tt0364435,Jailbait,2004,500+,521,24,24,17,3,50.0,,18,3,15,18,4.30,17.0
2877,tt0923688,Ezra,2007,100+,191,15,9,7,3.4,62.0,,17,12,5,17,6.30,71.0
2878,tt1934381,Sector 7,2011,250+,273,34,142,53,2.5,19.0,,2,0,2,2,,
2879,tt0318997,Angels in America,2003,Fewer than 50,15,13,2,5,4.3,87.0,,0,0,0,0,,
2880,tt0318997,Angels in America,2003,Fewer than 50,15,13,2,5,4.3,87.0,,0,0,0,0,,
2881,tt0164114,Drive Me Crazy,1999,"50,000+",59091,1287,1155,1158,3.3,53.0,,38,11,27,38,4.90,29.0
2882,tt0157836,Island of the Dead,2000,250+,340,1,49,29,1.5,2.0,,1,0,1,1,,
2883,tt0115834,Carnosaur 3: Primal Species,1996,"1,000+",2159,29,83,53,2.2,26.0,,3,0,3,3,,
2884,tt0107282,The Joy Luck Club,1993,"25,000+",27742,2612,327,1123,4.2,89.0,,85,73,12,85,7.70,86.0
2885,tt0275577,Othello,2001,"1,000+",1448,40,14,23,3.7,74.0,,2,1,1,2,,
2886,tt0056352,Planeta bur,1962,250+,318,12,9,9,3.3,57.0,,1,1,0,1,,
2887,tt1492820,Elevator Girl,2010,100+,111,32,27,7,3.4,54.0,,0,0,0,0,,
2888,tt0114663,Three Wishes,1995,"5,000+",7785,108,100,83,3.4,52.0,,15,2,13,15,4.40,13.0
2889,tt0099951,The Krays,1990,"5,000+",7748,630,157,281,4,80.0,,17,14,3,17,6.40,82.0
2890,tt0462590,Step Up,2006,"250,000+",615783,66258,13797,41632,4.2,83.0,,108,23,85,108,4.60,21.0
2891,tt0902290,I Sell the Dead,2008,"5,000+",8369,645,735,435,3.1,47.0,,45,32,13,45,5.90,71.0
2892,tt1516586,The Greatest Ears in Town: The Arif Mardin Story,2010,0,0,0,0,0,,,,0,0,0,0,,
2893,tt0098512,The Trial of the Incredible Hulk,1989,"1,000+",1979,88,96,57,3.3,48.0,,1,1,0,1,,
2894,tt0120594,B. Monkey,1998,"2,500+",3530,126,109,75,3.4,54.0,,20,12,8,20,5.70,60.0
2895,tt0478829,Vitus,2006,"10,000+",14894,1163,286,453,3.9,80.0,,61,41,20,61,6.70,67.0
2896,tt0365149,Eddie's Million Dollar Cook-Off,2003,500+,997,95,99,55,3.3,49.0,,4,3,1,4,,
2897,tt1282444,Minnaminnikkoottam,2008,0,0,0,0,0,,,,0,0,0,0,,
2898,tt1606230,Gorintaku,2008,0,0,0,0,0,,,,0,0,0,0,,
2899,tt0099654,Ghost Dad,1990,"25,000+",36572,325,698,630,2.7,32.0,,32,2,30,32,3.30,6.0
2900,tt0443619,Red Mercury,2005,50+,89,6,6,6,3.2,50.0,,0,0,0,0,,
2901,tt0117995,Twisted Desire,1996,50+,97,5,12,5,2.8,29.0,,0,0,0,0,,
2902,tt2495244,Ami Shubhash Bolchi,2011,0,0,0,0,0,,,,0,0,0,0,,
2903,tt0119501,Last Stand at Saber River,1997,"1,000+",1432,47,26,21,3.5,64.0,,3,0,3,3,,
2904,tt0070438,The Neptune Factor,1973,50+,84,3,17,6,2,15.0,,3,1,2,3,,
2905,tt0110889,Priest,1994,"2,500+",4940,524,104,201,4.1,83.0,,25,16,9,25,7.00,64.0
2906,tt0093832,Red's Dream,1987,500+,507,93,93,44,3.3,50.0,,1,1,0,1,,
2907,tt0100774,Thousand Pieces of Gold,1990,250+,309,18,9,7,3.5,67.0,,43,38,5,43,6.60,88.0
2908,tt0109723,Embrace of the Vampire,1995,50+,81,12,43,13,2.7,22.0,,1,1,0,1,,
2909,tt0119665,Metroland,1997,"2,500+",3215,163,139,88,3.4,54.0,,29,18,11,29,6.50,62.0
2910,tt0054017,Last Woman on Earth,1960,250+,420,16,92,50,2.3,15.0,,3,1,2,3,,
2911,tt0192578,Scooby-Doo in Arabian Nights,1994,"5,000+",8233,61,72,45,3.1,46.0,,0,0,0,0,,
2912,tt0494834,Silk,2007,"10,000+",10271,769,1859,1167,2.7,29.0,,56,4,52,56,3.80,7.0
2913,tt1723126,Last Days Here,2011,250+,460,219,24,45,4.1,90.0,,21,18,3,21,7.00,86.0
2914,tt0494834,Silk,2007,"10,000+",10271,769,1859,1167,2.7,29.0,,56,4,52,56,3.80,7.0
2915,tt2420208,Josettante Hero,2012,0,0,0,0,0,,,,0,0,0,0,,
2916,tt0107152,Household Saints,1993,500+,689,47,17,20,3.9,73.0,,13,7,6,13,6.00,54.0
2917,tt0102645,Patthar Ke Phool,1991,250+,413,3,14,3,2.6,18.0,,0,0,0,0,,
2918,tt0057181,The Incredibly Strange Creatures Who Stopped Living and Became Mixed-Up Zombies!!?,1964,"1,000+",1606,33,199,132,1.6,14.0,,5,1,4,5,3.10,20.0
2919,tt0191397,The Replacements,2000,"100,000+",159897,5709,2933,2991,3.7,66.0,,108,44,64,108,5.00,41.0
2920,tt0088194,Streets of Fire,1984,"5,000+",8681,1085,466,620,3.8,70.0,,29,20,9,29,6.20,69.0
2921,tt1332052,Arizona Sky,2008,100+,133,9,19,9,2.6,32.0,,2,0,2,2,,
2922,tt0365960,Zero Day,2002,"2,500+",3585,446,121,234,3.9,79.0,,41,28,13,41,6.70,68.0
2923,tt0120609,The Big Hit,1998,"25,000+",29806,1405,1061,846,3.4,57.0,,41,17,24,41,5.10,41.0
2924,tt0790740,Reverend Billy and the Church of Stop Shopping,2002,Fewer than 50,7,1,0,1,,,,1,1,0,1,,
2925,tt1410013,Christmas in Canaan,2009,Fewer than 50,28,13,6,2,3.8,68.0,,0,0,0,0,,
2926,tt0105187,The Public Eye,1992,"1,000+",1263,74,69,35,3.3,52.0,,17,11,6,17,5.70,65.0
2927,tt0246184,Raja Vikramarka,1990,0,0,0,0,0,,,,0,0,0,0,,
2928,tt0821640,Ghosts of Girlfriends Past,2009,"250,000+",290536,7146,10566,7386,3,40.0,,144,40,104,144,4.30,28.0
2929,tt0094321,Who's That Girl,1987,"5,000+",8535,406,456,291,3.2,47.0,,20,7,13,20,4.60,35.0
2930,tt1027747,Stiletto,2008,"2,500+",4103,24,100,52,2.5,19.0,,1,0,1,1,,
2931,tt0110867,Pontiac Moon,1994,500+,601,14,17,10,3.3,45.0,,1,0,1,1,,
2932,tt0319645,Kanni Raasi,1985,0,0,0,0,0,,,,0,0,0,0,,
2933,tt0995712,Buick Riviera,2008,Fewer than 50,26,3,2,3,3.3,60.0,,0,0,0,0,,
2934,tt1655442,The Artist,2011,"50,000+",58779,27302,3942,6656,4.2,87.0,,329,313,16,329,8.80,95.0
2935,tt0378873,Thilakkam,2003,0,0,0,0,0,,,,0,0,0,0,,
2936,tt0106598,Coneheads,1993,"100,000+",203571,1848,3095,2742,2.9,37.0,,31,11,20,31,4.70,35.0
2937,tt0315206,Ball & Chain,2004,500+,919,17,36,13,2.6,32.0,,0,0,0,0,,
2938,tt1483756,The Trouble with Bliss,2011,"1,000+",1092,79,205,43,2.7,28.0,,18,6,12,18,4.50,33.0
2939,tt0081229,Night of the Demon,1980,500+,966,39,73,67,2.8,35.0,,1,0,1,1,,
2940,tt0914798,The Boy in the Striped Pajamas,2008,"100,000+",114794,13723,2523,5595,4,85.0,,145,94,51,145,6.30,65.0
2941,tt0214663,Ek Mahal Ho Sapno Ka,1975,Fewer than 50,29,1,0,0,,,,0,0,0,0,,
2942,tt0087418,Hollywood Hot Tubs,1984,50+,69,1,17,5,1.9,6.0,,0,0,0,0,,
2943,tt0104283,Folks!,1992,"1,000+",2089,82,73,67,3.3,53.0,,20,0,20,20,2.80,0.0
2944,tt0091293,Mr. Vampire II,1986,0,0,0,0,0,,,,0,0,0,0,,
2945,tt0104645,Kshatriya,1993,50+,59,1,4,1,2.4,20.0,,0,0,0,0,,
2946,tt0105575,Thevar Magan,1992,Fewer than 50,5,5,0,2,4.4,100.0,,0,0,0,0,,
2947,tt0250682,Rag Doll,1961,Fewer than 50,2,2,0,2,,,,0,0,0,0,,
2948,tt1540400,Bonded by Blood,2010,250+,365,61,157,76,2.7,28.0,,11,1,10,11,4.00,9.0
2949,tt0057090,A Gathering of Eagles,1963,Fewer than 50,36,4,3,2,3.9,57.0,,3,1,2,3,,
2950,tt1135525,The Slammin' Salmon,2009,"5,000+",9957,941,1048,615,3.2,47.0,,26,9,17,26,5.10,35.0
2951,tt0056249,Moon Pilot,1962,Fewer than 50,41,6,5,5,3,55.0,,3,1,2,3,,
2952,tt0104060,Dead Ahead: The Exxon Valdez Disaster,1992,Fewer than 50,14,3,0,1,,,,0,0,0,0,,
2953,tt1135092,The Limits of Control,2009,"25,000+",34130,829,1086,727,3,43.0,,130,56,74,130,5.20,43.0
2954,tt0156663,Kabzaa,1988,Fewer than 50,4,1,3,0,,,,0,0,0,0,,
2955,tt0094012,Spaceballs,1987,"250,000+",435485,33623,7023,18819,4,83.0,,47,27,20,47,6.40,57.0
2956,tt0170351,Pan Tadeusz,1999,250+,281,45,44,6,3.3,51.0,,1,1,0,1,,
2957,tt1196170,Hollywood & Wine,2011,Fewer than 50,21,2,8,1,2.4,20.0,,0,0,0,0,,
2958,tt0208092,Snatch,2000,"250,000+",395236,98545,6950,25452,4.3,93.0,,143,106,37,143,6.40,74.0
2959,tt0258967,The Unsaid,2001,"2,500+",3765,294,113,129,3.8,72.0,,0,0,0,0,,
2960,tt0387575,Seed of Chucky,2004,"100,000+",140976,2978,4052,3534,3,42.0,,76,26,50,76,4.50,34.0
2961,tt0061405,Billion Dollar Brain,1967,"2,500+",2592,95,134,90,3.2,42.0,,6,3,3,6,5.90,50.0
2962,tt1193507,My Own Love Song,2010,250+,447,61,123,40,2.8,33.0,,2,1,1,2,,
2963,tt0256406,Sri Venkateswara Mahathyam,1960,0,0,0,0,0,,,,0,0,0,0,,
2964,tt0468442,51 Birch Street,2005,"1,000+",1252,162,24,65,4,87.0,,36,35,1,36,7.90,97.0
2965,tt0872230,My Soul to Take,2010,"25,000+",33439,1428,3985,1713,2.4,26.0,,65,7,58,65,3.40,11.0
2966,tt0298050,Manito,2002,500+,587,28,10,15,3.7,74.0,,31,29,2,31,7.30,94.0
2967,tt0303933,Drumline,2002,"250,000+",322282,13450,5871,9583,3.7,70.0,,87,71,16,87,6.70,82.0
2968,tt0080724,Fatso,1980,500+,549,83,44,47,3.7,65.0,,7,2,5,7,4.50,29.0
2969,tt0090846,Circle of Violence: A Family Drama,1986,0,0,0,0,0,,,,0,0,0,0,,
2970,tt1496832,Paiyaa,2010,100+,153,29,16,5,3.6,64.0,,0,0,0,0,,
2971,tt0326722,Agni Varsha,2002,Fewer than 50,9,0,3,0,,,,4,2,2,4,,
2972,tt0240468,Kung Pow: Enter the Fist,2002,"50,000+",79213,5994,2697,4784,3.7,69.0,,54,7,47,54,3.50,13.0
2973,tt0490087,Black Water Transit,2009,100+,159,0,3,0,,,,0,0,0,0,,
2974,tt0076507,The Other Side of Midnight,1977,500+,515,72,26,37,3.7,73.0,,8,2,6,8,5.00,25.0
2975,tt0062292,The Sorcerers,1967,250+,407,41,28,30,3.4,59.0,,13,13,0,13,7.30,100.0
2976,tt0116905,Lone Star,1996,"5,000+",9805,1377,287,444,4,83.0,,138,126,12,138,8.70,91.0
2977,tt0056693,Wild Guitar,1962,250+,444,25,22,24,3.2,53.0,,2,1,1,2,,
2978,tt1629391,Tere Bin Laden,2010,250+,432,135,106,79,3.3,56.0,,2,1,1,2,,
2979,tt0153992,You Lucky Dog,1998,250+,363,38,24,15,3.6,61.0,,0,0,0,0,,
2980,tt0108260,Suture,1993,"1,000+",1010,79,34,39,3.7,70.0,,17,12,5,17,6.20,71.0
2981,tt0929864,Love's Unending Legacy,2007,"2,500+",3156,342,70,135,4.2,83.0,,1,0,1,1,,
2982,tt0113133,Funny Bones,1995,"2,500+",4371,201,48,115,4.1,81.0,,19,12,7,19,6.40,63.0
2983,tt0282945,The Scoundrel's Wife,2002,100+,240,2,7,2,2.8,22.0,,4,2,2,4,,
2984,tt0067721,The Screaming Woman,1972,0,0,0,0,0,,,,0,0,0,0,,
2985,tt0163166,Quasimodo d'El Paris,1999,50+,79,8,9,2,3.1,47.0,,0,0,0,0,,
2986,tt0385638,The Long Shot,2004,"1,000+",1226,76,14,43,4.1,84.0,,0,0,0,0,,
2987,tt1219817,Going Postal,2010,250+,496,260,51,58,4,84.0,,0,0,0,0,,
2988,tt1016024,Battle Planet,2008,100+,183,7,32,17,2,18.0,,0,0,0,0,,
2989,tt0424908,Copying Beethoven,2006,"10,000+",14219,582,451,452,3.3,56.0,,81,23,58,81,4.80,28.0
2990,tt0362129,Seeing Other People,2004,"1,000+",2036,72,138,90,2.9,34.0,,34,14,20,34,5.50,41.0
2991,tt1266615,BoyBand,2010,50+,89,4,2,2,4.1,67.0,,0,0,0,0,,
2992,tt0120491,Welcome to Woop Woop,1997,500+,938,81,36,49,3.6,69.0,,19,7,12,19,4.80,37.0
2993,tt0844479,The Collector,2009,0,0,0,0,0,,,,0,0,0,0,,
2994,tt0844479,The Collector,2009,0,0,0,0,0,,,,0,0,0,0,,
2995,tt0377917,The Fifth Element,1998,"250,000+",587910,57017,8912,24381,4.1,86.0,,69,49,20,69,6.40,71.0
2996,tt0084268,Lookin' to Get Out,1982,"1,000+",1955,7,17,8,2.6,29.0,,13,4,9,13,5.10,31.0
2997,tt0119558,Lolita,1997,"10,000+",22694,2811,948,962,3.8,75.0,,26,18,8,26,7.00,69.0
2998,tt1864288,Conan O'Brien Can't Stop,2011,"10,000+",13533,1794,832,458,3.6,68.0,,77,63,14,77,6.80,82.0
2999,tt0388230,Malevolence,2003,"2,500+",2640,836,191,117,4.4,81.0,,17,6,11,17,4.80,35.0
3000,tt1242618,Deadline,2009,100+,177,20,18,14,3.1,53.0,,9,0,9,9,4.30,0.0
3001,tt0435259,Padmashree Laloo Prasad Yadav,2005,50+,65,0,4,0,,,,0,0,0,0,,
3002,tt1242618,Deadline,2009,100+,177,20,18,14,3.1,53.0,,9,0,9,9,4.30,0.0
3003,tt0069676,Ace Eli and Rodger of the Skies,1973,0,0,0,0,0,,,,0,0,0,0,,
3004,tt0102484,Murder in New Hampshire: The Pamela Smart Story,1991,50+,75,2,7,0,3.1,22.0,,1,0,1,1,,
3005,tt0089489,Lifeforce,1985,"5,000+",9666,663,785,576,3.1,46.0,,32,18,14,32,5.50,56.0
3006,tt1095217,The Bad Lieutenant: Port of Call - New Orleans,2009,"50,000+",53904,6299,4717,3510,3.3,57.0,,156,134,22,156,7.30,86.0
3007,tt0111304,The Substitute Wife,1994,100+,115,7,8,2,3.4,47.0,,0,0,0,0,,
3008,tt0260207,Mujhe Insaaf Chahiye,1983,0,0,0,0,0,,,,0,0,0,0,,
3009,tt0951216,Mad Money,2008,"100,000+",135257,4426,4706,3720,3.2,48.0,,106,23,83,106,4.50,22.0
3010,tt0405977,Chaos,2005,0,0,0,0,0,,,,0,0,0,0,,
3011,tt0405977,Chaos,2005,0,0,0,0,0,,,,0,0,0,0,,
3012,tt0405977,Chaos,2005,0,0,0,0,0,,,,0,0,0,0,,
3013,tt0768183,Day Zero,2007,"2,500+",3084,241,297,247,3.1,45.0,,21,5,16,21,4.20,24.0
3014,tt0405977,Chaos,2005,0,0,0,0,0,,,,0,0,0,0,,
3015,tt0934459,The Hitchhiker,2007,500+,963,26,49,40,2.9,35.0,,1,0,1,1,,
3016,tt2016894,Ek Tha Tiger,2012,"2,500+",4597,380,393,161,3.2,49.0,,16,12,4,16,5.90,75.0
3017,tt0096324,Two Moon Junction,1988,"5,000+",5044,147,156,113,3.3,49.0,,9,0,9,9,4.00,0.0
3018,tt1415284,The Brazen Bull,2010,Fewer than 50,26,1,7,2,1.5,12.0,,0,0,0,0,,
3019,tt0244590,Kissise Na Kehna,1983,0,0,0,0,0,,,,0,0,0,0,,
3020,tt0053580,The Alamo,1960,"5,000+",7370,598,342,283,3.6,64.0,,21,11,10,21,5.50,52.0
3021,tt0092074,TerrorVision,1986,"1,000+",1999,173,226,166,3.1,43.0,,10,1,9,10,3.30,10.0
3022,tt0061173,Way... Way Out,1966,Fewer than 50,14,8,2,3,3.9,80.0,,0,0,0,0,,
3023,tt0769499,Aathi,2006,100+,164,5,11,2,2.6,31.0,,0,0,0,0,,
3024,tt0071120,All the Kind Strangers,1974,100+,145,5,17,10,2.8,23.0,,0,0,0,0,,
3025,tt0065010,Some Kind of a Nut,1969,Fewer than 50,1,0,1,0,,,,0,0,0,0,,
3026,tt1611004,Autograph,2010,0,0,0,0,0,,,,0,0,0,0,,
3027,tt0067668,Reshma Aur Shera,1971,50+,63,4,0,1,,,,0,0,0,0,,
3028,tt1579811,Mogudu Pellam O Dongodu,2005,0,0,0,0,0,,,,0,0,0,0,,
3029,tt0936468,Dard Divorce,2007,Fewer than 50,2,0,2,1,,,,0,0,0,0,,
3030,tt1161646,Gingerdead Man 2: Passion of the Crust,2008,250+,435,28,102,63,2.2,21.0,,1,0,1,1,,
3031,tt0072278,Thomasine & Bushrod,1974,Fewer than 50,15,5,5,4,3.1,50.0,,1,1,0,1,,
3032,tt1108831,Chhodon Naa Yaar,2007,Fewer than 50,45,0,1,0,,,,1,0,1,1,,
3033,tt0271699,Padayani,1986,0,0,0,0,0,,,,0,0,0,0,,
3034,tt0173080,Pyaar Kiya To Darna Kya,1998,"1,000+",1312,70,27,22,3.7,72.0,,0,0,0,0,,
3035,tt0199685,Killer Flick,1998,Fewer than 50,41,2,1,1,,,,0,0,0,0,,
3036,tt0262430,Gaayam,1993,0,0,0,0,0,,,,0,0,0,0,,
3037,tt0350005,Pyar Ki Jeet,1987,0,0,0,0,0,,,,0,0,0,0,,
3038,tt1087474,Shark in Venice,2008,250+,472,23,138,97,1.7,14.0,,1,0,1,1,,
3039,tt0215643,Come Play with Me,1968,Fewer than 50,12,4,3,1,3.4,57.0,,3,2,1,3,,
3040,tt0116953,Mad Dog Time,1996,"1,000+",1389,66,72,61,3,48.0,,6,1,5,6,3.50,17.0
3041,tt1170391,Beautiful,2009,Fewer than 50,11,3,0,0,,,,0,0,0,0,,
3042,tt1170391,Beautiful,2009,Fewer than 50,11,3,0,0,,,,0,0,0,0,,
3043,tt0303658,Andromedia,1998,"1,000+",1714,8,32,15,2.7,20.0,,0,0,0,0,,
3044,tt0912599,War Dance,2007,"2,500+",2810,460,44,259,4.3,91.0,,47,40,7,47,7.10,85.0
3045,tt1605783,Midnight in Paris,2011,"50,000+",82995,34989,7334,8100,4,83.0,,229,213,16,229,7.80,93.0
3046,tt0106894,Killing Car,1993,50+,67,1,8,2,2.2,11.0,,0,0,0,0,,
3047,tt0256359,The Safety of Objects,2001,"2,500+",4226,340,179,160,3.6,65.0,,74,37,37,74,5.90,50.0
3048,tt0871438,Ocean of Pearls,2008,100+,111,30,12,6,3.9,71.0,,8,3,5,8,5.50,38.0
3049,tt0125454,Paulie,1998,"25,000+",43704,816,675,710,3.4,55.0,,37,23,14,37,6.20,62.0
3050,tt0995718,Ek Chalis Ki Last Local,2007,500+,525,65,45,45,3.3,59.0,,1,1,0,1,,
3051,tt2678040,Gokulathil Seethai,1996,0,0,0,0,0,,,,0,0,0,0,,
3052,tt0325980,Pirates of the Caribbean: The Curse of the Black Pearl,2003,"250,000+",33125722,173980,28679,1450985,3.9,86.0,,220,175,45,220,7.10,80.0
3053,tt0112537,Blue Juice,1995,"5,000+",6276,158,125,112,3.5,56.0,,2,0,2,2,,
3054,tt0325980,Pirates of the Caribbean: The Curse of the Black Pearl,2003,"250,000+",33125722,173980,28679,1450985,3.9,86.0,,220,175,45,220,7.10,80.0
3055,tt0359078,Churchill: The Hollywood Years,2004,"1,000+",2328,76,154,117,2.6,33.0,,5,2,3,5,4.80,40.0
3056,tt0244794,Sirf Tum,1999,"1,000+",1175,19,21,10,3.1,48.0,,0,0,0,0,,
3057,tt0258837,The Newman Shame,1978,0,0,0,0,0,,,,0,0,0,0,,
3058,tt0102757,The Rapture,1991,"2,500+",2839,232,144,127,3.4,62.0,,31,20,11,31,6.50,65.0
3059,tt0246462,Bidaai,1974,Fewer than 50,35,1,1,0,,,,0,0,0,0,,
3060,tt0070770,Tales That Witness Madness,1973,100+,110,15,35,17,2.9,30.0,,3,1,2,3,,
3061,tt0378542,Pattanathil Sundaran,2003,0,0,0,0,0,,,,0,0,0,0,,
3062,tt0089604,Missing in Action 2: The Beginning,1985,"5,000+",6758,226,258,151,3.2,47.0,,2,0,2,2,,
3063,tt0411323,Downloading Nancy,2008,"5,000+",9038,180,233,170,3,43.0,,33,6,27,33,3.80,18.0
3064,tt0445965,Feed,2005,"5,000+",5645,380,467,515,3,45.0,,7,4,3,7,5.40,57.0
3065,tt0490846,Chicken Little,2005,"250,000+",470969,6250,7192,10117,3.2,47.0,,164,60,104,164,5.50,37.0
3066,tt0098230,Rude Awakening,1989,250+,393,34,36,22,3.2,49.0,,21,4,17,21,4.00,19.0
3067,tt0110942,Raja Babu,1994,Fewer than 50,33,1,1,0,,,,0,0,0,0,,
3068,tt1777608,Scooby-Doo! Legend of the Phantosaur,2011,100+,109,56,25,16,3.7,69.0,,0,0,0,0,,
3069,tt0960721,Adventures of Power,2008,"1,000+",1038,77,80,63,3.2,49.0,,19,6,13,19,3.70,32.0
3070,tt0076929,Wizards,1977,"5,000+",8417,922,408,555,3.7,69.0,,29,18,11,29,5.50,62.0
3071,tt0055220,Nazrana,1961,0,0,0,0,0,,,,0,0,0,0,,
3072,tt0119620,Marius & Jeannette,1997,50+,93,17,6,6,3.6,74.0,,25,17,8,25,6.60,68.0
3073,tt1579232,Freerunner,2011,100+,222,21,104,27,2.1,17.0,,0,0,0,0,,
3074,tt2106537,Matru Ki Bijlee Ka Mandola,2013,250+,412,90,115,50,3,44.0,,9,3,6,9,5.80,33.0
3075,tt0177487,Aag Hi Aag,1987,0,0,0,0,0,,,,0,0,0,0,,
3076,tt0117202,Normal Life,1996,500+,960,53,57,32,3.3,49.0,,10,7,3,10,6.00,70.0
3077,tt0063135,Inspector Clouseau,1968,250+,409,27,93,42,2.5,22.0,,5,0,5,5,4.30,0.0
3078,tt0063643,"Stay Away, Joe",1968,"1,000+",1437,29,41,34,2.9,41.0,,0,0,0,0,,
3079,tt0147855,Aashirwad,1968,50+,53,4,0,2,,,,0,0,0,0,,
3080,tt1575672,Samarasimha Reddy,1999,0,0,0,0,0,,,,0,0,0,0,,
3081,tt0214996,Nokketha Dhoorathu Kannum Nattu,1984,0,0,0,0,0,,,,0,0,0,0,,
3082,tt0376994,X-Men III: The Last Stand,2006,"250,000+",1075076,57264,36711,47646,3.5,61.0,,239,137,102,239,5.90,57.0
3083,tt0280438,Ash Wednesday,2002,"2,500+",2935,126,161,83,3.2,44.0,,16,4,12,16,4.30,25.0
3084,tt0077280,The Buddy Holly Story,1978,"5,000+",7567,609,181,298,3.8,77.0,,30,30,0,30,7.30,100.0
3085,tt0095684,My Best Friend Is a Vampire,1987,"5,000+",8293,239,167,195,3.5,59.0,,3,2,1,3,,
3086,tt0069866,Charley and the Angel,1973,100+,236,8,16,8,3,33.0,,1,1,0,1,,
3087,tt0367027,Shortbus,2006,"50,000+",55587,6513,1933,3623,3.9,77.0,,128,88,40,128,6.50,69.0
3088,tt0074384,Death at Love House,1976,50+,73,4,7,5,2.9,36.0,,0,0,0,0,,
3089,tt0112896,Dracula: Dead and Loving It,1995,"50,000+",63584,2046,2134,1719,3.2,49.0,,37,4,33,37,3.10,11.0
3090,tt0996967,Otis,2008,"2,500+",2994,509,394,468,3.3,57.0,,1,0,1,1,,
3091,tt0120100,The Serpent's Kiss,1997,"1,000+",1387,43,69,26,3,38.0,,2,0,2,2,,
3092,tt0279730,Children of the Corn: Revelation,2001,"10,000+",11692,61,201,109,2.3,23.0,,5,0,5,5,2.70,0.0
3093,tt1000730,VeggieTales: Moe and the Big Exit,2007,Fewer than 50,4,1,1,0,,,,0,0,0,0,,
3094,tt0378804,State's Evidence,2004,500+,551,84,23,49,3.9,79.0,,5,2,3,5,5.00,40.0
3095,tt0114272,Restoration,1995,"2,500+",3914,304,215,139,3.4,58.0,,35,25,10,35,6.30,71.0
3096,tt0314630,The Secret Lives of Dentists,2002,"2,500+",2976,187,137,97,3.3,58.0,,93,79,14,93,7.20,85.0
3097,tt0053848,G.I. Blues,1960,"5,000+",8239,218,98,156,3.8,69.0,,5,0,5,5,4.70,0.0
3098,tt1251756,The Making of Plus One,2010,Fewer than 50,4,0,1,0,,,,0,0,0,0,,
3099,tt1394310,Bajimaat,2008,0,0,0,0,0,,,,0,0,0,0,,
3100,tt0135641,Sapoot,1996,0,0,0,0,0,,,,0,0,0,0,,
3101,tt0105361,The Seventh Coin,1993,50+,68,0,2,1,,,,0,0,0,0,,
3102,tt0169547,American Beauty,1999,"250,000+",661369,97659,7418,29042,4.4,93.0,,192,167,25,192,8.20,87.0
3103,tt0067742,Sharmeelee,1971,100+,113,4,1,1,4.2,80.0,,0,0,0,0,,
3104,tt0169547,American Beauty,1999,"250,000+",661369,97659,7418,29042,4.4,93.0,,192,167,25,192,8.20,87.0
3105,tt0126952,How to Cheat in the Leaving Certificate,1997,Fewer than 50,5,3,0,2,,,,0,0,0,0,,
3106,tt0324951,23rd March 1931: Shaheed,2002,Fewer than 50,2,1,0,0,,,,0,0,0,0,,
3107,tt1447783,Ee Pattanathil Bhootham,2009,0,0,0,0,0,,,,0,0,0,0,,
3108,tt1105733,Kismat Konnection,2008,"2,500+",3112,311,519,333,3,38.0,,3,0,3,3,,
3109,tt0110496,Mesmer,1994,"1,000+",1474,85,65,75,3.4,57.0,,3,0,3,3,,
3110,tt0275022,Crossroads,2002,"250,000+",359445,2066,3075,7345,2.8,40.0,,103,15,88,103,4.10,15.0
3111,tt0251320,Pehchaan,1993,50+,64,0,1,0,,,,0,0,0,0,,
3112,tt0054679,The Big Gamble,1961,Fewer than 50,2,1,1,1,,,,0,0,0,0,,
3113,tt0100222,Naked Tango,1990,250+,318,35,3,6,4.2,92.0,,1,0,1,1,,
3114,tt0117039,Michael Collins,1996,"10,000+",21356,2349,456,747,4,84.0,,50,39,11,50,6.90,78.0
3115,tt0323120,Loving Annabelle,2006,"5,000+",9719,1521,468,678,4,77.0,,3,1,2,3,,
3116,tt13853586,Achante Aanmakkal,2012,0,0,0,0,0,,,,0,0,0,0,,
3117,tt0104428,Hold Me Thrill Me Kiss Me,1992,250+,484,19,8,7,3.9,70.0,,1,1,0,1,,
3118,tt0096926,The Big Picture,1989,"2,500+",3303,158,190,96,3.2,45.0,,24,21,3,24,6.70,88.0
3119,tt0094057,Street Trash,1987,"2,500+",4823,512,329,359,3.4,61.0,,13,8,5,13,5.40,62.0
3120,tt0091817,Rad,1986,"5,000+",7253,1452,165,617,4.5,90.0,,12,5,7,12,4.50,42.0
3121,tt1735932,Va: Quarter Cutting,2010,Fewer than 50,32,3,7,5,2.1,30.0,,0,0,0,0,,
3122,tt0418832,Lie with Me,2005,"5,000+",7197,705,639,480,3.3,53.0,,8,4,4,8,4.30,50.0
3123,tt1706593,Chronicle,2012,"100,000+",116138,37499,14931,9527,3.7,72.0,,186,158,28,186,7.10,85.0
3124,tt1312057,Alli Thandha Vaanam,2001,0,0,0,0,0,,,,0,0,0,0,,
3125,tt0221297,Frozen with Fear,2001,Fewer than 50,1,0,1,1,,,,0,0,0,0,,
3126,tt0360130,Undertow,2004,"5,000+",7330,657,410,418,3.5,61.0,,120,65,55,120,5.90,54.0
3127,tt0242154,Yoyes,2000,Fewer than 50,8,2,2,0,,,,0,0,0,0,,
3128,tt0064425,Hibernatus,1969,"1,000+",1685,117,80,19,3.5,59.0,,0,0,0,0,,
3129,tt1070858,The Secrets of Jonathan Sperry,2008,250+,431,148,29,68,4.2,84.0,,3,2,1,3,,
3130,tt0488414,Omkara,2006,"5,000+",6249,821,88,328,4.2,90.0,,2,2,0,2,,
3131,tt0117927,"To Sir, with Love II",1996,250+,432,28,20,14,3.6,58.0,,0,0,0,0,,
3132,tt0455805,Then She Found Me,2007,"10,000+",18772,1112,1447,1202,3.1,43.0,,118,60,58,118,5.50,51.0
3133,tt0079224,The Golden Lady,1979,Fewer than 50,5,0,3,1,,,,0,0,0,0,,
3134,tt1220214,Heartless,2009,"10,000+",13346,809,906,438,3.1,47.0,,39,30,9,39,5.90,77.0
3135,tt0110687,North,1994,"10,000+",13596,381,1044,432,2.4,27.0,,35,5,30,35,3.70,14.0
3136,tt0055294,The Phantom Planet,1961,500+,600,13,105,59,1.9,11.0,,3,2,1,3,,
3137,tt0091862,Robotech: The Movie,1986,Fewer than 50,10,2,3,2,3.3,40.0,,1,0,1,1,,
3138,tt1503184,Vaamanan,2009,0,0,0,0,0,,,,0,0,0,0,,
3139,tt0072732,Brannigan,1975,"2,500+",4303,87,132,91,3.1,40.0,,12,3,9,12,5.40,25.0
3140,tt0342108,Beethoven's 5th,2003,"10,000+",10932,53,114,90,2.6,32.0,,0,0,0,0,,
3141,tt0937397,Hammy's Boomerang Adventure,2006,500+,555,33,13,9,3.9,72.0,,0,0,0,0,,
3142,tt1203523,Streets of Blood,2009,"5,000+",7677,90,425,204,2.3,17.0,,5,2,3,5,4.30,40.0
3143,tt0490170,Love Story 2050,2008,"1,000+",2349,88,290,207,2.2,23.0,,3,0,3,3,,
3144,tt1560171,Samaantar,2009,Fewer than 50,2,1,0,1,,,,0,0,0,0,,
3145,tt0337721,The Snow Walker,2003,"2,500+",4650,503,135,237,3.9,79.0,,14,12,2,14,6.80,86.0
3146,tt1488598,Stonehenge Apocalypse,2010,250+,272,44,96,51,2.6,31.0,,0,0,0,0,,
3147,tt0137361,Anupama,1966,0,0,0,0,0,,,,0,0,0,0,,
3148,tt0301636,The Mummy Returns,2001,"250,000+",748907,22091,13063,16800,3.5,63.0,,141,65,76,141,5.30,46.0
3149,tt1191121,Jalsa,2008,Fewer than 50,1,1,0,1,,,,0,0,0,0,,
3150,tt0268547,Prem Bandhan,1979,0,0,0,0,0,,,,0,0,0,0,,
3151,tt1019452,A Serious Man,2009,"50,000+",63265,11209,5284,5035,3.6,68.0,,224,200,24,224,7.90,89.0
3152,tt0116931,Love and Other Catastrophes,1996,500+,699,97,39,37,3.8,71.0,,16,8,8,16,5.40,50.0
3153,tt0094070,Summer Camp Nightmare,1986,100+,224,23,33,26,3,41.0,,0,0,0,0,,
3154,tt0099825,Identity Crisis,1989,50+,93,1,5,4,2.4,17.0,,0,0,0,0,,
3155,tt1301303,Born of Hope,2009,0,0,0,0,0,,,,0,0,0,0,,
3156,tt0111146,The Shaggy Dog,1994,Fewer than 50,1,0,1,0,,,,0,0,0,0,,
3157,tt0160644,Passion of Mind,2000,"2,500+",2741,94,90,65,3.3,51.0,,36,7,29,36,4.00,19.0
3158,tt0069289,Snoopy Come Home,1972,"2,500+",3468,421,79,181,4.1,84.0,,14,13,1,14,7.80,93.0
3159,tt4466544,Fatima,2015,Fewer than 50,1,1,0,0,,,,0,0,0,0,,
3160,tt0119987,The Real Blonde,1997,"1,000+",1401,56,94,32,3,37.0,,29,10,19,29,5.40,34.0
3161,tt0061431,The Busy Body,1967,50+,85,6,4,5,3.1,60.0,,0,0,0,0,,
3162,tt0098048,Outlaw of Gor,1988,50+,62,3,23,10,1.5,12.0,,3,0,3,3,,
3163,tt0084788,Things Are Tough All Over,1982,"10,000+",10339,272,160,149,3.6,63.0,,1,1,0,1,,
3164,tt0144622,St. Ives,1998,"1,000+",1014,31,18,22,3.7,62.0,,2,0,2,2,,
3165,tt0102011,"He Said, She Said",1991,"5,000+",7878,142,276,106,2.9,34.0,,18,6,12,18,5.00,33.0
3166,tt0426584,Stomp! Shout! Scream!,2005,500+,942,6,6,11,3.1,50.0,,1,0,1,1,,
3167,tt0246809,New Delhi,1987,0,0,0,0,0,,,,0,0,0,0,,
3168,tt0248675,Arappatta Kettiya Graamathil,1986,0,0,0,0,0,,,,0,0,0,0,,
3169,tt0093110,Grand Larceny,1987,Fewer than 50,7,1,1,0,,,,0,0,0,0,,
3170,tt1162125,"Sorry, Thanks",2009,50+,76,5,12,5,2.8,29.0,,2,2,0,2,,
3171,tt1198138,Obsessed,2009,"250,000+",258569,5414,6457,6784,3.1,46.0,,91,17,74,91,3.80,19.0
3172,tt0887867,20 Things to Do Before You're 30,2005,"1,000+",1322,26,87,46,2.6,23.0,,2,0,2,2,,
3173,tt0467421,Twitches,2005,"10,000+",24048,1050,570,524,3.7,65.0,,5,3,2,5,4.90,60.0
3174,tt1105741,Roudram,2008,0,0,0,0,0,,,,0,0,0,0,,
3175,tt0758053,Saawariya,2007,"5,000+",5832,776,907,860,3,46.0,,22,9,13,22,5.00,41.0
3176,tt0165498,Storm,1999,100+,176,7,14,7,2.1,33.0,,1,0,1,1,,
3177,tt0266765,Mere Mehboob,1963,Fewer than 50,20,5,0,1,4.3,100.0,,0,0,0,0,,
3178,tt0298607,Yeh Zindagi Ka Safar,2001,50+,57,1,1,0,,,,0,0,0,0,,
3179,tt0995752,Tashan,2008,"2,500+",3602,160,659,481,2.1,20.0,,6,3,3,6,7.30,50.0
3180,tt1014775,Beverly Hills Chihuahua,2008,"100,000+",186629,3945,3722,3053,3.3,51.0,,99,40,59,99,5.10,40.0
3181,tt0250469,Killjoy,2000,"1,000+",1315,45,123,87,2.3,27.0,,0,0,0,0,,
3182,tt0093894,The Running Man,1987,"50,000+",81022,5292,3458,3035,3.5,61.0,,47,31,16,47,5.70,66.0
3183,tt0112322,All Men Are Liars,1995,Fewer than 50,2,2,0,1,,,,0,0,0,0,,
3184,tt0184907,Snow Day,2000,"25,000+",49589,420,1151,649,2.6,27.0,,66,19,47,66,4.40,29.0
3185,tt0411061,88 Minutes,2007,"100,000+",103949,5369,6943,5212,3,44.0,,123,6,117,123,2.90,5.0
3186,tt0188212,Sukeban deka,1987,50+,82,2,5,3,3.1,29.0,,0,0,0,0,,
3187,tt0073393,The Milpitas Monster,1976,50+,92,2,6,4,2.4,25.0,,0,0,0,0,,
3188,tt0183503,Me Myself I,1999,"1,000+",1535,72,53,36,3.5,58.0,,32,20,12,32,6.00,63.0
3189,tt0847204,3 Américas,2007,Fewer than 50,36,2,3,1,3.6,40.0,,0,0,0,0,,
3190,tt0081793,Christmas Evil,1980,"1,000+",2192,150,280,198,2.8,35.0,,9,6,3,9,5.80,67.0
3191,tt0071426,The Disappearance of Flight 412,1974,50+,68,2,14,10,2.5,12.0,,0,0,0,0,,
3192,tt0078034,The One and Only,1978,100+,102,12,10,9,3.3,55.0,,10,6,4,10,6.30,60.0
3193,tt0094813,Bulletproof,1987,100+,121,11,29,17,2.8,28.0,,0,0,0,0,,
3194,tt0189456,Cut,2000,"2,500+",2716,45,137,85,2.4,25.0,,9,1,8,9,4.40,11.0
3195,tt0140293,Jappanil Kalyanaraman,1985,0,0,0,0,0,,,,0,0,0,0,,
3196,tt0078790,The Apple Dumpling Gang Rides Again,1979,"5,000+",6531,137,119,120,3.5,54.0,,3,0,3,3,,
3197,tt0382443,The Thing Below,2004,500+,769,5,47,27,1.6,10.0,,0,0,0,0,,
3198,tt1445022,Garuda di Dadaku,2009,Fewer than 50,23,2,2,1,,,,0,0,0,0,,
3199,tt0177653,The Confessions of Amans,1976,0,0,0,0,0,,,,0,0,0,0,,
3200,tt0059878,Village of the Giants,1965,"1,000+",1369,21,86,53,2.2,20.0,,6,1,5,6,3.60,17.0
3201,tt0112558,The Boogeyman,1982,"5,000+",7780,99,185,138,2.8,35.0,,9,3,6,9,4.10,33.0
3202,tt0267761,Mounam,1995,0,0,0,0,0,,,,0,0,0,0,,
3203,tt0442764,Dil Jo Bhi Kahey...,2005,250+,356,7,18,8,2.4,28.0,,2,0,2,2,,
3204,tt0054762,Cone of Silence,1960,0,0,0,0,0,,,,0,0,0,0,,
3205,tt1370429,99,2009,"5,000+",7539,146,84,105,3.4,63.0,,3,1,2,3,,
3206,tt0214486,Arangetra Velai,1990,0,0,0,0,0,,,,0,0,0,0,,
3207,tt0874679,Son of the Dragon,2006,250+,293,16,24,12,3.1,40.0,,0,0,0,0,,
3208,tt0441781,Piece by Piece,2005,Fewer than 50,22,6,0,3,4.7,100.0,,4,3,1,4,,
3209,tt0476540,The Entrance,2006,250+,279,3,46,29,1.9,6.0,,0,0,0,0,,
3210,tt1095174,New in Town,2009,"100,000+",129448,2190,3722,2686,3,37.0,,173,49,124,173,4.40,28.0
3211,tt0461872,Human Trafficking,2005,"5,000+",6899,665,96,342,4.2,87.0,,1,1,0,1,,
3212,tt1247693,Sister Mary,2011,Fewer than 50,12,2,6,4,2.2,25.0,,0,0,0,0,,
3213,tt0179098,Moonlight Mile,2002,"10,000+",10318,965,503,413,3.6,66.0,,150,95,55,150,6.40,63.0
3214,tt0425600,"Sorry, Haters",2005,"2,500+",4444,86,97,103,3.2,47.0,,37,14,23,37,5.00,38.0
3215,tt1440319,The Golden Pin,2009,0,0,0,0,0,,,,0,0,0,0,,
3216,tt0105007,Nishchaiy,1992,0,0,0,0,0,,,,0,0,0,0,,
3217,tt0314186,Humko Tumse Pyaar Hai,2006,"2,500+",3731,105,23,73,4.2,82.0,,0,0,0,0,,
3218,tt0118929,Dark City,1998,"100,000+",153810,19360,3540,7202,4,85.0,,88,67,21,88,6.90,76.0
3219,tt0468831,Pauran,2005,0,0,0,0,0,,,,0,0,0,0,,
3220,tt2708550,Jal,2013,Fewer than 50,10,2,1,0,,,,1,1,0,1,,
3221,tt0418309,Bulutlari Beklerken,2004,100+,215,22,7,3,3.9,76.0,,0,0,0,0,,
3222,tt0062862,Daring Game,1968,Fewer than 50,6,1,0,0,,,,0,0,0,0,,
3223,tt1435513,Hysteria,2011,"10,000+",14542,1546,1344,473,3.3,54.0,,134,80,54,134,5.80,60.0
3224,tt0167758,Alice Through the Looking Glass,1998,"5,000+",7474,90,93,79,3.3,49.0,,0,0,0,0,,
3225,tt28636198,The Snapper,1993,"2,500+",3119,410,67,140,4.1,86.0,,33,32,1,33,7.40,97.0
3226,tt1423894,Barney's Version,2010,"10,000+",18470,3333,931,1077,3.8,78.0,,137,106,31,137,6.60,77.0
3227,tt1156454,Journey to the Center of the Earth,2008,"100,000+",236101,69,59,21,3.4,54.0,,161,97,64,161,6.00,60.0
3228,tt1490602,Children of God,2010,100+,108,31,30,20,3.4,51.0,,3,2,1,3,,
3229,tt0119215,Good Burger,1997,"50,000+",55510,3691,2126,2656,3.6,63.0,,45,15,30,45,4.30,33.0
3230,tt0105632,Trancers III,1992,500+,995,17,51,28,2.8,25.0,,0,0,0,0,,
3231,tt0172980,Pehla Nasha,1993,0,0,0,0,0,,,,0,0,0,0,,
3232,tt0061584,Doctor Dolittle,1967,"50,000+",73413,701,523,834,3.4,57.0,,21,6,15,21,4.30,29.0
3233,tt0070895,Walking Tall,1973,"5,000+",6755,306,129,155,3.7,71.0,,13,10,3,13,6.60,77.0
3234,tt1032825,Love and Other Impossible Pursuits,2009,"10,000+",15120,1390,1675,539,3.2,45.0,,47,18,29,47,5.50,38.0
3235,tt0185143,The Adventures of Tom Thumb & Thumbelina,2002,"1,000+",1031,33,52,21,3.1,39.0,,2,2,0,2,,
3236,tt0106519,Carlito's Way,1993,"100,000+",124924,17809,1776,4439,4.2,91.0,,50,42,8,50,7.20,84.0
3237,tt1673374,Everywhere and Nowhere,2011,100+,132,18,18,13,3.1,50.0,,12,1,11,12,3.50,8.0
3238,tt0079504,The Magician of Lublin,1979,Fewer than 50,7,0,1,0,,,,2,1,1,2,,
3239,tt1592873,LOL,2012,"10,000+",21867,2571,2526,572,3.2,50.0,,7,1,6,7,3.70,14.0
3240,tt0283952,Blue Hill Avenue,2001,"2,500+",4646,411,37,159,4.5,92.0,,2,1,1,2,,
3241,tt0110137,The Inkwell,1994,"1,000+",2258,185,39,61,4.1,83.0,,9,2,7,9,4.70,22.0
3242,tt0070510,Paper Moon,1973,"10,000+",11482,2630,156,820,4.4,94.0,,47,43,4,47,8.70,91.0
3243,tt0157583,Enigma,2001,"5,000+",8369,627,532,271,3.3,54.0,,106,76,30,106,6.60,72.0
3244,tt0246839,Papa Kahte Hain,1996,0,0,0,0,0,,,,0,0,0,0,,
3245,tt0064417,Hello Down There,1969,"1,000+",1181,28,20,26,3.6,58.0,,3,2,1,3,,
3246,tt0119495,Love 101,2000,500+,676,4,8,7,3.1,33.0,,2,0,2,2,,
3247,tt0142431,Khamoshi,1969,Fewer than 50,1,1,0,0,,,,0,0,0,0,,
3248,tt0082661,Lili Marleen,1981,500+,716,114,41,31,3.7,74.0,,12,6,6,12,5.80,50.0
3249,tt0353154,Aayushkalam,1992,0,0,0,0,0,,,,0,0,0,0,,
3250,tt0120660,Enemy of the State,1998,"250,000+",373230,15622,4315,7381,3.8,78.0,,84,60,24,84,6.40,71.0
3251,tt0337114,Romy and Michele: In the Beginning,2005,"1,000+",1041,53,91,34,2.6,37.0,,0,0,0,0,,
3252,tt1278374,Iodine,2009,Fewer than 50,9,3,3,2,2.9,50.0,,3,2,1,3,,
3253,tt0357179,A Sight for Sore Eyes,2004,0,0,0,0,0,,,,2,0,2,2,,
3254,tt1512506,The Lollipop Generation,2008,0,0,0,0,0,,,,1,1,0,1,,
3255,tt0077597,Gas Pump Girls,1979,100+,135,8,22,16,2.3,27.0,,0,0,0,0,,
3256,tt0324937,Doctor Zhivago,2002,"2,500+",3282,421,115,139,3.9,78.0,,2,2,0,2,,
3257,tt0077597,Gas Pump Girls,1979,100+,135,8,22,16,2.3,27.0,,0,0,0,0,,
3258,tt0427339,"Hawaii, Oslo",2004,"2,500+",2841,361,87,99,3.8,80.0,,1,1,0,1,,
3259,tt1017428,Captain Abu Raed,2007,500+,634,157,41,77,3.9,79.0,,35,28,7,35,6.80,80.0
3260,tt0418627,Death Tunnel,2005,"5,000+",7413,137,385,309,2.2,26.0,,5,0,5,5,2.30,0.0
3261,tt0114697,Top Dog,1995,"5,000+",7967,93,199,141,2.8,32.0,,9,0,9,9,3.00,0.0
3262,tt0297037,Brown Sugar,2002,"50,000+",55655,5220,561,1947,4.4,90.0,,88,58,30,88,6.20,66.0
3263,tt1641390,Blue Moon Rising,2010,50+,52,16,10,9,3.7,62.0,,2,1,1,2,,
3264,tt0457090,The Marksman,2005,"2,500+",4293,59,196,88,2.3,23.0,,1,0,1,1,,
3265,tt0899137,The Blue Hour,2007,100+,104,1,4,0,2.3,20.0,,0,0,0,0,,
3266,tt0302819,Mr. Bones,2001,250+,387,47,25,19,3.6,65.0,,0,0,0,0,,
3267,tt2990346,Goppinti Alludu,2000,0,0,0,0,0,,,,0,0,0,0,,
3268,tt0107668,Nemesis,1992,"1,000+",1407,82,120,86,2.9,41.0,,6,4,2,6,5.60,67.0
3269,tt0217869,Unbreakable,2000,"250,000+",291527,22022,6428,12568,3.8,77.0,,175,123,52,175,6.40,70.0
3270,tt0104139,Dr. Giggles,1992,"10,000+",10081,246,347,292,3,42.0,,31,7,24,31,3.70,23.0
3271,tt0084532,Prem Rog,1982,250+,310,25,4,9,4.2,86.0,,0,0,0,0,,
3272,tt0482606,The Strangers,2008,0,0,0,0,0,,,,0,0,0,0,,
3273,tt0482606,The Strangers,2008,0,0,0,0,0,,,,0,0,0,0,,
3274,tt0107987,Roosters,1993,0,0,0,0,0,,,,3,2,1,3,,
3275,tt0161023,Tumbleweeds,1999,"1,000+",1479,106,57,59,3.6,65.0,,68,56,12,68,7.00,82.0
3276,tt0250240,Bale Pandiya,1962,0,0,0,0,0,,,,0,0,0,0,,
3277,tt0180654,Downtime,1995,500+,520,5,11,7,2.7,31.0,,0,0,0,0,,
3278,tt0118030,Under the Lighthouse Dancing,1997,50+,74,10,2,4,4.2,83.0,,0,0,0,0,,
3279,tt0113540,Kids,1995,"50,000+",51674,7063,2161,3314,3.8,77.0,,57,26,31,57,5.70,46.0
3280,tt2181931,English Vinglish,2012,"2,500+",3164,782,155,210,4.1,83.0,,6,5,1,6,6.00,83.0
3281,tt0062360,They Came from Beyond Space,1967,500+,739,9,58,37,2.4,13.0,,4,1,3,4,,
3282,tt0211126,Zakhm,1998,500+,743,58,11,25,4.2,84.0,,1,1,0,1,,
3283,tt1105742,Swamp Devil,2008,250+,309,7,76,36,2,8.0,,2,0,2,2,,
3284,tt1153706,Dance Flick,2009,"250,000+",348214,1502,3431,2464,2.5,30.0,,96,17,79,96,3.60,18.0
3285,tt0141974,The War Zone,1999,"5,000+",5250,570,116,260,3.9,83.0,,32,27,5,32,7.50,84.0
3286,tt0279064,Elling,2001,"5,000+",6831,1311,133,360,4.2,91.0,,59,50,9,59,7.10,85.0
3287,tt0109219,Barcelona,1994,"2,500+",3741,406,100,124,4,80.0,,36,29,7,36,6.70,81.0
3288,tt0115760,Broken English,1996,100+,109,13,5,6,3.9,72.0,,17,14,3,17,6.80,82.0
3289,tt0115009,Yaraana,1995,50+,78,3,1,1,,,,0,0,0,0,,
3290,tt1426361,Eastern Plays,2009,100+,227,46,35,22,3.5,56.0,,0,0,0,0,,
3291,tt0476999,Das Fräulein,2006,Fewer than 50,1,0,1,1,,,,13,9,4,13,6.40,69.0
3292,tt0404254,My Sassy Girl,2008,"5,000+",5688,1032,1042,874,3.2,50.0,,4,2,2,4,,
3293,tt0062430,Valley of the Dolls,1967,"5,000+",5618,541,385,366,3.4,58.0,,40,13,27,40,4.80,33.0
3294,tt0803057,The Promotion,2008,"50,000+",84757,870,2217,1323,2.8,28.0,,77,42,35,77,5.90,55.0
3295,tt0079472,The Magnificent Butcher,1979,0,0,0,0,0,,,,0,0,0,0,,
3296,tt0114550,Stonewall,1995,500+,990,62,28,28,3.8,69.0,,9,6,3,9,6.70,67.0
3297,tt0062708,Bandolero!,1968,"2,500+",3515,83,83,54,3.3,50.0,,5,1,4,5,5.30,20.0
3298,tt0091400,Let's Get Harry,1986,100+,132,9,25,7,2.7,26.0,,1,1,0,1,,
3299,tt0100747,Tatie Danielle,1990,500+,675,184,36,57,4.1,84.0,,7,7,0,7,7.00,100.0
3300,tt0361620,First Daughter,2004,"50,000+",71570,1572,2128,1500,3,42.0,,86,7,79,86,3.80,8.0
3301,tt0197096,What's Cooking?,2000,"1,000+",1535,127,68,83,3.6,65.0,,66,34,32,66,5.50,52.0
3302,tt2104022,Enteng ng Ina mo,2011,Fewer than 50,31,2,10,3,1.8,17.0,,0,0,0,0,,
3303,tt1064744,Dying Breed,2008,"1,000+",1494,107,350,248,2.6,23.0,,10,5,5,10,4.80,50.0
3304,tt0078724,22 June 1897,1979,0,0,0,0,0,,,,0,0,0,0,,
3305,tt1559041,Zanzibar Musical Club,2009,0,0,0,0,0,,,,0,0,0,0,,
3306,tt0154446,Ek Nai Paheli,1984,Fewer than 50,38,2,1,1,,,,0,0,0,0,,
3307,tt1390851,Sathi,2002,0,0,0,0,0,,,,0,0,0,0,,
3308,tt0339334,The Magic Roundabout,2005,"5,000+",5702,155,151,156,3.3,50.0,,5,3,2,5,5.10,60.0
3309,tt1748224,Brooklyn Brothers Beat the Best,2011,"1,000+",1129,40,24,11,3.5,62.0,,21,7,14,21,5.00,33.0
3310,tt1063111,Small Town Saturday Night,2010,250+,385,39,116,39,2.7,25.0,,0,0,0,0,,
3311,tt0164211,Ultimate Deception,1999,Fewer than 50,5,0,1,1,,,,0,0,0,0,,
3312,tt0983990,1971,2007,250+,257,21,4,12,4.1,84.0,,1,1,0,1,,
3313,tt0187859,Genghis Blues,1999,"1,000+",1129,149,16,73,4.3,90.0,,12,9,3,12,7.20,75.0
3314,tt0119505,Curtain Call,1998,0,0,0,0,0,,,,1,1,0,1,,
3315,tt0290884,Tail Sting,2001,100+,140,7,13,11,2.5,35.0,,1,1,0,1,,
3316,tt1092634,Shanghai,2010,250+,344,171,69,73,3.6,71.0,,2,2,0,2,,
3317,tt1772332,Pappu Can't Dance Saala,2010,Fewer than 50,25,4,15,5,2.6,21.0,,1,0,1,1,,
3318,tt0113737,Magic in the Water,1995,"2,500+",2976,126,89,87,3.4,59.0,,24,5,19,24,3.60,21.0
3319,tt0338034,Killer Flood: The Day the Dam Broke,2003,"1,000+",1258,14,16,14,3.1,47.0,,0,0,0,0,,
3320,tt0086946,Beat Street,1984,"5,000+",7494,677,134,312,4.2,83.0,,7,4,3,7,4.00,57.0
3321,tt0113314,Hollow Reed,1996,50+,91,6,4,6,3.5,60.0,,13,10,3,13,7.20,77.0
3322,tt0119273,Heavy Metal 2000,2000,"10,000+",11940,321,576,361,2.8,36.0,,12,1,11,12,3.50,8.0
3323,tt0139859,Annamalai,1992,100+,248,14,2,6,4.4,88.0,,1,1,0,1,,
3324,tt0476013,"Hello Sister, Goodbye Life",2006,500+,619,65,61,16,3.4,52.0,,0,0,0,0,,
3325,tt0197750,Paranoid,2000,"1,000+",1747,22,114,45,2.2,16.0,,3,0,3,3,,
3326,tt0310733,Bertie and Elizabeth,2002,Fewer than 50,16,3,3,2,3.4,50.0,,1,0,1,1,,
3327,tt0871510,Chak De! India,2007,"10,000+",13516,2757,254,1080,4.3,92.0,,18,17,1,18,7.30,94.0
3328,tt0178198,Aap To Aise Na The,1980,0,0,0,0,0,,,,0,0,0,0,,
3329,tt1283913,High School Musical: El Desafío,2008,Fewer than 50,27,13,14,6,3,48.0,,0,0,0,0,,
3330,tt0114319,Sabrina,1995,"50,000+",52314,2689,1542,1571,3.6,64.0,,49,31,18,49,6.10,63.0
3331,tt0058294,Lilith,1964,500+,767,64,37,35,3.6,63.0,,7,6,1,7,7.60,86.0
3332,tt0157134,Un soir après la guerre,1998,0,0,0,0,0,,,,0,0,0,0,,
3333,tt0068659,Greaser's Palace,1972,500+,598,43,29,31,3.4,60.0,,6,3,3,6,4.00,50.0
3334,tt0889588,The Children of Huang Shi,2008,"50,000+",70061,1198,628,729,3.6,66.0,,78,24,54,78,4.70,31.0
3335,tt0105242,The Resurrected,1991,"1,000+",1537,90,79,68,3.2,54.0,,5,2,3,5,5.70,40.0
3336,tt0499182,Anokha Milan,1972,0,0,0,0,0,,,,0,0,0,0,,
3337,tt6765648,Vathiyar,2006,0,0,0,0,0,,,,0,0,0,0,,
3338,tt0084962,L'étoile du Nord,1982,0,0,0,0,0,,,,0,0,0,0,,
3339,tt2033947,Azaan,2011,100+,230,8,8,8,3.4,50.0,,1,1,0,1,,
3340,tt0085384,Curse of the Pink Panther,1983,"1,000+",1940,60,197,57,2.4,23.0,,14,4,10,14,4.00,29.0
3341,tt0145404,Possums,1998,50+,73,9,4,6,3.7,69.0,,0,0,0,0,,
3342,tt0246281,Todu Dongalu,1981,0,0,0,0,0,,,,0,0,0,0,,
3343,tt0072705,Bite the Bullet,1975,"1,000+",1700,87,73,51,3.4,54.0,,15,11,4,15,6.60,73.0
3344,tt1159922,Cheerful Weather for the Wedding,2012,250+,489,44,117,27,2.7,27.0,,30,11,19,30,5.20,37.0
3345,tt0104928,Mr. Saturday Night,1992,"5,000+",5256,129,210,98,3,38.0,,28,16,12,28,5.70,57.0
3346,tt0101465,Black Robe,1991,"5,000+",7057,369,121,166,3.8,75.0,,12,11,1,12,6.80,92.0
3347,tt0454433,Classic Dance of Love,2005,Fewer than 50,48,0,1,1,,,,0,0,0,0,,
3348,tt0088099,Sharaabi,1984,50+,89,19,11,5,3.7,63.0,,0,0,0,0,,
3349,tt0067531,One More Train to Rob,1971,Fewer than 50,17,5,3,4,3.9,62.0,,0,0,0,0,,
3350,tt1433822,The Apparition,2012,"10,000+",23585,1279,4008,856,2.3,24.0,,62,2,60,62,2.70,3.0
3351,tt0128378,Ogniem i mieczem,1999,Fewer than 50,2,2,0,0,,,,0,0,0,0,,
3352,tt0117473,The Rich Man's Wife,1996,"2,500+",4697,98,157,79,2.9,38.0,,15,2,13,15,4.10,13.0
3353,tt0120878,The Velocity of Gary,1998,"1,000+",1567,66,58,44,3.4,53.0,,18,4,14,18,4.00,22.0
3354,tt0092854,Death Before Dishonor,1987,"1,000+",1806,19,36,28,2.8,35.0,,3,0,3,3,,
3355,tt0060588,Khartoum,1966,"1,000+",2254,191,100,89,3.6,66.0,,10,10,0,10,7.00,100.0
3356,tt0471251,Mama Jack,2005,50+,70,8,4,3,3.5,67.0,,0,0,0,0,,
3357,tt1286159,1981,2009,50+,60,14,5,6,3.5,74.0,,0,0,0,0,,
3358,tt0758758,Into the Wild,2007,"100,000+",179832,58662,7220,24818,4.2,89.0,,201,166,35,201,7.50,83.0
3359,tt0064651,"Me, Natalie",1969,250+,435,17,7,4,3.9,74.0,,3,3,0,3,,
3360,tt0443526,Gypo,2005,500+,801,63,15,36,3.9,82.0,,4,4,0,4,,
3361,tt2375779,Wrong Turn 5,2012,"1,000+",1314,148,689,204,2.1,18.0,,3,0,3,3,,
3362,tt0102175,Jungle Fever,1991,"10,000+",15723,1293,648,459,3.6,67.0,,51,41,10,51,6.80,80.0
3363,tt0389313,Red Cockroaches,2003,500+,743,10,12,15,3,45.0,,5,4,1,5,6.60,80.0
3364,tt0423510,Warm Springs,2005,"1,000+",1346,145,42,77,3.9,78.0,,1,1,0,1,,
3365,tt0846699,Hineini: Coming Out in a Jewish High School,2005,0,0,0,0,0,,,,1,1,0,1,,
3366,tt1592503,Alien vs. Ninja,2010,250+,457,56,138,81,2.6,29.0,,3,0,3,3,,
3367,tt1756447,Carl Panzram: The Spirit of Hatred and Vengeance,2011,Fewer than 50,20,5,7,3,3,42.0,,0,0,0,0,,
3368,tt0251736,House of 1000 Corpses,2003,"100,000+",131086,9351,4981,6561,3.6,65.0,,87,18,69,87,3.80,21.0
3369,tt0099878,Jetsons: The Movie,1990,"25,000+",25957,346,419,383,3.2,45.0,,15,4,11,15,4.40,27.0
3370,tt0112760,Cutthroat Island,1995,"10,000+",21853,721,1080,747,3,40.0,,41,16,25,41,4.90,39.0
3371,tt0454987,Let's Go to Prison,2006,"100,000+",119964,2328,2513,2180,3.2,48.0,,40,5,35,40,3.30,13.0
3372,tt0389722,30 Days of Night,2007,"250,000+",459128,34398,27294,30977,3.3,56.0,,158,80,78,158,5.50,51.0
3373,tt0247254,The Code Conspiracy,2002,250+,403,3,11,4,2.4,21.0,,0,0,0,0,,
3374,tt0212974,Groove,2000,"5,000+",5943,542,133,242,4,80.0,,51,29,22,51,6.10,57.0
3375,tt0113215,The Great Mom Swap,1995,Fewer than 50,5,1,0,1,,,,0,0,0,0,,
3376,tt0099567,Fierrot le pou,1990,Fewer than 50,43,1,7,2,2.5,12.0,,0,0,0,0,,
3377,tt0092610,Bad Taste,1987,"25,000+",33573,3638,1225,2002,3.8,75.0,,21,15,6,21,6.40,71.0
3378,tt0435437,Taarzan: The Wonder Car,2004,100+,158,5,24,8,2.3,17.0,,0,0,0,0,,
3379,tt1990321,Shankaranum Mohananum,2011,Fewer than 50,2,0,1,0,,,,0,0,0,0,,
3380,tt0064087,The Big Bounce,1969,"1,000+",1481,12,26,15,2.8,32.0,,1,0,1,1,,
3381,tt0800367,Storm Warning,2007,"1,000+",2237,204,352,305,2.9,37.0,,5,5,0,5,7.00,100.0
3382,tt0065560,The Cockeyed Cowboys of Calico County,1970,50+,71,6,5,1,3.5,55.0,,0,0,0,0,,
3383,tt0811082,Stalking Santa,2006,250+,365,23,11,18,3.8,68.0,,2,1,1,2,,
3384,tt0323531,Out for a Kill,2003,"5,000+",8203,101,290,127,2.4,26.0,,3,0,3,3,,
3385,tt0246834,The Other Me,2000,250+,466,48,60,18,3.3,44.0,,2,2,0,2,,
3386,tt0086987,Bolero,1984,"1,000+",1519,22,102,46,1.9,18.0,,23,0,23,23,2.00,0.0
3387,tt0156639,The Big Tease,1999,"1,000+",2499,112,94,88,3.4,54.0,,39,22,17,39,5.70,56.0
3388,tt1324053,Happy Ever Afters,2009,500+,588,19,80,19,2.7,19.0,,1,1,0,1,,
3389,tt1591095,Insidious,2010,"100,000+",131530,55279,33900,9043,3.6,62.0,,177,118,59,177,6.10,67.0
3390,tt1082075,Pusher,2010,"2,500+",3715,255,487,99,2.9,34.0,,49,23,26,49,5.40,47.0
3391,tt0410162,The King Maker,2005,500+,621,7,80,57,1.8,8.0,,0,0,0,0,,
3392,tt1927093,Fred 2: Night of the Living Fred,2011,500+,595,97,157,79,2.7,38.0,,0,0,0,0,,
3393,tt0110432,Magic Kid II,1994,50+,82,3,4,2,3.1,43.0,,0,0,0,0,,
3394,tt0063592,Shalako,1968,"1,000+",2011,35,83,45,2.9,30.0,,6,3,3,6,4.80,50.0
3395,tt0107060,Gumrah,1993,50+,58,7,3,1,4,70.0,,0,0,0,0,,
3396,tt0440803,Shutter,2004,0,0,0,0,0,,,,0,0,0,0,,
3397,tt1337510,Livestock,2009,Fewer than 50,3,2,0,0,,,,1,0,1,1,,
3398,tt0457302,Choking Man,2006,500+,668,30,51,35,3,37.0,,33,17,16,33,5.20,52.0
3399,tt1575539,Elena Undone,2010,500+,523,130,76,42,3.5,63.0,,6,3,3,6,6.00,50.0
3400,tt0059224,Girl Happy,1965,"5,000+",5375,128,64,89,3.8,67.0,,2,0,2,2,,
3401,tt0117882,Terror in the Family,1996,100+,136,15,16,6,3,48.0,,0,0,0,0,,
3402,tt0210358,Things You Can Tell Just by Looking at Her,2000,"2,500+",4780,408,227,170,3.5,64.0,,21,16,5,21,6.60,76.0
3403,tt0095060,Dr. Alien,1989,"1,000+",1335,10,22,11,2.6,31.0,,0,0,0,0,,
3404,tt0126026,Shadow of the Boomerang,1960,0,0,0,0,0,,,,0,0,0,0,,
3405,tt0822849,Rails & Ties,2007,"10,000+",10103,341,246,287,3.4,58.0,,47,16,31,47,4.60,34.0
3406,tt0104215,Excessive Force,1993,"1,000+",1581,19,34,23,2.9,36.0,,5,1,4,5,3.80,20.0
3407,tt0119426,Joyride,1997,"2,500+",3456,51,125,51,2.6,29.0,,5,1,4,5,4.50,20.0
3408,tt0971204,Long Pigs,2007,100+,113,22,11,9,3.8,67.0,,2,2,0,2,,
3409,tt0109529,Dance Me Outside,1994,"2,500+",4791,253,27,149,4.4,90.0,,13,9,4,13,5.70,69.0
3410,tt1437598,Deiva Magan,1969,0,0,0,0,0,,,,0,0,0,0,,
3411,tt1033575,The Descendants,2011,"50,000+",70150,28031,7615,6406,3.8,79.0,,271,236,35,271,8.10,87.0
3412,tt0284083,Ek Rishtaa: The Bond of Love,2001,250+,344,12,11,1,3.6,52.0,,0,0,0,0,,
3413,tt1262981,World's Greatest Dad,2009,"50,000+",51860,5174,2578,2274,3.5,67.0,,118,104,14,118,6.90,88.0
3414,tt0107927,The Real McCoy,1993,"5,000+",7915,3,2,0,3.7,60.0,,18,4,14,18,4.10,22.0
3415,tt0125439,Notting Hill,1999,"250,000+",508913,38877,10325,14692,3.9,79.0,,106,89,17,106,7.10,84.0
3416,tt0113855,Mortal Kombat,1995,"250,000+",312115,10735,7957,7408,3.5,57.0,,45,21,24,45,4.80,47.0
3417,tt0254927,Aaghaaz,2000,0,0,0,0,0,,,,0,0,0,0,,
3418,tt0113749,Mallrats,1995,"100,000+",220301,24936,5462,9758,4,82.0,,48,28,20,48,5.60,58.0
3419,tt0100920,When Will I Be Loved?,1990,0,0,0,0,0,,,,0,0,0,0,,
3420,tt1275863,Love Aaj Kal,2009,0,0,0,0,0,,,,0,0,0,0,,
3421,tt1947973,Bin Bulaye Baraati,2011,0,0,0,0,0,,,,0,0,0,0,,
3422,tt0339840,Undead,2003,"10,000+",15746,856,1068,1023,3,44.0,,78,26,52,78,4.60,33.0
3423,tt0235235,Blacktop,2000,500+,646,17,13,10,3.4,57.0,,0,0,0,0,,
3424,tt0421090,Zerophilia,2005,"1,000+",1628,183,116,128,3.4,61.0,,20,5,15,20,4.80,25.0
3425,tt1098358,The Attic Door,2009,Fewer than 50,12,2,0,0,,,,1,1,0,1,,
3426,tt0061370,Aurat,1967,0,0,0,0,0,,,,0,0,0,0,,
3427,tt1097013,Next Day Air,2009,"100,000+",167376,679,1488,929,2.8,31.0,,66,14,52,66,4.10,21.0
3428,tt0822819,Kissing Cousins,2008,100+,194,16,23,17,3.1,41.0,,0,0,0,0,,
3429,tt1290470,Arcadia Lost,2010,Fewer than 50,27,1,3,0,,,,0,0,0,0,,
3430,tt0072623,Alfie Darling,1975,50+,86,1,6,5,1.6,14.0,,1,1,0,1,,
3431,tt0114571,Stuart Saves His Family,1995,"2,500+",3208,111,100,93,3.2,53.0,,27,8,19,27,5.10,30.0
3432,tt0099365,Darkman,1990,"50,000+",53445,3040,2091,1538,3.4,59.0,,63,52,11,63,6.90,83.0
3433,tt1528312,Route Irish,2010,500+,717,176,160,93,3.2,53.0,,30,22,8,30,5.90,73.0
3434,tt0129332,Ravenous,1999,"10,000+",21547,2899,829,1516,3.9,78.0,,65,33,32,65,6.00,51.0
3435,tt1549829,Bioscope,2008,0,0,0,0,0,,,,0,0,0,0,,
3436,tt0055464,Something Wild,1961,250+,365,20,28,14,3,42.0,,8,4,4,8,6.00,50.0
3437,tt0142231,Down in the Delta,1998,"1,000+",1436,115,47,43,3.8,71.0,,72,55,17,72,7.00,76.0
3438,tt0105604,To Catch a Killer,1992,500+,557,79,13,38,4.1,86.0,,1,0,1,1,,
3439,tt1037163,The Time That Remains,2009,"5,000+",7989,267,123,65,3.6,68.0,,49,42,7,49,6.90,86.0
3440,tt0246073,Mechanic Alludu,1993,0,0,0,0,0,,,,0,0,0,0,,
3441,tt0171356,Gun Shy,2000,"5,000+",5301,149,263,124,2.9,36.0,,43,11,32,43,4.80,26.0
3442,tt0828065,Moondance Alexander,2007,500+,733,129,65,77,3.7,66.0,,2,0,2,2,,
3443,tt0084385,Namak Halaal,1982,500+,609,60,12,19,4.1,83.0,,0,0,0,0,,
3444,tt0066294,The Resurrection of Broncho Billy,1970,Fewer than 50,47,4,4,4,3.2,50.0,,0,0,0,0,,
3445,tt0205418,The Smokers,2000,"2,500+",2831,87,119,72,2.8,42.0,,4,1,3,4,,
3446,tt0379754,Death to the Supermodels,2005,500+,905,19,113,55,1.8,15.0,,1,0,1,1,,
3447,tt0108233,Strawberry Fields,1997,100+,101,2,6,3,2.8,25.0,,2,0,2,2,,
3448,tt0061842,Jewel Thief,1967,50+,94,19,3,6,4.1,86.0,,0,0,0,0,,
3449,tt1210042,Brooklyn's Finest,2009,"100,000+",101155,5006,5895,3385,3.1,46.0,,153,67,86,153,5.50,44.0
3450,tt0805492,Bhadra,2005,0,0,0,0,0,,,,0,0,0,0,,
3451,tt0099389,December Bride,1990,Fewer than 50,45,5,2,2,3.6,71.0,,4,2,2,4,,
3452,tt0420835,Opal Dream,2006,"1,000+",1534,141,78,128,3.6,64.0,,35,24,11,35,6.10,69.0
3453,tt1512220,My Friend Pinto,2011,50+,85,11,11,2,3.1,50.0,,3,0,3,3,,
3454,tt0479974,Passage to Zarahemla,2007,250+,360,24,26,28,3.3,48.0,,1,1,0,1,,
3455,tt0327775,Brush with Fate,2003,250+,320,11,11,8,3.1,50.0,,0,0,0,0,,
3456,tt0177882,Kebab Connection,2004,"1,000+",2219,251,92,69,3.7,73.0,,3,3,0,3,,
3457,tt0406759,The Eye,2008,"250,000+",303504,8083,10538,9538,3.1,43.0,,77,17,60,77,4.20,22.0
3458,tt0363472,Bewafaa,2005,500+,925,72,48,27,3.4,60.0,,0,0,0,0,,
3459,tt0056585,Tickle Me,1965,"1,000+",1008,58,38,39,3.6,60.0,,1,0,1,1,,
3460,tt0306698,Cybermutt,2003,100+,232,6,4,3,3.4,60.0,,1,0,1,1,,
3461,tt1018830,Yonkers Joe,2008,500+,583,46,47,47,3.3,49.0,,21,11,10,21,5.20,52.0
3462,tt0163187,Runaway Bride,1999,"250,000+",438079,9498,8614,7486,3.3,52.0,,87,40,47,87,5.40,46.0
3463,tt0054988,Homicidal,1961,"1,000+",1138,121,63,84,3.6,66.0,,11,8,3,11,6.60,73.0
3464,tt1112782,Thick as Thieves,2009,"5,000+",5700,694,1386,766,2.9,33.0,,5,1,4,5,3.80,20.0
3465,tt0080489,La cage aux folles II,1980,"1,000+",1397,65,55,27,3.3,54.0,,7,4,3,7,6.30,57.0
3466,tt0925259,The Monastery: Mr. Vig and the Nun,2006,250+,498,46,5,17,4.1,90.0,,18,15,3,18,6.90,83.0
3467,tt0118749,Boogie Nights,1997,"100,000+",189978,21282,2516,6390,4.2,89.0,,77,72,5,77,8.10,94.0
3468,tt0071790,Madhouse,1974,500+,658,115,116,98,3.3,50.0,,5,2,3,5,4.90,40.0
3469,tt0475390,Shut Up and Sing,2006,"5,000+",8777,1554,262,1057,4.1,86.0,,125,111,14,125,7.60,89.0
3470,tt0095304,High Spirits,1988,"5,000+",7475,404,286,255,3.5,59.0,,15,4,11,15,3.70,27.0
3471,tt0137455,Dastak,1970,0,0,0,0,0,,,,0,0,0,0,,
3472,tt0070948,Zardoz,1974,"5,000+",9040,1029,902,939,3.2,53.0,,38,19,19,38,5.60,50.0
3473,tt0087384,Hard to Hold,1984,"1,000+",1754,64,41,69,3.6,61.0,,2,0,2,2,,
3474,tt1600058,The Cutting Edge: Fire & Ice,2010,100+,240,48,31,9,3.6,61.0,,0,0,0,0,,
3475,tt0466208,Bhairav,2001,0,0,0,0,0,,,,0,0,0,0,,
3476,tt0985692,"Girl, Positive",2007,500+,723,100,45,64,3.8,69.0,,0,0,0,0,,
3477,tt0985692,"Girl, Positive",2007,500+,723,100,45,64,3.8,69.0,,0,0,0,0,,
3478,tt1082881,"Two Fists, One Heart",2008,100+,142,13,18,11,2.9,42.0,,9,9,0,9,7.30,100.0
3479,tt0110593,Munchie Strikes Back,1994,Fewer than 50,39,3,8,1,2.3,27.0,,0,0,0,0,,
3480,tt0985692,"Girl, Positive",2007,500+,723,100,45,64,3.8,69.0,,0,0,0,0,,
3481,tt0053716,Cinderfella,1960,"2,500+",4459,161,87,100,3.6,65.0,,5,3,2,5,5.90,60.0
3482,tt0067634,The Pursuit of Happiness,1971,Fewer than 50,30,3,6,2,3.2,33.0,,0,0,0,0,,
3483,tt0488352,The Company,2007,500+,602,113,36,62,3.9,76.0,,2,1,1,2,,
3484,tt0079584,Mr. Natwarlal,1979,50+,72,4,8,0,3,33.0,,0,0,0,0,,
3485,tt0061179,Where the Bullets Fly,1966,0,0,0,0,0,,,,0,0,0,0,,
3486,tt0149691,Anywhere But Here,1999,"25,000+",39758,1187,988,585,3.4,55.0,,88,55,33,88,6.30,63.0
3487,tt0095975,Renegade,1987,"1,000+",1438,30,24,4,3.5,56.0,,0,0,0,0,,
3488,tt1440266,Pina,2011,"5,000+",8475,1599,372,400,4,81.0,,106,101,5,106,8.30,95.0
3489,tt0158690,Joshila,1973,0,0,0,0,0,,,,0,0,0,0,,
3490,tt0478311,Knocked Up,2007,"250,000+",2085205,243296,51267,158308,4,83.0,,253,226,27,253,7.70,89.0
3491,tt0112438,The Babysitter,1995,"2,500+",4860,51,262,73,2.2,16.0,,7,2,5,7,3.30,29.0
3492,tt0125879,Lulu on the Bridge,1998,"1,000+",1543,112,97,56,3.3,54.0,,8,0,8,8,3.60,0.0
3493,tt1916728,Shor in the City,2010,100+,153,74,23,18,3.5,76.0,,2,2,0,2,,
3494,tt0417011,Nerukku Ner,1997,100+,139,6,2,0,3.7,75.0,,0,0,0,0,,
3495,tt0109035,Above the Rim,1994,"25,000+",30745,2161,467,711,4.1,82.0,,21,11,10,21,5.40,52.0
3496,tt1104733,Hamlet 2,2008,"10,000+",17676,3200,2553,3135,3.3,56.0,,146,91,55,146,6.20,62.0
3497,tt0111273,The St. Tammany Miracle,1994,Fewer than 50,16,4,1,1,4.6,80.0,,0,0,0,0,,
3498,tt0246815,Nirakkoottu,1985,0,0,0,0,0,,,,0,0,0,0,,
3499,tt0098382,Star Trek V: The Final Frontier,1989,"50,000+",58744,1497,4648,2126,2.6,24.0,,52,11,41,52,3.90,21.0
3500,tt0107895,Public Access,1993,250+,394,10,27,11,2.9,27.0,,12,7,5,12,5.40,58.0
3501,tt1135503,Julie & Julia,2009,"250,000+",363644,18756,8075,11112,3.6,70.0,,228,176,52,228,6.70,77.0
3502,tt0217894,The Woman Chaser,1999,100+,165,20,8,18,3.9,71.0,,14,10,4,14,7.10,71.0
3503,tt0111547,The Unborn II,1994,250+,362,9,12,7,2.8,43.0,,1,0,1,1,,
3504,tt0109010,1942: A Love Story,1994,500+,835,71,30,19,3.8,70.0,,0,0,0,0,,
3505,tt0308875,Shaheed-E-Mohabbat Boota Singh,1999,0,0,0,0,0,,,,0,0,0,0,,
3506,tt1229366,Life Partner,2009,500+,652,57,76,53,3,43.0,,1,0,1,1,,
3507,tt1430074,Bhoomi Malayalam,2009,0,0,0,0,0,,,,0,0,0,0,,
3508,tt1212454,An Invisible Sign,2010,"1,000+",1965,154,312,102,2.7,33.0,,15,0,15,15,3.10,0.0
3509,tt0790741,The Riddle,2007,500+,608,28,114,73,2.3,20.0,,1,0,1,1,,
3510,tt0449389,Shaadi No. 1,2005,250+,425,6,26,9,2.4,19.0,,0,0,0,0,,
3511,tt2146836,Diamond Necklace,2012,Fewer than 50,39,5,6,0,2.4,45.0,,0,0,0,0,,
3512,tt0492956,The Game Plan,2007,"250,000+",407068,23190,10281,12137,3.7,69.0,,104,31,73,104,4.70,30.0
3513,tt0063286,Me and My Brother,1968,Fewer than 50,17,3,0,1,,,,1,1,0,1,,
3514,tt1185420,Dostana,2008,"2,500+",4460,865,414,582,3.6,68.0,,16,13,3,16,6.80,81.0
3515,tt1376699,Den Brother,2010,250+,306,58,54,12,3.4,52.0,,1,1,0,1,,
3516,tt0096257,The Thin Blue Line,1988,"5,000+",8727,1897,216,568,4.2,90.0,,18,18,0,18,8.90,100.0
3517,tt1228931,Kuruvi,2008,Fewer than 50,3,0,3,0,,,,0,0,0,0,,
3518,tt0327004,Kuch Tum Kaho Kuch Hum Kahein,2002,Fewer than 50,32,2,2,0,,,,0,0,0,0,,
3519,tt0362387,2LDK,2003,"2,500+",2981,409,117,232,3.8,78.0,,9,9,0,9,7.40,100.0
3520,tt0058110,For Those Who Think Young,1964,50+,55,3,11,9,2.6,21.0,,1,0,1,1,,
3521,tt0254164,Bahurani,1964,0,0,0,0,0,,,,0,0,0,0,,
3522,tt0261552,The Foul King,2000,50+,75,23,8,2,3.7,74.0,,1,1,0,1,,
3523,tt0073796,Ransom,1974,Fewer than 50,13,0,1,0,,,,0,0,0,0,,
3524,tt0221905,Octopus,2000,500+,612,12,71,43,1.9,14.0,,3,0,3,3,,
3525,tt1266027,The Marine 2,2009,"1,000+",1598,210,409,213,2.8,34.0,,0,0,0,0,,
3526,tt0114127,The Piano Lesson,1995,250+,252,32,10,9,3.8,76.0,,4,3,1,4,,
3527,tt1160328,Kalloori,2007,0,0,0,0,0,,,,0,0,0,0,,
3528,tt0072024,Pray for the Wildcats,1974,Fewer than 50,27,3,7,4,2.8,30.0,,2,2,0,2,,
3529,tt1157605,Anvil: The Story of Anvil,2008,"5,000+",9222,2948,309,1278,4.1,90.0,,139,136,3,139,8.00,98.0
3530,tt0762105,I Hate Valentine's Day,2009,"25,000+",48348,704,1808,665,2.6,28.0,,26,5,21,26,3.50,19.0
3531,tt0387925,Chestnut: Hero of Central Park,2004,500+,569,77,58,40,3.4,57.0,,1,1,0,1,,
3532,tt0104027,CrissCross,1992,500+,984,15,47,13,2.7,24.0,,2,0,2,2,,
3533,tt1075746,I Am Omega,2006,500+,812,39,225,143,1.9,15.0,,0,0,0,0,,
3534,tt0455583,Komodo vs. Cobra,2005,500+,890,31,113,81,2.1,22.0,,0,0,0,0,,
3535,tt0358294,Into the Sun,2005,"5,000+",8548,115,312,146,2.6,27.0,,2,0,2,2,,
3536,tt0475591,Gharshana,2004,0,0,0,0,0,,,,0,0,0,0,,
3537,tt1239461,Tokyo Marble Chocolate,2007,Fewer than 50,1,1,0,0,,,,0,0,0,0,,
3538,tt1324078,Kal Kissne Dekha,2009,50+,57,5,7,1,2.8,42.0,,1,0,1,1,,
3539,tt0100456,The Rainbow Thief,1990,500+,522,23,37,13,2.9,38.0,,0,0,0,0,,
3540,tt0172495,Gladiatoren,2000,"250,000+",34128168,170538,24401,1652336,3.8,87.0,,257,205,52,257,7.40,80.0
3541,tt0425966,Electric Shadows,2004,"10,000+",15898,147,27,61,4,84.0,,12,9,3,12,6.80,75.0
3542,tt0284610,Larry-Boy and the Rumor Weed,1999,Fewer than 50,1,1,0,0,,,,0,0,0,0,,
3543,tt0139046,Baharon Ki Manzil,1968,0,0,0,0,0,,,,0,0,0,0,,
3544,tt1508675,Le Havre,2011,"5,000+",7355,1527,510,325,3.7,75.0,,98,97,1,98,7.80,99.0
3545,tt0867145,Classmates,2006,50+,64,5,0,0,4.2,100.0,,1,1,0,1,,
3546,tt2524674,Wetlands,2013,"1,000+",1714,376,196,81,3.5,66.0,,58,53,5,58,7.20,91.0
3547,tt0867145,Classmates,2006,50+,64,5,0,0,4.2,100.0,,1,1,0,1,,
3548,tt1713501,Level Up,2011,50+,52,12,14,8,2.8,46.0,,0,0,0,0,,
3549,tt0287969,Comic Book Villains,2002,"1,000+",2114,79,204,99,2.7,28.0,,4,3,1,4,,
3550,tt0800080,The Incredible Hulk,2008,"250,000+",741428,57201,25417,35266,3.6,69.0,,239,160,79,239,6.20,67.0
3551,tt0116418,Girls Town,1996,500+,609,69,17,25,3.9,80.0,,26,22,4,26,6.70,85.0
3552,tt1916676,Fixing America,2012,0,0,0,0,0,,,,0,0,0,0,,
3553,tt0120347,Tomorrow Never Dies,1997,"100,000+",231335,6825,6059,5117,3.3,53.0,,93,53,40,93,6.10,57.0
3554,tt0092026,Sultanat,1986,50+,76,0,2,0,,,,0,0,0,0,,
3555,tt0379865,Leatherheads,2008,"100,000+",156757,3834,6301,4886,3,38.0,,169,88,81,169,5.80,52.0
3556,tt1045670,Happy-Go-Lucky,2008,"25,000+",34794,5430,2711,3511,3.5,67.0,,163,151,12,163,7.70,93.0
3557,tt0406514,Adventures of Young Van Helsing: The Quest for the Lost Scepter,2004,Fewer than 50,27,2,3,1,2.7,40.0,,0,0,0,0,,
3558,tt0157337,Azaad,1978,0,0,0,0,0,,,,0,0,0,0,,
3559,tt1443564,Tarot,2009,0,0,0,0,0,,,,0,0,0,0,,
3560,tt2028578,The Tsunami and the Cherry Blossom,2011,50+,53,21,1,4,4.4,95.0,,0,0,0,0,,
3561,tt0296915,Valentín,2002,"2,500+",4872,653,48,228,4.3,93.0,,66,41,25,66,6.30,62.0
3562,tt0118174,The Winner,1996,50+,81,2,20,4,2.3,9.0,,6,1,5,6,3.50,17.0
3563,tt0410407,Orwell Rolls in His Grave,2003,"1,000+",1177,99,10,43,4.3,91.0,,24,19,5,24,6.80,79.0
3564,tt0246905,Saajan Chale Sasural,1996,50+,83,4,6,0,2.9,40.0,,0,0,0,0,,
3565,tt0338096,Dirty Dancing: Havana Nights,2004,"250,000+",269684,8834,3326,7345,3.8,73.0,,107,25,82,107,4.30,23.0
3566,tt1322385,Submarino,2010,"25,000+",25731,7365,1664,1495,3.9,82.0,,156,137,19,156,7.40,88.0
3567,tt2112127,Christmas Magic,2011,Fewer than 50,26,12,8,3,3.5,60.0,,0,0,0,0,,
3568,tt0347817,A Problem with Fear,2003,"1,000+",1518,12,13,8,3.2,48.0,,6,1,5,6,4.60,17.0
3569,tt0882759,Chinthamani Kolacase,2006,0,0,0,0,0,,,,0,0,0,0,,
3570,tt0388323,Parthiban Kanavu,2003,0,0,0,0,0,,,,0,0,0,0,,
3571,tt0117070,Mojave Moon,1996,"2,500+",3217,42,108,41,2.8,28.0,,1,1,0,1,,
3572,tt0361858,Lurking in Suburbia,2006,Fewer than 50,9,2,1,1,,,,4,4,0,4,,
3573,tt0435625,The Descent,2005,"100,000+",207986,19592,6317,12643,3.8,76.0,,189,164,25,189,7.40,87.0
3574,tt0382601,Chantal,2007,Fewer than 50,13,3,4,1,3,43.0,,0,0,0,0,,
3575,tt1191971,Zone of the Dead,2009,500+,575,33,116,68,2.4,22.0,,1,1,0,1,,
3576,tt0422908,Pammal K. Sambandam,2002,100+,176,10,4,1,3.5,71.0,,0,0,0,0,,
3577,tt0098473,Thunderground,1989,Fewer than 50,9,0,1,1,,,,0,0,0,0,,
3578,tt0118528,12 Angry Men,1997,"10,000+",20547,1767,270,603,4.2,87.0,,15,14,1,15,7.20,93.0
3579,tt1365496,Parijatham,2006,Fewer than 50,1,1,0,0,,,,0,0,0,0,,
3580,tt0095389,Jack's Back,1988,"1,000+",1726,66,110,66,3,38.0,,7,5,2,7,6.30,71.0
3581,tt0056967,Cry of Battle,1963,Fewer than 50,13,0,6,2,2.6,0.0,,1,1,0,1,,
3582,tt0107474,Mâdadayo,1993,"2,500+",3278,372,87,112,4,81.0,,15,13,2,15,7.20,87.0
3583,tt0455362,The Breed,2006,"5,000+",8873,466,1115,824,2.6,29.0,,15,4,11,15,3.50,27.0
3584,tt0068795,Kansas City Bomber,1972,"1,000+",1058,32,53,29,3,38.0,,1,1,0,1,,
3585,tt1636842,Virsa,2010,Fewer than 50,26,1,7,3,1.9,12.0,,0,0,0,0,,
3586,tt1519245,Agnosia,2010,100+,157,29,57,15,2.8,34.0,,2,2,0,2,,
3587,tt0076715,Silver Bears,1977,100+,106,6,12,4,3.1,33.0,,1,1,0,1,,
3588,tt0101615,Cool as Ice,1991,"2,500+",4538,311,408,409,2.8,43.0,,33,1,32,33,2.90,3.0
3589,tt0321640,Cheeky,2003,0,0,0,0,0,,,,0,0,0,0,,
3590,tt0120025,Road to Nhill,1997,Fewer than 50,5,1,2,1,,,,0,0,0,0,,
3591,tt0104118,Doing Time on Maple Drive,1992,"1,000+",1259,67,33,27,3.7,67.0,,3,0,3,3,,
3592,tt0112642,Casper,1995,"250,000+",381391,4661,4761,7870,3.3,50.0,,42,22,20,42,5.10,52.0
3593,tt0826031,Arang,2006,500+,958,107,100,91,3.4,52.0,,1,1,0,1,,
3594,tt0376144,Saamy,2003,Fewer than 50,1,1,0,0,,,,0,0,0,0,,
3595,tt1632726,The Boy Mir,2011,0,0,0,0,0,,,,0,0,0,0,,
3596,tt0379184,Blackballed: The Bobby Dukes Story,2004,"1,000+",1454,181,102,129,3.6,64.0,,19,10,9,19,5.40,53.0
3597,tt0059408,Love and Kisses,1965,Fewer than 50,1,1,0,0,,,,0,0,0,0,,
3598,tt1274650,Sundo,2009,0,0,0,0,0,,,,0,0,0,0,,
3599,tt0252501,Hearts in Atlantis,2001,"10,000+",23566,1638,919,776,3.6,64.0,,137,67,70,137,5.70,49.0
3600,tt0070673,The Severed Arm,1973,50+,85,3,14,12,2.4,18.0,,3,2,1,3,,
3601,tt0065963,The Landlord,1970,500+,888,134,35,59,3.8,79.0,,14,13,1,14,7.60,93.0
3602,tt0369400,Eroica,2003,100+,107,13,3,10,3.8,81.0,,0,0,0,0,,
3603,tt0266875,Raat,1992,Fewer than 50,40,6,6,0,3.2,50.0,,1,1,0,1,,
3604,tt0074184,Barocco,1976,100+,237,19,8,6,3.5,69.0,,3,2,1,3,,
3605,tt0108341,Time Indefinite,1993,100+,124,20,5,7,4,80.0,,5,4,1,5,7.10,80.0
3606,tt0249963,Siri Siri Muvva,1976,0,0,0,0,0,,,,0,0,0,0,,
3607,tt0219333,Suspicious River,2000,100+,207,11,26,15,2.8,30.0,,7,2,5,7,4.60,29.0
3608,tt1085515,Weather Girl,2009,"5,000+",6405,158,282,125,2.9,36.0,,9,3,6,9,5.30,33.0
3609,tt0106627,The Crush,1993,"10,000+",20307,614,864,472,3.1,42.0,,30,8,22,30,4.20,27.0
3610,tt0814335,The Stepfather,2009,"250,000+",982328,3622,6915,3559,2.9,34.0,,64,8,56,64,3.50,13.0
3611,tt0077270,The Boys in Company C,1978,"2,500+",3542,126,39,72,3.9,76.0,,3,2,1,3,,
3612,tt1172994,The House of the Devil,2009,"50,000+",56002,3803,2251,1935,3.4,63.0,,101,86,15,101,7.10,85.0
3613,tt0099717,Gumapang ka sa lusak,1990,0,0,0,0,0,,,,0,0,0,0,,
3614,tt0388473,Tokyo Godfathers,2003,"10,000+",14053,2936,299,915,4.2,91.0,,76,70,6,76,7.30,92.0
3615,tt0120777,The Opposite of Sex,1998,"10,000+",16494,1000,671,490,3.5,60.0,,43,35,8,43,7.10,81.0
3616,tt0094750,Black Eagle,1988,"2,500+",3086,47,247,83,2.1,16.0,,2,0,2,2,,
3617,tt0124298,Blast from the Past,1999,"100,000+",214785,3402,2616,3573,3.4,57.0,,81,47,34,81,6.10,58.0
3618,tt9244928,Unarchigal,1976,0,0,0,0,0,,,,0,0,0,0,,
3619,tt1980986,Housefull 2,2012,Fewer than 50,3,3,0,0,,,,0,0,0,0,,
3620,tt1497874,Cold Weather,2010,"1,000+",2052,224,207,115,3.2,52.0,,64,49,15,64,6.90,77.0
3621,tt0915460,Grizzly Park,2008,500+,953,40,217,140,2,16.0,,1,0,1,1,,
3622,tt0381131,The Deal,2003,100+,249,3,18,6,2.1,14.0,,0,0,0,0,,
3623,tt2118688,My Househusband: Ikaw na!,2011,0,0,0,0,0,,,,0,0,0,0,,
3624,tt0427392,The Invasion,2007,"100,000+",236195,8051,11932,9365,3,40.0,,164,32,132,164,4.40,20.0
3625,tt0805185,Blood Trails,2006,250+,490,17,107,68,1.8,14.0,,2,0,2,2,,
3626,tt0380623,The Perfect Man,2005,"250,000+",281802,7235,5180,5752,3.4,58.0,,128,8,120,128,3.40,6.0
3627,tt1393744,Only When I Dance,2009,500+,818,40,13,11,3.8,75.0,,13,12,1,13,7.20,92.0
3628,tt0092684,Body Slam,1986,500+,773,49,44,34,3.2,53.0,,1,0,1,1,,
3629,tt2496990,Nirop,2007,0,0,0,0,0,,,,0,0,0,0,,
3630,tt0076590,Rabid,1977,"5,000+",7295,555,658,374,3.2,46.0,,27,21,6,27,6.30,78.0
3631,tt1356935,Viduthalai,1986,0,0,0,0,0,,,,0,0,0,0,,
3632,tt1117385,Felon,2008,"10,000+",13950,3366,742,1571,3.9,82.0,,25,15,10,25,6.40,60.0
3633,tt0471571,Athadu,2005,250+,308,101,5,21,4.5,95.0,,1,0,1,1,,
3634,tt0072226,The Sugarland Express,1974,"5,000+",7232,721,369,292,3.5,66.0,,52,45,7,52,7.20,87.0
3635,tt0083015,S.O.B.,1981,"2,500+",2587,178,102,103,3.6,64.0,,25,20,5,25,6.80,80.0
3636,tt0059094,Dear Brigitte,1965,100+,136,17,14,10,3.3,55.0,,0,0,0,0,,
3637,tt0337824,And Starring Pancho Villa as Himself,2003,500+,877,129,113,53,3.4,53.0,,3,3,0,3,,
3638,tt1179071,The Orphan Killer,2011,Fewer than 50,22,5,6,1,3,45.0,,0,0,0,0,,
3639,tt0492478,The Peace Tree,2005,0,0,0,0,0,,,,0,0,0,0,,
3640,tt1039969,The Last Lear,2007,250+,440,61,41,50,3.5,60.0,,3,0,3,3,,
3641,tt0150915,Hilary and Jackie,1998,"5,000+",6596,841,175,262,4,83.0,,60,53,7,60,7.50,88.0
3642,tt1836912,Shaitan,2011,100+,129,73,26,21,3.5,74.0,,2,1,1,2,,
3643,tt0061005,The She Beast,1966,250+,308,10,31,19,2.6,24.0,,7,5,2,7,5.90,71.0
3644,tt1805263,I Am Kalam,2010,Fewer than 50,49,25,9,6,3.5,74.0,,5,4,1,5,6.00,80.0
3645,tt0067977,When Michael Calls,1972,Fewer than 50,6,1,3,2,,,,0,0,0,0,,
3646,tt0080731,The Fiendish Plot of Dr. Fu Manchu,1980,500+,813,45,59,37,3,43.0,,12,2,10,12,3.80,17.0
3647,tt0466399,Ten Canoes,2006,"5,000+",6932,750,213,440,3.8,78.0,,66,65,1,66,7.80,98.0
3648,tt0266757,Mehboob Ki Mehndi,1971,0,0,0,0,0,,,,0,0,0,0,,
3649,tt0102581,Old Scores,1991,Fewer than 50,35,1,0,0,,,,0,0,0,0,,
3650,tt10196342,Paarai,2003,0,0,0,0,0,,,,0,0,0,0,,
3651,tt0478134,In the Valley of Elah,2007,"25,000+",29370,8799,2677,5198,3.7,77.0,,163,120,43,163,7.00,74.0
3652,tt0065547,Chisum,1970,"5,000+",7537,400,139,157,3.8,74.0,,6,5,1,6,5.80,83.0
3653,tt0362590,Employee of the Month,2004,"250,000+",422114,9434,8477,11820,3.3,53.0,,92,18,74,92,4.10,20.0
3654,tt0099364,The Dark Side of the Moon,1990,500+,893,23,80,41,2.4,22.0,,1,0,1,1,,
3655,tt0362590,Employee of the Month,2004,"250,000+",422114,9434,8477,11820,3.3,53.0,,92,18,74,92,4.10,20.0
3656,tt0225013,Aa Gale Lag Jaa,1994,0,0,0,0,0,,,,0,0,0,0,,
3657,tt0317796,Kalaignan,1993,0,0,0,0,0,,,,0,0,0,0,,
3658,tt0307568,Time of the Wolf,2002,"2,500+",4932,558,302,252,3.5,65.0,,53,36,17,53,6.40,68.0
3659,tt0054290,September Storm,1960,0,0,0,0,0,,,,0,0,0,0,,
3660,tt0425326,Outsourced,2006,"5,000+",6486,1610,586,835,3.7,73.0,,42,32,10,42,6.70,76.0
3661,tt2359175,Mayamohini,2012,0,0,0,0,0,,,,0,0,0,0,,
3662,tt1149610,La Virgen Negra,2008,Fewer than 50,38,4,4,4,3,50.0,,1,0,1,1,,
3663,tt2917786,Thirupathi,2006,0,0,0,0,0,,,,0,0,0,0,,
3664,tt1227931,Slightly Single in L.A.,2013,100+,217,20,93,15,2.1,18.0,,0,0,0,0,,
3665,tt0057063,Flipper,1963,"25,000+",26376,195,206,119,3.4,49.0,,6,3,3,6,4.70,50.0
3666,tt0079191,Game for Vultures,1979,100+,147,3,9,5,2.3,25.0,,0,0,0,0,,
3667,tt0122906,Among Giants,1998,250+,281,17,26,10,3,40.0,,22,14,8,22,5.60,64.0
3668,tt0453671,Garam Masala,2005,"2,500+",4105,246,91,110,3.7,73.0,,1,0,1,1,,
3669,tt0118863,Clay Pigeons,1998,"5,000+",9656,858,415,458,3.6,67.0,,54,33,21,54,6.20,61.0
3670,tt0280381,25 Watts,2001,500+,851,85,23,23,4,79.0,,0,0,0,0,,
3671,tt0109708,Eden Valley,1995,Fewer than 50,2,1,0,1,,,,2,1,1,2,,
3672,tt0095904,Prison,1987,500+,835,81,159,67,2.9,34.0,,5,2,3,5,5.10,40.0
3673,tt0130036,It Came from the Sky,1999,100+,197,6,8,6,3.4,43.0,,0,0,0,0,,
3674,tt0122768,Twin Sitters,1994,"1,000+",1143,58,42,33,3.6,59.0,,0,0,0,0,,
3675,tt0094351,Just Heroes,1989,0,0,0,0,0,,,,0,0,0,0,,
3676,tt6358182,Unnai Ninaithu,2002,0,0,0,0,0,,,,0,0,0,0,,
3677,tt0120036,Rosewood,1997,"5,000+",7977,704,145,292,4.1,83.0,,55,48,7,55,7.10,87.0
3678,tt0076029,Fire Sale,1977,Fewer than 50,1,1,0,1,,,,2,0,2,2,,
3679,tt0106505,Calendar Girl,1993,"5,000+",5268,54,120,68,2.8,31.0,,19,2,17,19,3.40,11.0
3680,tt0069515,The Wrath of God,1972,100+,102,9,15,9,3.1,38.0,,3,1,2,3,,
3681,tt1341167,Four Lions,2010,"10,000+",23493,6125,1570,2107,3.8,80.0,,139,115,24,139,7.30,83.0
3682,tt0082382,First Monday in October,1981,500+,985,25,29,21,3.3,46.0,,4,1,3,4,,
3683,tt0119429,Julian Po,1997,"1,000+",1018,58,29,28,3.4,67.0,,4,2,2,4,,
3684,tt0367652,Deuce Bigalow: European Gigolo,2005,"100,000+",194079,1904,3804,2843,2.6,33.0,,99,9,90,99,3.30,9.0
3685,tt0395580,Home Beyond the Sun,2004,250+,341,5,7,2,2.9,42.0,,0,0,0,0,,
3686,tt0250491,Late Night Shopping,2001,"1,000+",1245,126,35,60,3.9,78.0,,6,4,2,6,5.70,67.0
3687,tt0063673,Tarzan and the Jungle Boy,1968,Fewer than 50,20,0,9,3,2.1,0.0,,1,0,1,1,,
3688,tt0081624,Thodisi Bewafaii,1980,Fewer than 50,36,2,0,0,,,,0,0,0,0,,
3689,tt0118753,Born Into Exile,1997,100+,221,9,1,2,4.6,90.0,,0,0,0,0,,
3690,tt0060801,The Oscar,1966,100+,103,9,22,13,2.5,29.0,,17,2,15,17,3.30,12.0
3691,tt0103671,American Me,1992,"10,000+",10368,1610,181,448,4.3,90.0,,11,8,3,11,6.70,73.0
3692,tt1226273,Edge of Darkness,2010,"250,000+",542564,8657,9018,6360,3.2,49.0,,218,120,98,218,5.90,55.0
3693,tt1623013,Vacation with Derek,2010,100+,101,18,22,9,3.4,45.0,,0,0,0,0,,
3694,tt0065025,The Southern Star,1969,Fewer than 50,4,0,2,0,,,,1,0,1,1,,
3695,tt0165854,The Limey,1999,"10,000+",11662,1867,528,715,3.8,78.0,,86,79,7,86,7.40,92.0
3696,tt0158131,Purgatory,1999,"2,500+",3464,181,51,93,4,78.0,,3,1,2,3,,
3697,tt0791201,VeggieTales: Lord of the Beans,2005,100+,198,23,7,5,4,77.0,,1,1,0,1,,
3698,tt0054798,Dentist on the Job,1961,0,0,0,0,0,,,,0,0,0,0,,
3699,tt0181830,Solomon and Gaenor,1999,"1,000+",1001,59,14,28,3.9,81.0,,27,19,8,27,6.80,70.0
3700,tt1582604,Simha,2010,50+,54,10,10,4,3.4,50.0,,0,0,0,0,,
3701,tt0110668,Night of the Running Man,1995,250+,289,25,25,14,3.1,50.0,,3,2,1,3,,
3702,tt0383278,Comfort and Joy,2003,250+,267,22,27,15,3.3,45.0,,1,0,1,1,,
3703,tt0071548,Get Christie Love!,1974,"1,000+",1191,9,16,18,3.1,36.0,,1,1,0,1,,
3704,tt0430377,Muhammad: The Last Prophet,2002,100+,139,20,6,7,4.1,77.0,,4,2,2,4,,
3705,tt0076717,The Singer and the Dancer,1977,0,0,0,0,0,,,,0,0,0,0,,
3706,tt0328089,Maayi,2000,0,0,0,0,0,,,,0,0,0,0,,
3707,tt0449828,Ayya,2005,0,0,0,0,0,,,,0,0,0,0,,
3708,tt1172203,Sita Sings the Blues,2008,"2,500+",2943,737,132,309,4,85.0,,32,32,0,32,8.30,100.0
3709,tt0104938,Munchie,1992,250+,353,25,38,24,3,41.0,,2,0,2,2,,
3710,tt1182884,Dulha Mil Gaya,2010,250+,281,33,59,30,2.7,36.0,,1,1,0,1,,
3711,tt0478166,The Heart of the Game,2005,"10,000+",24332,292,58,242,4,83.0,,100,87,13,100,7.50,87.0
3712,tt0345074,Connie and Carla,2004,"10,000+",12910,1080,458,775,3.8,70.0,,120,53,67,120,5.10,44.0
3713,tt0317243,Chinnavar,1992,0,0,0,0,0,,,,0,0,0,0,,
3714,tt0095690,Mystic Pizza,1988,"25,000+",43903,1677,1401,825,3.4,54.0,,27,21,6,27,6.80,78.0
3715,tt0090915,Dead End Drive-In,1986,"1,000+",1976,71,97,74,3,43.0,,0,0,0,0,,
3716,tt0460975,Unidentified,2006,500+,636,37,31,39,3.2,54.0,,1,0,1,1,,
3717,tt0098678,Worth Winning,1989,"1,000+",1077,35,49,25,3,42.0,,5,0,5,5,3.50,0.0
3718,tt1931549,"The Man Nobody Knew: In Search of My Father, CIA Spymaster William Colby",2011,250+,307,44,26,15,3.6,63.0,,25,21,4,25,7.00,84.0
3719,tt0295718,Take Away,2003,"1,000+",1425,45,33,44,3.4,58.0,,3,3,0,3,,
3720,tt0245479,Just a Kiss,2002,"1,000+",1381,26,66,27,2.5,28.0,,60,11,49,60,4.10,18.0
3721,tt1538503,Los Bandoleros,2009,250+,294,68,57,13,3.4,54.0,,0,0,0,0,,
3722,tt0062765,Bullitt,1968,"25,000+",40192,5912,1050,2589,4.1,85.0,,45,44,1,45,7.80,98.0
3723,tt0907676,The Hills Run Red,2009,"1,000+",2126,308,617,401,2.8,33.0,,7,4,3,7,5.40,57.0
3724,tt0117942,Tornado!,1996,"2,500+",3157,30,85,67,2.6,26.0,,0,0,0,0,,
3725,tt0072236,The Swinging Cheerleaders,1974,50+,65,8,17,5,2.7,32.0,,2,2,0,2,,
3726,tt0075669,Amar Akbar Anthony,1977,"2,500+",2747,249,42,79,4.1,86.0,,2,2,0,2,,
3727,tt0089371,Mr. Vampire,1985,"2,500+",4758,347,49,179,4.1,88.0,,7,6,1,7,5.70,86.0
3728,tt0089371,Mr. Vampire,1985,"2,500+",4758,347,49,179,4.1,88.0,,7,6,1,7,5.70,86.0
3729,tt0089371,Mr. Vampire,1985,"2,500+",4758,347,49,179,4.1,88.0,,7,6,1,7,5.70,86.0
3730,tt2022587,Vetri kodi kattu,2000,0,0,0,0,0,,,,0,0,0,0,,
3731,tt0072972,Faraar,1975,0,0,0,0,0,,,,0,0,0,0,,
3732,tt0060169,Birds Do It,1966,0,0,0,0,0,,,,0,0,0,0,,
3733,tt0360139,Chasing Liberty,2004,"50,000+",77310,3349,2219,2084,3.5,60.0,,117,21,96,117,4.70,18.0
3734,tt0242508,Harvard Man,2001,"5,000+",7899,154,308,169,2.8,33.0,,36,12,24,36,4.60,33.0
3735,tt0352520,The Life and Death of Peter Sellers,2004,"5,000+",8890,1071,417,532,3.6,72.0,,26,18,8,26,6.20,69.0
3736,tt0841046,Walk Hard: The Dewey Cox Story,2007,"250,000+",303143,14118,10557,12455,3.3,57.0,,143,107,36,143,6.60,75.0
3737,tt0155896,Nadodi Thendral,1992,0,0,0,0,0,,,,0,0,0,0,,
3738,tt0073639,Royal Flash,1975,250+,280,38,20,26,3.6,66.0,,5,2,3,5,6.50,40.0
3739,tt1806954,Lost Christmas,2011,100+,100,71,9,39,4.5,89.0,,1,1,0,1,,
3740,tt1205558,Hick,2011,"5,000+",6694,847,1496,354,2.9,36.0,,22,1,21,22,3.10,5.0
3741,tt0093347,The Killing Time,1987,"1,000+",1356,18,34,7,2.8,35.0,,1,1,0,1,,
3742,tt0963208,Where in the World Is Osama Bin Laden?,2008,"2,500+",4146,764,690,819,3.3,52.0,,107,41,66,107,4.90,38.0
3743,tt0118707,Beverly Hills Family Robinson,1997,500+,607,16,29,12,2.9,36.0,,0,0,0,0,,
3744,tt0079709,Penitentiary,1979,"1,000+",1369,14,24,14,2.7,37.0,,1,0,1,1,,
3745,tt0064579,The Learning Tree,1969,500+,564,52,8,26,4.1,86.0,,17,13,4,17,7.00,76.0
3746,tt0417395,7 Seconds,2005,"10,000+",10723,111,325,139,2.5,25.0,,4,1,3,4,,
3747,tt0118745,Bloodmoon,1997,"1,000+",1633,15,14,11,2.9,52.0,,0,0,0,0,,
3748,tt0479968,One Missed Call,2008,"50,000+",61790,3432,8414,5368,2.5,29.0,,80,0,80,80,2.60,0.0
3749,tt0101453,Billy Bathgate,1991,"5,000+",5912,155,399,108,2.8,28.0,,25,9,16,25,5.00,36.0
3750,tt0120117,Shikari,2000,0,0,0,0,0,,,,0,0,0,0,,
3751,tt0479968,One Missed Call,2008,"50,000+",61790,3432,8414,5368,2.5,29.0,,80,0,80,80,2.60,0.0
3752,tt0293562,The Rosa Parks Story,2002,Fewer than 50,6,4,2,1,4.3,67.0,,2,2,0,2,,
3753,tt1361809,Arundhati,2009,100+,180,30,11,15,3.7,73.0,,0,0,0,0,,
3754,tt0090887,Critters,1986,"50,000+",53245,1134,1403,1180,3.2,45.0,,49,25,24,49,5.40,51.0
3755,tt0217086,Devil in the Flesh 2,2000,"1,000+",1071,21,50,16,2.7,30.0,,6,2,4,6,4.90,33.0
3756,tt0986329,Mungaru Male,2006,Fewer than 50,1,0,1,0,,,,0,0,0,0,,
3757,tt0365296,Hair High,2004,100+,156,29,11,6,3.6,72.0,,19,14,5,19,6.50,74.0
3758,tt0147843,Anokhi Raat,1968,Fewer than 50,26,2,0,2,,,,0,0,0,0,,
3759,tt0122029,The Crippled Masters,1979,"1,000+",1249,93,50,75,3.7,65.0,,1,0,1,1,,
3760,tt0944835,Salt,2010,Fewer than 50,15,3,1,0,,,,1,0,1,1,,
3761,tt0364571,Once More,1997,50+,71,0,3,0,,,,0,0,0,0,,
3762,tt0264792,Let's Get Skase,2001,Fewer than 50,2,0,2,1,,,,4,2,2,4,,
3763,tt0383719,Xcuse Me,2003,100+,124,4,5,2,3.1,44.0,,0,0,0,0,,
3764,tt1568338,Man on a Ledge,2012,"25,000+",41315,9546,8889,2594,3.3,52.0,,163,51,112,163,4.80,31.0
3765,tt0271368,Arasiyal,1997,0,0,0,0,0,,,,0,0,0,0,,
3766,tt0303929,Dracula III: Legacy,2005,"5,000+",5930,70,154,86,2.6,31.0,,7,3,4,7,5.00,43.0
3767,tt0143338,Killer Crocodile,1989,100+,102,5,26,12,2.6,16.0,,0,0,0,0,,
3768,tt0094052,Strange Voices,1987,0,0,0,0,0,,,,0,0,0,0,,
3769,tt0132888,Blood Freak,1972,500+,939,59,64,74,3,48.0,,2,0,2,2,,
3770,tt0978764,Sucker Punch,2011,"50,000+",97184,18203,20574,11948,3.1,47.0,,220,48,172,220,4.10,22.0
3771,tt0295725,Time Changer,2002,Fewer than 50,15,12,3,12,4.1,80.0,,9,2,7,9,5.00,22.0
3772,tt0292332,Vietnam Colony,1992,0,0,0,0,0,,,,0,0,0,0,,
3773,tt0115791,Busted,1997,Fewer than 50,21,1,4,1,1.8,20.0,,0,0,0,0,,
3774,tt0292332,Vietnam Colony,1992,0,0,0,0,0,,,,0,0,0,0,,
3775,tt0108308,Teenage Mutant Ninja Turtles III,1993,"50,000+",92187,2290,4556,2594,2.8,33.0,,32,6,26,32,4.10,19.0
3776,tt0077531,F.I.S.T,1978,"1,000+",1908,177,137,77,3.4,56.0,,11,8,3,11,6.80,73.0
3777,tt0110706,Oblivion,1994,250+,454,16,43,26,2.5,27.0,,3,2,1,3,,
3778,tt1185262,Pourudu,2008,Fewer than 50,36,1,1,0,,,,0,0,0,0,,
3779,tt0422617,Lastikman,2004,100+,134,2,2,3,,,,0,0,0,0,,
3780,tt0418141,Scooby-Doo and the Loch Ness Monster,2004,"5,000+",8447,194,134,104,3.6,59.0,,1,1,0,1,,
3781,tt1324058,Separation City,2009,100+,174,19,43,17,2.7,31.0,,5,4,1,5,6.40,80.0
3782,tt0961108,Fireflies in the Garden,2008,"25,000+",45164,977,1182,490,3.2,45.0,,52,11,41,52,4.20,21.0
3783,tt0120275,The Tango Lesson,1997,"2,500+",4276,246,70,113,4,78.0,,19,10,9,19,6.00,53.0
3784,tt0107613,Mr. Wonderful,1993,"2,500+",3378,90,125,56,3.2,42.0,,21,11,10,21,5.80,52.0
3785,tt0102915,Showdown in Little Tokyo,1991,"10,000+",10276,587,555,422,3.3,51.0,,9,3,6,9,4.30,33.0
3786,tt0067924,Vampire Circus,1972,"1,000+",1526,144,81,93,3.6,64.0,,5,4,1,5,6.30,80.0
3787,tt0102915,Showdown in Little Tokyo,1991,"10,000+",10276,587,555,422,3.3,51.0,,9,3,6,9,4.30,33.0
3788,tt0795439,Numb,2007,"2,500+",3373,597,489,487,3.3,55.0,,3,1,2,3,,
3789,tt0301417,The Honourable Wally Norman,2003,100+,149,8,5,2,3.3,62.0,,0,0,0,0,,
3790,tt0097665,The Kill-Off,1989,100+,128,0,2,1,,,,4,4,0,4,,
3791,tt1340161,The Prince & Me: The Elephant Adventure,2010,100+,244,30,43,15,2.9,41.0,,1,0,1,1,,
3792,tt0416471,American Gun,2005,"2,500+",3608,147,192,121,3.1,43.0,,31,12,19,31,5.30,39.0
3793,tt0118829,Cats Don't Dance,1997,"10,000+",11184,999,251,536,4,80.0,,24,17,7,24,6.50,71.0
3794,tt11542520,Samudhram,2001,0,0,0,0,0,,,,0,0,0,0,,
3795,tt1182345,Moon,2009,"100,000+",101106,29667,3809,9712,4.1,89.0,,197,177,20,197,7.50,90.0
3796,tt0107563,The Meteor Man,1993,"5,000+",6447,255,451,240,2.9,36.0,,16,4,12,16,4.00,25.0
3797,tt0118866,Clockwatchers,1997,"2,500+",4882,289,182,120,3.5,61.0,,26,22,4,26,6.90,85.0
3798,tt0392908,When Do We Eat?,2005,"1,000+",1122,84,38,55,3.6,69.0,,38,16,22,38,4.90,42.0
3799,tt0112664,Choices of the Heart: The Margaret Sanger Story,1995,Fewer than 50,25,3,4,0,3.3,43.0,,0,0,0,0,,
3800,tt0101701,Delirious,1991,"2,500+",3049,175,274,123,3,39.0,,21,6,15,21,5.30,29.0
3801,tt1258805,Ullasanga Utsahanga,2008,0,0,0,0,0,,,,0,0,0,0,,
3802,tt0498399,We Own the Night,2007,"250,000+",264412,18882,12031,12265,3.5,61.0,,154,88,66,154,5.90,57.0
3803,tt0778602,About a Boy,2003,"250,000+",31164074,37601,31257,792589,2.8,55.0,,184,171,13,184,7.70,93.0
3804,tt0090886,Crimes of the Heart,1986,"2,500+",2760,170,93,70,3.7,65.0,,22,18,4,22,6.90,82.0
3805,tt0071800,Majboor,1974,Fewer than 50,9,3,1,0,,,,0,0,0,0,,
3806,tt0096376,A Very Brady Christmas,1988,500+,960,61,64,58,3.3,49.0,,0,0,0,0,,
3807,tt0287781,Utsab,2000,0,0,0,0,0,,,,0,0,0,0,,
3808,tt0346148,With or Without You,2003,250+,353,9,2,3,4.1,82.0,,0,0,0,0,,
3809,tt0345855,The Republic of Love,2003,500+,853,32,35,32,3.1,48.0,,9,4,5,9,5.50,44.0
3810,tt1932767,What Maisie Knew,2012,"10,000+",15297,3431,881,470,3.9,80.0,,111,96,15,111,7.60,86.0
3811,tt0319660,Keladi Kanmani,1990,Fewer than 50,1,1,0,1,,,,0,0,0,0,,
3812,tt0092718,Can't Buy Me Love,1987,"25,000+",48316,2849,1011,1452,3.9,74.0,,24,12,12,24,5.00,50.0
3813,tt0112681,Citizen X,1995,"2,500+",4670,777,128,252,4,86.0,,7,6,1,7,7.30,86.0
3814,tt0359619,Love 86,1986,0,0,0,0,0,,,,0,0,0,0,,
3815,tt0094325,Wild Thing,1987,250+,307,19,14,14,3.4,58.0,,6,2,4,6,4.10,33.0
3816,tt0417658,Factotum,2005,"10,000+",19684,1118,690,643,3.4,62.0,,121,90,31,121,6.80,74.0
3817,tt0819755,Babysitter Wanted,2008,"1,000+",1868,149,443,265,2.6,25.0,,1,1,0,1,,
3818,tt0466664,Alien Autopsy,2006,"10,000+",12816,399,396,381,3.3,50.0,,8,6,2,8,5.60,75.0
3819,tt0112685,"Class of Nuke 'Em High Part 3: The Good, the Bad and the Subhumanoid",1994,250+,290,11,39,22,2.3,22.0,,0,0,0,0,,
3820,tt0083365,Zoot Suit,1981,"1,000+",1197,125,44,56,3.9,74.0,,11,6,5,11,4.90,55.0
3821,tt0103783,Bebe's Kids,1992,"10,000+",10142,650,227,360,3.9,74.0,,11,4,7,11,4.40,36.0
3822,tt0181618,Judy Berlin,1999,500+,589,41,19,16,3.6,68.0,,31,24,7,31,7.10,77.0
3823,tt0400426,Far Cry,2008,"1,000+",2290,80,600,310,1.8,12.0,,2,0,2,2,,
3824,tt0267277,Ashi Hi Banwa Banwi,1988,0,0,0,0,0,,,,1,1,0,1,,
3825,tt1129423,Fireproof,2008,"25,000+",39821,5829,1251,3326,4.2,82.0,,21,8,13,21,4.60,38.0
3826,tt0099292,The Comfort of Strangers,1990,"1,000+",1852,128,88,76,3.4,59.0,,23,12,11,23,5.60,52.0
3827,tt0248500,Swarnakamalam,1988,0,0,0,0,0,,,,0,0,0,0,,
3828,tt2156899,Naa Ishtam,2012,0,0,0,0,0,,,,0,0,0,0,,
3829,tt0155157,Serial Lover,1998,500+,597,70,21,15,3.9,77.0,,0,0,0,0,,
3830,tt0454919,Pulse,2006,"50,000+",83355,1714,4527,3770,2.5,28.0,,73,8,65,73,3.70,11.0
3831,tt0101486,Blue Desert,1990,100+,226,7,10,1,3,41.0,,1,1,0,1,,
3832,tt0062974,Finian's Rainbow,1968,"2,500+",3586,131,123,107,3.4,52.0,,15,8,7,15,5.60,53.0
3833,tt0113492,Judge Dredd,1995,"100,000+",132717,2205,5051,2760,2.7,30.0,,54,12,42,54,4.00,22.0
3834,tt0364396,Hatchetman,2003,250+,285,7,35,25,2.1,17.0,,0,0,0,0,,
3835,tt0080485,Caboblanco,1980,50+,98,1,10,3,2.4,9.0,,1,0,1,1,,
3836,tt1175709,All Good Things,2010,"25,000+",39244,2125,3684,1015,3,37.0,,98,34,64,98,5.50,35.0
3837,tt1365483,Main Street,2010,"1,000+",1836,38,299,93,2.1,11.0,,8,1,7,8,4.70,13.0
3838,tt1672845,You Instead,2011,"2,500+",3672,351,233,81,3.6,60.0,,47,18,29,47,4.70,38.0
3839,tt1104123,The Scorpion King 2: Rise of a Warrior,2008,"5,000+",7875,307,1425,823,2.1,18.0,,3,0,3,3,,
3840,tt0083728,Chan Is Missing,1982,500+,633,100,33,37,3.8,75.0,,51,49,2,51,7.40,96.0
3841,tt1183911,Mr. Nice,2010,"2,500+",4020,317,407,219,3.1,44.0,,47,25,22,47,5.50,53.0
3842,tt0280241,Black River,2001,250+,431,25,25,12,3.1,50.0,,0,0,0,0,,
3843,tt1227381,Little Girl Lost: The Delimar Vera Story,2008,250+,299,36,6,12,4.4,86.0,,0,0,0,0,,
3844,tt0081159,Midnight Madness,1980,"2,500+",3026,244,105,149,3.8,70.0,,3,0,3,3,,
3845,tt0070530,Phagun,1973,0,0,0,0,0,,,,0,0,0,0,,
3846,tt0284445,Sabretooth,2002,"1,000+",1486,20,114,66,1.9,15.0,,4,1,3,4,,
3847,tt0388364,Red Dust,2004,"1,000+",1820,152,58,103,3.7,72.0,,4,4,0,4,,
3848,tt0230832,Attack from Space,1965,100+,215,11,16,17,3.1,41.0,,0,0,0,0,,
3849,tt0064160,"Cherry, Harry & Raquel!",1969,100+,125,14,18,10,3.1,44.0,,1,1,0,1,,
3850,tt0138681,The Opportunists,1999,100+,143,12,15,11,3,44.0,,28,15,13,28,5.90,54.0
3851,tt0066550,Watermelon Man,1970,"1,000+",1059,103,44,74,3.6,70.0,,8,7,1,8,7.10,88.0
3852,tt0253658,Scooby-Doo and the Alien Invaders,2000,250+,495,148,94,35,3.6,62.0,,5,4,1,5,5.50,80.0
3853,tt0455906,The American Ruling Class,2005,500+,540,46,16,30,3.9,74.0,,0,0,0,0,,
3854,tt0470381,Jaan Tere Naam,1992,0,0,0,0,0,,,,0,0,0,0,,
3855,tt1664806,Raavanan,2010,"1,000+",2257,229,262,244,3,47.0,,19,13,6,19,6.00,68.0
3856,tt0129359,On the 2nd Day of Christmas,1997,250+,390,31,16,16,3.7,66.0,,0,0,0,0,,
3857,tt1170404,Mere Baap Pehle Aap,2008,"1,000+",1723,72,154,104,2.8,32.0,,1,0,1,1,,
3858,tt0099173,Brain Dead,1990,"5,000+",7708,338,156,191,3.6,68.0,,6,1,5,6,5.00,17.0
3859,tt0115798,The Cable Guy,1996,"250,000+",471646,7318,7100,9875,3.2,51.0,,80,44,36,80,5.70,55.0
3860,tt0080836,Hangar 18,1980,"1,000+",1341,23,56,35,2.7,29.0,,5,2,3,5,5.10,40.0
3861,tt0365748,Shaun of the Dead,2004,"250,000+",499304,98890,7780,39176,4.3,93.0,,218,200,18,218,7.80,92.0
3862,tt0061589,Dont Look Back,1967,"5,000+",5726,1098,95,339,4.3,92.0,,55,50,5,55,8.70,91.0
3863,tt0961728,The Escapist,2008,"10,000+",14823,996,573,585,3.4,63.0,,46,31,15,46,6.20,67.0
3864,tt0961728,The Escapist,2008,"10,000+",14823,996,573,585,3.4,63.0,,46,31,15,46,6.20,67.0
3865,tt0380599,Oliver Twist,2005,"10,000+",23320,1521,897,703,3.5,63.0,,142,86,56,142,6.30,61.0
3866,tt0098444,Tarzan in Manhattan,1989,100+,105,1,6,0,2,14.0,,0,0,0,0,,
3867,tt0380599,Oliver Twist,2005,"10,000+",23320,1521,897,703,3.5,63.0,,142,86,56,142,6.30,61.0
3868,tt0124901,Thursday,1998,"5,000+",5733,776,177,289,4,81.0,,7,3,4,7,5.10,43.0
3869,tt0275381,Grahan,2001,0,0,0,0,0,,,,0,0,0,0,,
3870,tt0096071,The Serpent and the Rainbow,1988,"10,000+",15467,1031,784,637,3.4,57.0,,37,23,14,37,5.70,62.0
3871,tt0092298,Zone Troopers,1985,100+,165,25,34,26,3.1,42.0,,1,1,0,1,,
3872,tt0095956,Rambo III,1988,"50,000+",77634,4014,4902,2204,3.2,45.0,,37,15,22,37,4.70,41.0
3873,tt0402739,Aag Andhi Aur Toofan,1994,0,0,0,0,0,,,,0,0,0,0,,
3874,tt0464288,Underexposure,2005,0,0,0,0,0,,,,0,0,0,0,,
3875,tt1149405,Trouble the Water,2008,"1,000+",1991,438,68,214,4,87.0,,76,73,3,76,8.10,96.0
3876,tt0375063,Sideways,2004,"100,000+",197951,26465,7227,10822,3.8,79.0,,231,223,8,231,8.60,97.0
3877,tt0163862,T-Rex: Back to the Cretaceous,1998,500+,975,13,31,13,2.6,30.0,,21,15,6,21,6.30,71.0
3878,tt0110675,No Contest,1995,250+,462,5,29,11,2.6,15.0,,3,1,2,3,,
3879,tt0100403,Predator 2,1990,"100,000+",139548,6428,8196,4808,3.1,44.0,,37,11,26,37,5.00,30.0
3880,tt1577883,The Turn of the Screw,2009,Fewer than 50,10,4,6,1,2.9,40.0,,1,0,1,1,,
3881,tt0081063,Little Miss Marker,1980,"1,000+",1313,42,39,17,3.3,52.0,,3,2,1,3,,
3882,tt0145893,Simply Irresistible,1999,"25,000+",45570,1291,1094,1073,3.3,54.0,,31,5,26,31,4.10,16.0
3883,tt0498329,We Live in Public,2009,"10,000+",13307,370,101,172,3.8,79.0,,51,42,9,51,7.20,82.0
3884,tt0252133,1st to Die,2003,"1,000+",1241,15,18,17,3.4,45.0,,2,1,1,2,,
3885,tt0067980,Who Is Harry Kellerman and Why Is He Saying Those Terrible Things About Me?,1971,250+,343,12,24,13,2.9,31.0,,5,2,3,5,6.30,40.0
3886,tt0101625,Once Upon a Crime...,1992,"1,000+",2028,93,124,61,3.1,43.0,,6,0,6,6,3.70,0.0
3887,tt2236636,Karmayogi,2012,0,0,0,0,0,,,,0,0,0,0,,
3888,tt0812243,Ex Drummer,2007,"1,000+",2391,452,188,191,3.6,71.0,,18,8,10,18,4.80,44.0
3889,tt0260303,Purani Haveli,1989,Fewer than 50,13,0,4,3,,,,0,0,0,0,,
3890,tt0106258,American Samurai,1992,"2,500+",3599,28,57,32,2.7,33.0,,1,0,1,1,,
3891,tt0192071,Get Over It,2001,"50,000+",51938,1296,1226,1164,3.3,51.0,,65,28,37,65,4.90,43.0
3892,tt0246981,Thillana Mohanambal,1968,0,0,0,0,0,,,,0,0,0,0,,
3893,tt0192071,Get Over It,2001,"50,000+",51938,1296,1226,1164,3.3,51.0,,65,28,37,65,4.90,43.0
3894,tt0830515,Quantum of Solace,2008,"250,000+",432648,37717,27645,32086,3.4,58.0,,301,191,110,301,6.10,63.0
3895,tt0830515,Quantum of Solace,2008,"250,000+",432648,37717,27645,32086,3.4,58.0,,301,191,110,301,6.10,63.0
3896,tt0485857,The Attic,2007,500+,798,31,214,123,1.9,13.0,,1,0,1,1,,
3897,tt0097531,How to Get Ahead in Advertising,1989,"2,500+",4953,538,158,270,3.9,77.0,,15,9,6,15,6.30,60.0
3898,tt0117109,The Munsters' Scary Little Christmas,1996,250+,461,23,49,19,2.7,32.0,,0,0,0,0,,
3899,tt0205000,Deuce Bigalow: Male Gigolo,1999,"250,000+",382398,3251,4465,5396,3,42.0,,76,17,59,76,4.10,22.0
3900,tt0189592,Hum Aapke Dil Mein Rehte Hain,1999,50+,56,5,16,0,2.7,24.0,,0,0,0,0,,
3901,tt0375210,White Noise,2005,"100,000+",188339,2143,4774,4420,2.7,31.0,,149,10,139,149,3.40,7.0
3902,tt0375210,White Noise,2005,"100,000+",188339,2143,4774,4420,2.7,31.0,,149,10,139,149,3.40,7.0
3903,tt0375210,White Noise,2005,"100,000+",188339,2143,4774,4420,2.7,31.0,,149,10,139,149,3.40,7.0
3904,tt0375210,White Noise,2005,"100,000+",188339,2143,4774,4420,2.7,31.0,,149,10,139,149,3.40,7.0
3905,tt0096344,The Unnamable,1988,"1,000+",1272,35,94,55,2.6,27.0,,2,0,2,2,,
3906,tt1877589,Christian Brothers,2011,Fewer than 50,30,2,6,1,2.3,25.0,,0,0,0,0,,
3907,tt0375210,White Noise,2005,"100,000+",188339,2143,4774,4420,2.7,31.0,,149,10,139,149,3.40,7.0
3908,tt0080117,The Wanderers,1979,"5,000+",7124,924,142,328,4.2,87.0,,19,17,2,19,6.80,89.0
3909,tt0110740,Open Fire,1994,Fewer than 50,36,0,2,0,,,,0,0,0,0,,
3910,tt0407658,The Chronicles of Riddick: Dark Fury,2004,"2,500+",2793,1506,1287,805,3.4,54.0,,4,0,4,4,,
3911,tt0407658,The Chronicles of Riddick: Dark Fury,2004,"2,500+",2793,1506,1287,805,3.4,54.0,,4,0,4,4,,
3912,tt8743136,Vattaram,2006,0,0,0,0,0,,,,0,0,0,0,,
3913,tt0264616,Frailty,2001,"50,000+",53449,5360,1469,2537,3.8,79.0,,155,116,39,155,6.90,75.0
3914,tt0066836,Black Noon,1971,Fewer than 50,1,0,1,1,,,,0,0,0,0,,
3915,tt0101264,Abraxas: Guardian of the Universe,1990,"1,000+",1641,23,89,67,2,21.0,,1,0,1,1,,
3916,tt0376136,The Rum Diary,2011,"25,000+",44201,4763,8364,2170,2.9,36.0,,169,87,82,169,5.60,51.0
3917,tt0097607,Jacknife,1989,"1,000+",2098,129,142,45,3.3,47.0,,14,9,5,14,5.90,64.0
3918,tt0246008,Kondaveeti Donga,1990,Fewer than 50,21,21,0,0,4.8,100.0,,0,0,0,0,,
3919,tt0378947,Melinda og Melinda,2004,"10,000+",17026,1404,1604,949,3.1,47.0,,157,80,77,157,5.70,51.0
3920,tt1981637,Holy Flying Circus,2011,50+,76,28,31,17,3.2,47.0,,0,0,0,0,,
3921,tt0116126,Don't Be a Menace to South Central While Drinking Your Juice in the Hood,1996,"50,000+",65939,5903,1459,2606,4.1,80.0,,28,9,19,28,4.70,32.0
3922,tt0414675,What's Bugging Seth,2005,50+,59,2,0,0,,,,0,0,0,0,,
3923,tt0480372,Derailed,2005,"100,000+",217062,5260,3787,5309,3.4,58.0,,125,26,99,125,4.70,21.0
3924,tt0083944,First Blood,1982,"100,000+",139669,15896,2700,5550,4.1,86.0,,50,43,7,50,7.30,86.0
3925,tt0480372,Derailed,2005,"100,000+",217062,5260,3787,5309,3.4,58.0,,125,26,99,125,4.70,21.0
3926,tt0090798,Caravaggio,1986,"2,500+",2878,280,131,119,3.6,68.0,,11,9,2,11,6.30,82.0
3927,tt0056860,Beach Party,1963,250+,458,49,67,44,3.3,42.0,,7,3,4,7,5.30,43.0
3928,tt1331335,Wyvern,2009,250+,300,21,93,49,2.4,18.0,,1,1,0,1,,
3929,tt0082850,One More Chance,1981,Fewer than 50,47,2,0,0,,,,0,0,0,0,,
3930,tt0929609,Donga Dongadi,2004,Fewer than 50,38,38,0,0,4.9,100.0,,0,0,0,0,,
3931,tt0067454,Multiple Maniacs,1970,"1,000+",1357,203,80,74,3.8,72.0,,23,23,0,23,7.20,100.0
3932,tt0075343,Track of the Moon Beast,1976,Fewer than 50,8,0,8,6,1.1,0.0,,1,0,1,1,,
3933,tt0086969,Birdy,1984,"5,000+",8314,1313,258,270,4,84.0,,30,24,6,30,7.30,80.0
3934,tt0499549,Avatar,2009,"250,000+",1387334,233655,50779,83471,4.1,82.0,,335,273,62,335,7.50,81.0
3935,tt0252480,The Grey Zone,2001,"5,000+",6777,557,193,260,3.7,74.0,,84,58,26,84,7.00,69.0
3936,tt0119062,The End of Violence,1997,"1,000+",2413,107,141,61,3,43.0,,35,10,25,35,5.00,29.0
3937,tt0844708,The Last House on the Left,2009,"250,000+",1003828,9027,8188,8675,3.3,52.0,,169,72,97,169,5.10,43.0
3938,tt0109822,For the Love of Nancy,1994,250+,424,50,25,21,3.7,66.0,,0,0,0,0,,
3939,tt1328913,Preacher's Kid,2010,"1,000+",1011,188,108,72,3.6,64.0,,7,4,3,7,6.60,57.0
3940,tt2125630,Swapna Sanchari,2011,100+,115,1,2,0,,,,0,0,0,0,,
3941,tt1186788,Baby on Board,2009,"5,000+",9892,106,457,180,2.3,19.0,,5,1,4,5,4.10,20.0
3942,tt0166008,Uphaar,1971,0,0,0,0,0,,,,0,0,0,0,,
3943,tt1031969,The Rocker,2008,"25,000+",44222,2862,3349,2432,3.2,46.0,,122,49,73,122,5.20,40.0
3944,tt0398027,Down in the Valley,2005,"25,000+",39365,1391,1219,1094,3.3,53.0,,101,53,48,101,6.00,52.0
3945,tt1119614,Flower in the Pocket,2007,100+,232,18,10,17,3.4,64.0,,0,0,0,0,,
3946,tt0066999,Dirty Harry,1971,"50,000+",77091,11618,1259,3812,4.2,90.0,,54,48,6,54,7.80,89.0
3947,tt0882742,Alice Upside Down,2007,"2,500+",3263,116,116,81,3.3,50.0,,0,0,0,0,,
3948,tt0188388,Les abysses,1963,Fewer than 50,16,2,0,1,,,,1,0,1,1,,
3949,tt1002963,Y.M.I. Yeh Mera India,2008,0,0,0,0,0,,,,1,1,0,1,,
3950,tt0109296,Blindfold: Acts of Obsession,1994,100+,234,8,13,6,3,38.0,,0,0,0,0,,
3951,tt0106799,Ek Hi Raasta,1993,0,0,0,0,0,,,,0,0,0,0,,
3952,tt0076138,Heroes,1977,500+,616,42,39,23,3.3,52.0,,15,4,11,15,3.60,27.0
3953,tt1345772,The Clinic,2010,Fewer than 50,1,1,0,0,,,,0,0,0,0,,
3954,tt1554091,A Better Life,2011,250+,253,57,59,18,3.2,49.0,,0,0,0,0,,
3955,tt1554091,A Better Life,2011,250+,253,57,59,18,3.2,49.0,,0,0,0,0,,
3956,tt1554091,A Better Life,2011,250+,253,57,59,18,3.2,49.0,,0,0,0,0,,
3957,tt1554091,A Better Life,2011,250+,253,57,59,18,3.2,49.0,,0,0,0,0,,
3958,tt0097457,Great Balls of Fire!,1989,"25,000+",26104,762,686,491,3.4,53.0,,27,17,10,27,5.90,63.0
3959,tt0446724,Kim Possible: So the Drama,2005,"5,000+",6956,338,124,166,3.9,73.0,,2,2,0,2,,
3960,tt1924394,The Angels' Share,2012,"5,000+",6943,1651,459,364,3.7,78.0,,103,92,11,103,7.20,89.0
3961,tt0190861,Vatel,2000,"2,500+",4410,337,218,133,3.5,61.0,,32,10,22,32,4.60,31.0
3962,tt0432188,Vishwa Thulasi,2004,50+,53,0,2,1,,,,0,0,0,0,,
3963,tt0361467,Confessions of a Teenage Drama Queen,2004,"250,000+",395627,2924,5482,6844,2.7,35.0,,94,13,81,94,3.90,14.0
3964,tt1719634,Snow on tha Bluff,2011,"1,000+",1299,415,110,78,4,79.0,,4,4,0,4,,
3965,tt0107899,Puppet Master 4,1993,"5,000+",5656,100,208,112,2.9,32.0,,4,0,4,4,,
3966,tt1860215,Dongala Mutha,2011,Fewer than 50,19,1,1,0,,,,0,0,0,0,,
3967,tt2963004,Giri,2004,50+,53,0,2,0,,,,0,0,0,0,,
3968,tt0472259,Alone with Her,2006,"100,000+",109071,500,594,346,3.1,46.0,,28,19,9,28,6.00,68.0
3969,tt1307858,All About Evil,2010,100+,231,60,27,33,,,,10,9,1,10,7.00,90.0
3970,tt0092831,Dark Tower,1987,100+,104,2,32,21,1.9,6.0,,0,0,0,0,,
3971,tt0482857,Broken Trail,2006,"2,500+",3195,436,66,184,4.1,87.0,,3,3,0,3,,
3972,tt0077539,Fedora,1978,500+,537,77,49,25,3.4,61.0,,17,12,5,17,7.00,71.0
3973,tt0066758,Amar Prem,1972,50+,82,17,4,5,4.2,81.0,,0,0,0,0,,
3974,tt0059170,"Faster, Pussycat! Kill! Kill!",1965,"5,000+",9417,1642,458,818,3.9,78.0,,30,22,8,30,6.80,73.0
3975,tt0054016,The Last Voyage,1960,100+,119,22,16,21,3.4,58.0,,5,3,2,5,6.40,60.0
3976,tt0066832,Billy Jack,1971,"5,000+",9224,466,273,324,3.6,63.0,,16,10,6,16,5.40,63.0
3977,tt0095238,The Good Mother,1988,500+,566,15,40,12,2.9,28.0,,13,7,6,13,5.40,54.0
3978,tt0487011,Anandabhadram,2005,0,0,0,0,0,,,,0,0,0,0,,
3979,tt2325785,Kalabha Kadhalan,2006,0,0,0,0,0,,,,0,0,0,0,,
3980,tt0096286,Too Young the Hero,1988,50+,93,13,11,3,3.6,54.0,,0,0,0,0,,
3981,tt0092723,The Care Bears Adventure in Wonderland,1987,Fewer than 50,6,2,4,2,2.2,33.0,,1,0,1,1,,
3982,tt0325849,Mr. St. Nick,2002,100+,100,12,25,8,2.9,32.0,,0,0,0,0,,
3983,tt1142585,Welcome Aboard Toxic Airlines,2007,0,0,0,0,0,,,,0,0,0,0,,
3984,tt1366409,Miral,2010,"5,000+",5420,252,216,131,3.4,54.0,,65,12,53,65,4.50,18.0
3985,tt0103893,Buffy the Vampire Slayer,1992,"250,000+",335194,3285,4354,8308,3.1,43.0,,53,19,34,53,4.40,36.0
3986,tt0230732,Sarapanjaram,1979,0,0,0,0,0,,,,0,0,0,0,,
3987,tt0078341,Summer of My German Soldier,1978,100+,198,9,1,9,4.3,90.0,,0,0,0,0,,
3988,tt1038072,Pulse 2: Afterlife,2008,"1,000+",1521,29,274,171,1.8,10.0,,4,1,3,4,,
3989,tt0119484,Kull the Conqueror,1997,"5,000+",9581,141,436,230,2.5,24.0,,20,5,15,20,4.00,25.0
3990,tt0457706,Super Spy,2004,Fewer than 50,19,1,0,1,,,,0,0,0,0,,
3991,tt0061439,Camelot,1967,"5,000+",8387,471,218,290,3.8,68.0,,17,7,10,17,6.20,41.0
3992,tt0071518,Frankenstein '80,1972,50+,74,2,11,4,2.3,15.0,,1,0,1,1,,
3993,tt13919770,Kadhaludan,2003,0,0,0,0,0,,,,0,0,0,0,,
3994,tt1183252,Chocolate,2008,"10,000+",12267,1559,586,1077,3.7,73.0,,38,27,11,38,6.10,71.0
3995,tt1183252,Chocolate,2008,"10,000+",12267,1559,586,1077,3.7,73.0,,38,27,11,38,6.10,71.0
3996,tt0834541,Sherman's Way,2008,"1,000+",2009,13,47,23,2.6,22.0,,18,6,12,18,4.40,33.0
3997,tt0091767,Playing for Keeps,1986,"1,000+",1004,27,20,23,3.4,57.0,,0,0,0,0,,
3998,tt0108147,Sister Act 2: Back in the Habit,1993,"250,000+",395330,4328,2777,7011,3.5,61.0,,38,7,31,38,3.60,18.0
3999,tt0762107,I Now Pronounce You Chuck & Larry,2007,"250,000+",1307773,75417,34296,44757,3.7,69.0,,166,24,142,166,3.80,14.0
4000,tt2064849,London Paris New York,2012,100+,246,59,67,31,3,47.0,,9,5,4,9,6.30,56.0
4001,tt0424863,The Book of Revelation,2006,"1,000+",1350,78,109,84,2.9,42.0,,13,9,4,13,6.70,69.0
4002,tt0086947,Bedroom Eyes,1984,100+,109,2,10,6,2.4,17.0,,1,0,1,1,,
4003,tt0110361,Lisbon Story,1994,"1,000+",2287,387,61,98,4.1,86.0,,3,2,1,3,,
4004,tt0061094,Thunderbirds Are GO,1966,500+,947,119,89,78,3.5,57.0,,7,4,3,7,4.50,57.0
4005,tt0839930,The Nutty Professor,2008,"1,000+",2038,15,27,13,2.8,36.0,,1,0,1,1,,
4006,tt1156067,The Lightkeepers,2009,100+,204,27,32,14,3,46.0,,5,1,4,5,3.80,20.0
4007,tt0063694,Thunderbird 6,1968,"1,000+",1786,38,46,35,3.3,45.0,,3,1,2,3,,
4008,tt0247924,Anaganaga Oka Roju,1997,50+,58,1,2,0,,,,0,0,0,0,,
4009,tt0104053,Trauma,1993,"2,500+",4041,196,275,155,3.1,41.0,,6,3,3,6,5.70,50.0
4010,tt1770650,BKO: Bangkok Knockout,2010,250+,373,40,67,49,3,37.0,,1,1,0,1,,
4011,tt0131978,Blood Orgy of the Leather Girls,1988,Fewer than 50,1,1,0,0,,,,0,0,0,0,,
4012,tt0834902,Confession of Pain,2006,"5,000+",5241,539,336,255,3.5,62.0,,3,0,3,3,,
4013,tt0101864,The Gods Must Be Crazy,1991,"10,000+",12119,844,366,379,3.7,70.0,,14,7,7,14,5.80,50.0
4014,tt0287637,Praja,2001,0,0,0,0,0,,,,0,0,0,0,,
4015,tt0113241,Habit,1995,"1,000+",1535,73,44,54,3.6,62.0,,20,15,5,20,6.60,75.0
4016,tt0385940,The Perfect Husband: The Laci Peterson Story,2004,"1,000+",1186,39,66,35,3,37.0,,1,0,1,1,,
4017,tt1833845,Eating Out: Drama Camp,2011,250+,284,45,95,25,2.9,32.0,,2,2,0,2,,
4018,tt0089591,Miami Supercops,1985,500+,688,107,81,16,3.4,57.0,,0,0,0,0,,
4019,tt0804505,Married Life,2007,"5,000+",5087,564,1012,728,3,36.0,,116,63,53,116,5.80,54.0
4020,tt0110449,Mammo,1994,250+,321,23,1,7,4.4,96.0,,1,1,0,1,,
4021,tt0300532,Blue Crush,2002,"250,000+",371427,3994,2853,5722,3.5,58.0,,145,89,56,145,5.80,61.0
4022,tt0168473,Babes in Toyland,1997,50+,81,16,22,10,3.1,42.0,,3,1,2,3,,
4023,tt0115019,Yeh Majhdhaar,1996,0,0,0,0,0,,,,0,0,0,0,,
4024,tt0271027,Kiss of the Dragon,2001,"50,000+",66339,3539,1665,1776,3.7,68.0,,109,57,52,109,5.30,52.0
4025,tt2292625,Chakravyuh,2012,"1,000+",1331,48,58,22,3.1,45.0,,5,2,3,5,4.50,40.0
4026,tt0071866,Mr. Majestyk,1974,"2,500+",3603,263,129,148,3.6,67.0,,17,14,3,17,6.20,82.0
4027,tt0083336,Wolfen,1981,"5,000+",5375,312,354,219,3.2,47.0,,26,20,6,26,6.30,77.0
4028,tt0067732,The Cannibal Man,1972,Fewer than 50,44,17,27,20,3,39.0,,2,1,1,2,,
4029,tt1320291,The Reef,2010,"1,000+",2422,582,836,443,3,41.0,,20,16,4,20,6.20,80.0
4030,tt0156606,Himalay Ki Godmein,1965,0,0,0,0,0,,,,0,0,0,0,,
4031,tt0081625,"Those Lips, Those Eyes",1980,Fewer than 50,9,2,3,2,3.3,40.0,,1,0,1,1,,
4032,tt0112459,Barsaat,1995,50+,96,3,6,1,3.1,33.0,,0,0,0,0,,
4033,tt0165125,Budo,1979,Fewer than 50,3,0,1,0,,,,0,0,0,0,,
4034,tt0219813,Horse Sense,1999,500+,552,70,51,23,3.6,58.0,,3,3,0,3,,
4035,tt0078025,"Olly, Olly, Oxen Free",1978,50+,79,1,4,1,2.5,20.0,,0,0,0,0,,
4036,tt1911606,Nenu Naa Rakshasi,2011,Fewer than 50,13,1,4,0,2.4,20.0,,0,0,0,0,,
4037,tt0077309,Ceddo,1977,100+,192,15,10,5,3.2,60.0,,7,5,2,7,6.00,71.0
4038,tt0339422,Murder in Greenwich,2002,500+,785,57,53,33,3.4,52.0,,4,0,4,4,,
4039,tt2317337,Vicky Donor,2012,500+,807,443,134,139,3.8,77.0,,3,2,1,3,,
4040,tt0138376,Common Bonds,1997,0,0,0,0,0,,,,0,0,0,0,,
4041,tt0112499,The Big Green,1995,"25,000+",36260,619,734,534,3.2,46.0,,5,0,5,5,3.60,0.0
4042,tt0360032,Strange Bedfellows,2004,"1,000+",1655,101,73,79,3.3,58.0,,5,4,1,5,6.70,80.0
4043,tt0099236,Chaindance,1991,250+,262,11,4,7,3.7,73.0,,0,0,0,0,,
4044,tt0790746,Savage Planet,2007,100+,209,4,25,24,1.5,14.0,,0,0,0,0,,
4045,tt0472156,The Half Life of Timofey Berezin,2006,"1,000+",1314,214,110,126,3.5,66.0,,6,4,2,6,6.30,67.0
4046,tt0188766,King of Comedy,1999,"5,000+",6857,609,264,177,3.7,70.0,,0,0,0,0,,
4047,tt0086182,Rembetiko,1983,100+,245,49,6,6,4.3,89.0,,2,2,0,2,,
4048,tt4161520,Dashavatar,2008,0,0,0,0,0,,,,0,0,0,0,,
4049,tt0388980,The Greatest Game Ever Played,2005,"50,000+",62619,3361,730,1696,4,82.0,,112,70,42,112,6.20,63.0
4050,tt0478087,21,2008,"250,000+",368042,40342,21249,20810,3.6,66.0,,171,61,110,171,5.20,36.0
4051,tt0421270,All Aboard! Rosie's Family Cruise,2006,500+,507,29,5,17,4.1,85.0,,5,2,3,5,5.00,40.0
4052,tt0477079,Romancing the Bride,2005,500+,517,51,25,34,3.8,67.0,,0,0,0,0,,
4053,tt1995389,Oridathoru Postman,2010,0,0,0,0,0,,,,0,0,0,0,,
4054,tt0451142,Aunt Rose,2005,50+,94,2,12,2,2.3,14.0,,0,0,0,0,,
4055,tt0901494,Life Is Hot in Cracktown,2009,"1,000+",2149,123,105,88,3.3,54.0,,6,3,3,6,5.10,50.0
4056,tt0053980,Kala Bazar,1960,0,0,0,0,0,,,,0,0,0,0,,
4057,tt0391891,Cruel Intentions 3,2004,"10,000+",18519,342,769,409,2.7,31.0,,2,1,1,2,,
4058,tt0099574,Fine Things,1990,50+,94,6,7,5,3.4,46.0,,0,0,0,0,,
4059,tt0089461,The Last Dragon,1985,"10,000+",20213,2846,481,1523,4.3,86.0,,23,14,9,23,5.50,61.0
4060,tt0429591,Aquamarine,2006,"250,000+",296750,6584,4107,6844,3.6,62.0,,87,45,42,87,5.50,52.0
4061,tt0100943,Witchcraft II: The Temptress,1989,100+,113,1,18,12,2.1,5.0,,1,0,1,1,,
4062,tt0087385,Hardbodies,1984,"1,000+",1610,50,105,50,2.8,32.0,,2,0,2,2,,
4063,tt1369842,Transformers: Revenge of the Fallen,2009,"250,000+",4081606,92741,68939,136859,3.5,57.0,,250,49,201,250,4.10,20.0
4064,tt0286520,"Bougainville: Our Island, Our Fight",1998,0,0,0,0,0,,,,0,0,0,0,,
4065,tt1411232,13 Hrs,2010,250+,253,19,117,54,2.1,14.0,,1,1,0,1,,
4066,tt0326965,In My Sleep,2010,250+,464,60,122,62,2.7,33.0,,16,2,14,16,3.80,13.0
4067,tt0758922,Murder Unveiled,2005,50+,53,6,1,3,4.1,86.0,,0,0,0,0,,
4068,tt0104759,The Lost World,1992,100+,175,4,22,6,2.4,15.0,,1,0,1,1,,
4069,tt0069948,The Day of the Wolves,1971,50+,70,6,2,3,3.7,75.0,,0,0,0,0,,
4070,tt0099691,Graffiti Bridge,1990,"2,500+",4511,123,192,146,2.9,39.0,,28,5,23,28,3.70,18.0
4071,tt1470023,MacGruber,2010,"100,000+",120273,3321,6096,2804,2.8,35.0,,153,72,81,153,5.20,47.0
4072,tt0062453,Viy,1967,"1,000+",1044,144,39,51,3.8,79.0,,8,7,1,8,6.30,88.0
4073,tt0383551,Palestine Is Still the Issue,2002,250+,381,22,3,11,4.2,88.0,,0,0,0,0,,
4074,tt0087492,Jaag Utha Insan,1984,Fewer than 50,1,1,0,1,,,,0,0,0,0,,
4075,tt0093227,Howling III,1987,"5,000+",5872,51,291,148,2,15.0,,13,3,10,13,3.90,23.0
4076,tt0172163,Bambai Ka Babu,1996,0,0,0,0,0,,,,0,0,0,0,,
4077,tt0478737,Treasure Raiders,2007,500+,553,4,78,44,1.5,5.0,,0,0,0,0,,
4078,tt0059445,Mere Sanam,1965,Fewer than 50,17,2,0,1,,,,0,0,0,0,,
4079,tt0382628,Dark Water,2005,"100,000+",154899,1421,3662,3112,2.7,28.0,,152,71,81,152,5.60,47.0
4080,tt0958824,The Apocalypse,2007,100+,173,6,21,9,1.8,22.0,,0,0,0,0,,
4081,tt0110353,Lightning Jack,1994,"10,000+",12207,182,212,145,3.1,46.0,,17,1,16,17,3.30,6.0
4082,tt0382628,Dark Water,2005,"100,000+",154899,1421,3662,3112,2.7,28.0,,152,71,81,152,5.60,47.0
4083,tt0107009,Ghost in the Machine,1993,"5,000+",9336,47,156,95,2.4,23.0,,10,1,9,10,3.40,10.0
4084,tt0079944,Stalker,1979,"25,000+",25561,6394,531,1579,4.5,92.0,,43,43,0,43,8.50,100.0
4085,tt0089892,Red Heat,1985,"25,000+",37149,1058,1770,686,3,37.0,,26,18,8,26,5.60,69.0
4086,tt1234250,Mehbooba,2008,100+,191,3,16,9,2,16.0,,1,0,1,1,,
4087,tt0102846,Saugandh,1991,0,0,0,0,0,,,,0,0,0,0,,
4088,tt0079339,The Incredible Journey of Doctor Meg Laurel,1979,Fewer than 50,24,5,1,0,4.7,83.0,,0,0,0,0,,
4089,tt0072906,The Dream Makers,1975,0,0,0,0,0,,,,0,0,0,0,,
4090,tt0150359,Dog Years,1997,Fewer than 50,25,1,2,2,,,,1,0,1,1,,
4091,tt0196857,Play It to the Bone,1999,"10,000+",10383,173,505,150,2.7,26.0,,79,9,70,79,4.00,11.0
4092,tt0105592,Tiger Claws,1991,500+,540,13,20,10,2.9,39.0,,0,0,0,0,,
4093,tt0088805,The Big Snit,1985,50+,88,13,5,5,3.7,72.0,,0,0,0,0,,
4094,tt1090750,Dadnapped,2009,"10,000+",18263,255,314,189,3.2,45.0,,2,1,1,2,,
4095,tt1335975,47 Ronin,2013,"50,000+",62325,10145,11033,2694,3.2,48.0,,90,14,76,90,4.20,16.0
4096,tt0279977,The Navigators,2001,500+,992,126,27,31,3.9,83.0,,9,8,1,9,7.00,89.0
4097,tt0984210,Multiple Sarcasms,2010,"1,000+",1212,20,62,25,2.5,24.0,,22,2,20,22,4.00,9.0
4098,tt1526300,Merry Madagascar,2009,"1,000+",1138,241,186,83,3.4,56.0,,1,1,0,1,,
4099,tt0470993,Crazy Eights,2006,"2,500+",2514,92,477,301,2.2,16.0,,3,0,3,3,,
4100,tt0057877,Becket,1964,"5,000+",5634,933,138,392,4.1,87.0,,28,21,7,28,7.20,75.0
4101,tt0092273,The Seventh Curse,1986,100+,213,15,12,9,3.2,56.0,,0,0,0,0,,
4102,tt1314843,Shake Rattle & Roll X,2008,0,0,0,0,0,,,,0,0,0,0,,
4103,tt3456970,Malaikottai,2007,0,0,0,0,0,,,,0,0,0,0,,
4104,tt0084777,Tenebre,1982,"5,000+",9262,1260,351,537,3.8,78.0,,27,22,5,27,6.70,81.0
4105,tt0422774,Are We Done Yet?,2007,50+,74,22,49,18,2.6,31.0,,91,6,85,91,3.30,7.0
4106,tt0302585,Fubar,2002,"5,000+",7198,1059,163,517,4.2,87.0,,11,6,5,11,6.00,55.0
4107,tt0485774,Heartstopper,2006,"2,500+",4838,30,111,84,2.4,21.0,,1,0,1,1,,
4108,tt0064645,Mayerling,1968,100+,165,11,18,4,3,38.0,,4,1,3,4,,
4109,tt0075930,God Told Me To,1976,"1,000+",2011,154,144,111,3.2,52.0,,14,11,3,14,6.60,79.0
4110,tt0107468,M. Butterfly,1993,"5,000+",5345,522,257,211,3.6,67.0,,22,9,13,22,5.60,41.0
4111,tt0765465,The Legend of Secret Pass,2010,250+,310,9,22,7,2.8,29.0,,0,0,0,0,,
4112,tt1373215,Recep Ivedik 2,2009,Fewer than 50,3,2,1,1,,,,0,0,0,0,,
4113,tt0999913,Straw Dogs,2011,"10,000+",18956,2188,4290,1369,2.8,34.0,,128,54,74,128,5.10,42.0
4114,tt0164393,Berserker,1987,50+,69,2,15,9,2,12.0,,1,0,1,1,,
4115,tt0113410,In the Name of Love: A Texas Tragedy,1995,100+,142,8,1,1,3.4,89.0,,0,0,0,0,,
4116,tt1033467,American Drug War: The Last White Hope,2006,500+,674,195,32,99,4.2,86.0,,0,0,0,0,,
4117,tt0385543,Bell Witch: The Movie,2007,100+,192,4,2,3,3.9,67.0,,0,0,0,0,,
4118,tt0120086,The Second Civil War,1997,500+,539,48,31,25,3.6,61.0,,6,4,2,6,6.30,67.0
4119,tt0061072,Teesri Kasam,1966,0,0,0,0,0,,,,0,0,0,0,,
4120,tt0377808,Dragon Storm,2004,"1,000+",1874,17,29,29,2.7,37.0,,0,0,0,0,,
4121,tt0081760,Windwalker,1980,"1,000+",1764,74,12,49,4.3,86.0,,2,1,1,2,,
4122,tt0295369,Killjoy 2: Deliverance from Evil,2002,500+,937,16,53,34,2.3,23.0,,1,0,1,1,,
4123,tt0116136,DragonHeart,1996,"250,000+",326747,4206,2767,5673,3.5,60.0,,30,15,15,30,5.70,50.0
4124,tt0475984,Mister Lonely,2007,"2,500+",4305,693,535,520,3.4,57.0,,73,34,39,73,5.30,47.0
4125,tt0381838,...ing,2003,"1,000+",1353,227,36,76,4.1,86.0,,0,0,0,0,,
4126,tt1037222,Robosapien: Rebooted,2013,100+,175,29,40,10,3,42.0,,4,0,4,4,,
4127,tt0248042,Gokulamlo Seetha,1997,0,0,0,0,0,,,,0,0,0,0,,
4128,tt0303780,Blues Harp,1998,0,0,0,0,0,,,,0,0,0,0,,
4129,tt0113309,Hiroshima,1995,100+,216,25,5,11,4,83.0,,1,1,0,1,,
4130,tt0119002,Doing Time for Patsy Cline,1997,50+,84,3,4,2,3.3,43.0,,9,7,2,9,6.10,78.0
4131,tt0342853,Ogú y Mampato en Rapa Nui,2002,Fewer than 50,45,3,1,1,,,,0,0,0,0,,
4132,tt0053767,Dil Apna Aur Preet Parai,1960,50+,55,2,1,0,,,,0,0,0,0,,
4133,tt0795371,Dirty Laundry,2006,500+,711,82,38,52,3.7,68.0,,12,6,6,12,4.80,50.0
4134,tt2076837,Dollar Dreams,2000,0,0,0,0,0,,,,0,0,0,0,,
4135,tt0192803,Willy McBean and His Magic Machine,1965,Fewer than 50,14,3,2,2,3.2,60.0,,0,0,0,0,,
4136,tt0211317,Colorz of Rage,1999,Fewer than 50,7,0,2,0,,,,1,0,1,1,,
4137,tt0077406,Deadman's Curve,1978,Fewer than 50,19,2,0,1,,,,0,0,0,0,,
4138,tt1483831,Lebanon,2009,"5,000+",5602,860,333,378,3.6,72.0,,111,100,11,111,7.80,90.0
4139,tt0485601,The Secret of Kells,2009,"10,000+",11626,3491,625,1055,4,85.0,,84,76,8,84,7.60,90.0
4140,tt1464540,I Am Number Four,2011,"100,000+",145730,52907,39225,6967,3.5,57.0,,169,55,114,169,4.70,33.0
4141,tt0100519,Rosencrantz & Guildenstern Are Dead,1990,"10,000+",17246,2547,370,1006,4.2,87.0,,31,19,12,31,6.40,61.0
4142,tt0112515,Black Day Blue Night,1995,50+,70,0,4,2,,,,0,0,0,0,,
4143,tt1189267,Woodshop,2010,Fewer than 50,32,2,5,3,3.1,29.0,,0,0,0,0,,
4144,tt0213446,The Amati Girls,2000,500+,635,14,8,14,3.7,64.0,,13,6,7,13,4.40,46.0
4145,tt0078024,Oliver's Story,1978,500+,760,8,25,9,2.7,24.0,,7,2,5,7,4.10,29.0
4146,tt0261075,Mooga Manasulu,1964,0,0,0,0,0,,,,0,0,0,0,,
4147,tt0119095,FairyTale: A True Story,1997,"10,000+",10571,384,193,264,3.6,66.0,,32,18,14,32,6.10,56.0
4148,tt0377091,Mean Creek,2004,"25,000+",32864,3459,782,1648,3.9,82.0,,124,110,14,124,7.30,89.0
4149,tt0054102,"Murder, Inc.",1960,250+,469,21,23,13,3.2,48.0,,4,2,2,4,,
4150,tt0342508,Hangman's Curse,2003,"5,000+",8573,596,200,541,3.9,75.0,,6,0,6,6,3.50,0.0
4151,tt0236348,Josie and the Pussycats,2001,"50,000+",71604,1738,1582,2040,3.3,52.0,,125,66,59,125,5.20,53.0
4152,tt0107505,Mandroid,1993,50+,59,1,10,8,2.3,9.0,,1,0,1,1,,
4153,tt0074430,"Dr. Black, Mr. Hyde",1976,500+,602,4,26,17,2.5,13.0,,2,1,1,2,,
4154,tt0924249,Maharadhi,2007,50+,98,10,15,9,3.2,40.0,,2,0,2,2,,
4155,tt0057569,The Terror,1963,"2,500+",3643,105,366,211,2.5,22.0,,11,4,7,11,5.00,36.0
4156,tt0124102,Strangeland,1998,"10,000+",10894,808,465,647,3.6,64.0,,16,1,15,16,2.70,6.0
4157,tt0118688,Batman & Robin,1997,"250,000+",555059,5043,26193,20575,1.9,16.0,,96,11,85,96,3.80,11.0
4158,tt0317962,One-Man Show,2001,0,0,0,0,0,,,,0,0,0,0,,
4159,tt0060099,An American Dream,1966,50+,70,1,12,9,2.4,8.0,,2,0,2,2,,
4160,tt0163676,The In Crowd,2000,"5,000+",6612,177,289,190,2.8,38.0,,61,1,60,61,2.90,2.0
4161,tt1182887,Flirting with Forty,2008,500+,617,134,125,86,3.3,52.0,,1,1,0,1,,
4162,tt0313532,Ride or Die,2003,250+,369,24,20,8,3.5,56.0,,0,0,0,0,,
4163,tt0082782,My Bloody Valentine,1981,"5,000+",9454,885,817,752,3.3,52.0,,26,15,11,26,5.70,58.0
4164,tt1029234,Martyrs,2008,"10,000+",12564,3881,1744,2219,3.6,69.0,,40,26,14,40,6.10,65.0
4165,tt1397502,Grown Up Movie Star,2009,100+,124,26,9,16,3.7,74.0,,5,4,1,5,6.40,80.0
4166,tt1127896,Taking Woodstock,2009,"250,000+",252419,2714,3026,2021,3.2,47.0,,183,88,95,183,5.40,48.0
4167,tt1582478,Bindaas,2010,100+,108,97,3,0,4.8,97.0,,0,0,0,0,,
4168,tt0103621,Adventures in Dinosaur City,1991,100+,209,21,30,20,3,41.0,,0,0,0,0,,
4169,tt1582478,Bindaas,2010,100+,108,97,3,0,4.8,97.0,,0,0,0,0,,
4170,tt0059453,Mister Buddwing,1966,100+,192,19,17,17,3.2,53.0,,1,0,1,1,,
4171,tt0329575,Seabiscuit,2003,"100,000+",118520,5952,1912,2838,3.8,76.0,,208,162,46,208,7.10,78.0
4172,tt0386504,Haven,2004,"10,000+",21519,902,613,679,3.5,60.0,,62,9,53,62,4.00,15.0
4173,tt0346091,Unprecedented: The 2000 Presidential Election,2002,250+,421,36,8,15,4,82.0,,9,9,0,9,7.80,100.0
4174,tt1067769,Christmas Caper,2006,250+,422,44,39,28,3.4,53.0,,1,1,0,1,,
4175,tt1628055,Touchback,2011,"5,000+",5350,338,199,104,3.6,63.0,,13,5,8,13,5.80,38.0
4176,tt0115683,Bio-Dome,1996,"50,000+",98453,2265,2203,2351,3.1,51.0,,26,1,25,26,2.70,4.0
4177,tt0101996,Hammers Over the Anvil,1993,500+,641,7,12,5,3,37.0,,1,0,1,1,,
4178,tt0057517,Soldier in the Rain,1963,250+,486,49,25,27,3.6,66.0,,2,1,1,2,,
4179,tt0234054,Kranti,1981,Fewer than 50,42,5,1,2,4.3,83.0,,0,0,0,0,,
4180,tt0181305,Banzai Runner,1987,50+,80,3,3,2,3.2,50.0,,1,0,1,1,,
4181,tt1714210,Weekend,2011,0,0,0,0,0,,,,0,0,0,0,,
4182,tt0058007,Devil Doll,1964,500+,545,32,80,35,2.6,29.0,,6,2,4,6,5.20,33.0
4183,tt0270053,Vizontele,2001,"1,000+",2472,365,50,24,4.2,88.0,,0,0,0,0,,
4184,tt0362230,Terror Toons 2,2007,0,0,0,0,0,,,,0,0,0,0,,
4185,tt0331497,"Gacaca, Living Together Again in Rwanda?",2002,0,0,0,0,0,,,,1,1,0,1,,
4186,tt0086022,Nostalghia,1983,"5,000+",6143,1180,127,239,4.3,90.0,,23,20,3,23,8.30,87.0
4187,tt0090882,Crazy Moon,1987,"1,000+",1458,34,22,22,3.6,61.0,,0,0,0,0,,
4188,tt0443604,"Paradise, Texas",2006,250+,325,2,2,1,,,,4,3,1,4,,
4189,tt0356152,Ullasappoonkattu,1997,0,0,0,0,0,,,,0,0,0,0,,
4190,tt0175526,Cherry Falls,1999,"10,000+",11203,435,664,402,3,40.0,,19,12,7,19,6.00,63.0
4191,tt0195778,Here on Earth,2000,"10,000+",20272,948,625,635,3.5,60.0,,69,12,57,69,3.90,17.0
4192,tt0339034,From Justin to Kelly,2003,"50,000+",52915,708,1098,1387,2.6,39.0,,63,5,58,63,3.10,8.0
4193,tt0492754,Salvage,2006,250+,463,46,182,75,2.6,20.0,,7,6,1,7,6.10,86.0
4194,tt0262890,Wafadaar,1985,0,0,0,0,0,,,,0,0,0,0,,
4195,tt0178207,Aashiq Hoon Baharon Ka,1977,100+,174,2,0,2,,,,0,0,0,0,,
4196,tt0093608,Nekromantik,1988,"2,500+",3759,304,327,249,3.1,48.0,,6,3,3,6,7.00,50.0
4197,tt0452703,Walkout,2006,"1,000+",1085,178,43,92,4.1,81.0,,1,1,0,1,,
4198,tt0109936,Greedy,1994,"5,000+",7857,363,397,201,3.2,48.0,,19,6,13,19,4.70,32.0
4199,tt0098023,Ollie Hopnoodle's Haven of Bliss,1988,500+,899,49,4,30,4.3,92.0,,1,0,1,1,,
4200,tt0066848,Blood and Lace,1971,100+,162,9,31,22,2.5,22.0,,4,1,3,4,,
4201,tt1705772,Mankatha,2011,100+,234,126,35,29,4,78.0,,0,0,0,0,,
4202,tt0054642,Atlantis: The Lost Continent,1961,100+,155,12,38,22,2.6,24.0,,4,0,4,4,,
4203,tt0106233,Airborne,1993,"5,000+",8563,553,373,378,3.5,60.0,,16,5,11,16,3.50,31.0
4204,tt0261545,Astitva,2000,250+,269,22,5,4,4,81.0,,0,0,0,0,,
4205,tt1760998,Somebody Help Me 2,2010,250+,253,25,35,5,3.1,42.0,,0,0,0,0,,
4206,tt0056119,La jetée,1962,"5,000+",9255,2499,191,739,4.4,93.0,,28,26,2,28,8.60,93.0
4207,tt0261203,Prince Charming,2001,"1,000+",1857,89,102,61,3.1,46.0,,2,2,0,2,,
4208,tt0194422,Seventeen Again,2000,"5,000+",9531,302,149,148,3.8,67.0,,1,0,1,1,,
4209,tt0377575,C.I.D. Moosa,2003,0,0,0,0,0,,,,0,0,0,0,,
4210,tt0070814,Tom Sawyer,1973,"2,500+",3629,71,60,48,3.4,54.0,,3,3,0,3,,
4211,tt1204882,The Black Candle,2008,Fewer than 50,8,1,0,1,,,,0,0,0,0,,
4212,tt0364955,Art School Confidential,2006,"25,000+",44511,1969,2155,1887,3.2,48.0,,135,48,87,135,5.40,36.0
4213,tt0059311,Incubus,1966,"1,000+",1564,87,83,102,3.3,51.0,,8,5,3,8,6.40,63.0
4214,tt0106387,Benny & Joon,1993,"100,000+",143577,14088,2490,6334,4.1,85.0,,41,31,10,41,5.80,76.0
4215,tt1429432,Rio Sex Comedy,2010,100+,188,13,33,14,2.5,28.0,,1,0,1,1,,
4216,tt0061170,Walk Don't Run,1966,"2,500+",3354,203,86,101,3.7,70.0,,6,5,1,6,7.00,83.0
4217,tt0110044,Holy Matrimony,1994,250+,469,18,56,16,2.6,24.0,,5,0,5,5,3.30,0.0
4218,tt0307078,L.A. Law: The Movie,2002,Fewer than 50,27,1,1,0,,,,1,1,0,1,,
4219,tt0087071,The Cold Room,1984,100+,116,2,8,4,2.6,20.0,,0,0,0,0,,
4220,tt0456020,Waist Deep,2006,"50,000+",94179,3535,1130,1680,3.9,76.0,,75,21,54,75,4.50,28.0
4221,tt0130350,Vishwatma,1992,50+,50,5,3,1,3.8,62.0,,0,0,0,0,,
4222,tt1135084,Takers,2010,"100,000+",125592,32360,20084,3443,3.6,62.0,,117,33,84,117,4.50,28.0
4223,tt0093278,Ishtar,1987,"5,000+",5043,266,413,299,2.7,39.0,,58,23,35,58,4.50,40.0
4224,tt0130797,Jaali Note,1960,Fewer than 50,42,1,0,0,,,,0,0,0,0,,
4225,tt0065896,The Intruders,1970,0,0,0,0,0,,,,0,0,0,0,,
4226,tt1231287,Labor Pains,2009,"5,000+",5283,424,972,392,2.7,30.0,,5,0,5,5,2.60,0.0
4227,tt0303297,Amandla! A Revolution in Four Part Harmony,2002,500+,968,114,15,47,4.2,88.0,,64,53,11,64,7.20,83.0
4228,tt0316272,Momentum,2003,"1,000+",1268,37,26,22,3.5,59.0,,1,0,1,1,,
4229,tt0061418,Bonnie & Clyde,1967,"50,000+",56723,7501,1052,2374,4.1,88.0,,68,61,7,68,8.30,90.0
4230,tt0089160,Fool for Love,1985,"1,000+",1310,51,63,28,3.2,45.0,,14,11,3,14,6.00,79.0
4231,tt0384533,She Hate Me,2004,"5,000+",7963,651,443,421,3.4,59.0,,103,20,83,103,4.10,19.0
4232,tt0054331,Spartacus,1960,"50,000+",78274,8213,1207,2375,4.1,87.0,,63,59,4,63,8.20,94.0
4233,tt0101902,For the Boys,1991,"5,000+",7536,312,106,175,3.9,75.0,,16,7,9,16,5.00,44.0
4234,tt0109450,Cobb,1994,"5,000+",6246,329,237,165,3.5,58.0,,48,31,17,48,6.40,65.0
4235,tt0218864,Buying the Cow,2002,"5,000+",7759,412,351,246,3.3,54.0,,3,1,2,3,,
4236,tt0119158,Friends 'Til the End,1997,100+,222,18,7,5,3.9,72.0,,0,0,0,0,,
4237,tt1413527,Evil Things,2009,100+,237,27,122,58,1.9,18.0,,0,0,0,0,,
4238,tt0310254,Tumko Na Bhool Paayenge,2002,500+,773,34,32,17,3.2,52.0,,0,0,0,0,,
4239,tt0085640,Hammett,1982,"1,000+",1119,94,57,43,3.5,62.0,,13,10,3,13,6.20,77.0
4240,tt0237772,Sriman Prithviraj,1973,0,0,0,0,0,,,,0,0,0,0,,
4241,tt0248441,Sitaara,1983,0,0,0,0,0,,,,0,0,0,0,,
4242,tt0108052,Schindlers liste,1993,"250,000+",413183,82246,2643,22968,4.6,97.0,,134,131,3,134,9.20,98.0
4243,tt0888503,Imsai Arasan 23rd Pulikecei,2006,Fewer than 50,1,1,0,0,,,,0,0,0,0,,
4244,tt0413466,Wassup Rockers,2005,"5,000+",8686,604,343,313,3.5,64.0,,52,19,33,52,5.30,37.0
4245,tt0466831,Hidden Places,2006,250+,302,17,13,16,3.5,57.0,,0,0,0,0,,
4246,tt0219952,Lucky Numbers,2000,"5,000+",9785,119,520,140,2.4,19.0,,97,22,75,97,4.10,23.0
4247,tt0229949,Aankhon Aankhon Mein,1972,Fewer than 50,23,1,0,0,,,,0,0,0,0,,
4248,tt1350512,The Terminators,2009,250+,427,7,90,46,1.3,7.0,,1,1,0,1,,
4249,tt0110066,Houseguest,1995,"10,000+",11153,442,361,311,3.4,55.0,,23,4,19,23,3.80,17.0
4250,tt1133995,The Way of War,2009,"1,000+",1272,21,480,127,1.1,4.0,,0,0,0,0,,
4251,tt0246304,Usha Parinayam,1961,0,0,0,0,0,,,,0,0,0,0,,
4252,tt0437857,Behind the mask,2006,Fewer than 50,24,3,5,2,2.9,38.0,,1,1,0,1,,
4253,tt0066262,Puzzle of a Downfall Child,1970,100+,120,17,12,7,3.4,61.0,,3,1,2,3,,
4254,tt1595842,Fred: The Movie,2010,"2,500+",4473,451,691,450,2.5,39.0,,13,0,13,13,2.50,0.0
4255,tt0499041,Kalyug,2005,500+,980,68,31,37,3.8,69.0,,0,0,0,0,,
4256,tt1671582,Occupant,2011,500+,531,39,115,47,2.3,25.0,,0,0,0,0,,
4257,tt0119901,Place Vendôme,1998,500+,932,58,43,22,3.4,57.0,,20,17,3,20,6.60,85.0
4258,tt1093824,Encounters at the End of the World,2007,"25,000+",35854,1927,399,967,4,83.0,,112,105,7,112,7.70,94.0
4259,tt1764750,Yugapurushan,2010,Fewer than 50,1,1,0,1,,,,0,0,0,0,,
4260,tt0377818,The Dukes of Hazzard,2005,"250,000+",409962,4696,5441,10349,3.1,46.0,,170,23,147,170,3.70,14.0
4261,tt0420101,Puteri Gunung Ledang,2004,Fewer than 50,8,5,1,2,4.3,83.0,,2,2,0,2,,
4262,tt0318964,Abhinandana,1988,0,0,0,0,0,,,,0,0,0,0,,
4263,tt0082313,Eijanaika,1981,250+,299,17,5,5,3.6,77.0,,1,1,0,1,,
4264,tt0060121,Arabesque,1966,500+,725,137,117,95,3.4,54.0,,19,14,5,19,6.30,74.0
4265,tt0988655,A Flat,2010,Fewer than 50,6,2,0,1,,,,0,0,0,0,,
4266,tt0893401,Daylight Robbery,2008,250+,421,60,76,63,3.1,44.0,,9,2,7,9,3.40,22.0
4267,tt1166100,Ghajini,2008,"5,000+",6481,1342,538,820,3.8,71.0,,13,7,6,13,5.90,54.0
4268,tt0078056,Paradise Alley,1978,"2,500+",3189,119,151,63,3.1,44.0,,5,2,3,5,4.00,40.0
4269,tt0417586,Dangerous Parking,2007,100+,204,33,13,26,3.7,72.0,,4,2,2,4,,
4270,tt0419358,The Poseidon Adventure,2005,"2,500+",4220,81,153,125,2.7,35.0,,2,1,1,2,,
4271,tt0060321,Doctor in Clover,1966,50+,69,5,8,3,3.3,38.0,,0,0,0,0,,
4272,tt1474864,Speaking in Code,2009,Fewer than 50,42,7,3,3,3.3,70.0,,0,0,0,0,,
4273,tt0058264,Kiss Me Quick!,1964,Fewer than 50,9,0,1,0,,,,0,0,0,0,,
4274,tt0119381,Inventing the Abbotts,1997,"5,000+",9912,608,572,253,3.3,51.0,,27,9,18,27,5.60,33.0
4275,tt0199975,Pros & Cons,1999,Fewer than 50,1,0,1,0,,,,0,0,0,0,,
4276,tt0466766,Drive Thru,2007,"2,500+",2537,209,356,307,2.8,37.0,,3,0,3,3,,
4277,tt0396456,Aparichithan,2004,0,0,0,0,0,,,,0,0,0,0,,
4278,tt0411475,Hell Ride,2008,"5,000+",5536,642,1469,935,2.6,30.0,,60,6,54,60,3.50,10.0
4279,tt0762085,Coons! Night of the Bandits of the Night,2005,50+,72,4,4,7,2.9,50.0,,0,0,0,0,,
4280,tt0085547,The First Turn-On!!,1983,100+,228,9,36,15,2.4,20.0,,0,0,0,0,,
4281,tt0105219,Rapid Fire,1992,"10,000+",10318,402,324,251,3.5,55.0,,22,10,12,22,4.90,45.0
4282,tt0304415,Mona Lisa Smile,2003,"100,000+",208329,6593,4321,3833,3.5,60.0,,151,51,100,151,4.90,34.0
4283,tt0304415,Mona Lisa Smile,2003,"100,000+",208329,6593,4321,3833,3.5,60.0,,151,51,100,151,4.90,34.0
4284,tt0077402,Dawn of the Dead,1978,"100,000+",205085,17686,1989,8054,4.3,90.0,,56,51,5,56,8.70,91.0
4285,tt0273048,30 Years to Life,2001,"1,000+",2158,23,12,13,3.8,65.0,,9,6,3,9,5.60,67.0
4286,tt0118214,Zarkorr! The Invader,1996,50+,64,3,13,8,2.1,19.0,,2,1,1,2,,
4287,tt0105599,Tirangaa,1992,Fewer than 50,1,1,0,0,,,,0,0,0,0,,
4288,tt0058990,Brainstorm,1965,50+,89,5,7,5,3.2,42.0,,1,1,0,1,,
4289,tt1630613,Soch Lo,2010,Fewer than 50,6,1,2,1,,,,1,1,0,1,,
4290,tt1417075,In Darkness,2011,"10,000+",11059,1278,310,236,3.9,80.0,,114,100,14,114,7.60,88.0
4291,tt1417075,In Darkness,2011,"10,000+",11059,1278,310,236,3.9,80.0,,114,100,14,114,7.60,88.0
4292,tt0059635,Rasputin: The Mad Monk,1966,"1,000+",1516,63,92,76,3.1,41.0,,8,4,4,8,5.60,50.0
4293,tt0089501,Loose Screws,1985,500+,713,12,39,27,2.6,24.0,,2,0,2,2,,
4294,tt1632722,Playoff,2011,Fewer than 50,17,0,2,0,,,,1,0,1,1,,
4295,tt0485522,Umrao Jaan,2006,"5,000+",5014,299,133,203,3.7,69.0,,4,1,3,4,,
4296,tt0071424,Dirty Mary Crazy Larry,1974,"5,000+",5864,433,200,281,3.7,68.0,,18,8,10,18,4.90,44.0
4297,tt0388482,Transporter 2,2005,"250,000+",407878,12110,8652,11639,3.4,58.0,,122,64,58,122,5.40,52.0
4298,tt0494199,5ive Girls,2006,"10,000+",12298,235,366,296,2.9,39.0,,1,0,1,1,,
4299,tt0076011,The F.J. Holden,1977,Fewer than 50,5,2,1,2,,,,1,1,0,1,,
4300,tt0086567,WarGames,1983,"50,000+",52827,4859,1552,1986,3.8,76.0,,47,44,3,47,7.60,94.0
4301,tt0359398,Hellbreeder,2004,Fewer than 50,7,0,2,0,,,,0,0,0,0,,
4302,tt0092532,Alien from L.A.,1988,250+,387,3,88,44,1.4,3.0,,9,2,7,9,4.00,22.0
4303,tt0282695,Lone Hero,2002,"1,000+",1209,26,25,23,3.3,51.0,,3,2,1,3,,
4304,tt0496673,Calvin Marshall,2009,250+,279,39,54,33,3.2,42.0,,10,6,4,10,5.70,60.0
4305,tt0382810,Little Fish,2005,"50,000+",80014,670,497,483,3.3,57.0,,29,26,3,29,6.70,90.0
4306,tt0186975,Down to You,2000,"50,000+",51529,1179,1253,831,3.2,48.0,,61,2,59,61,3.30,3.0
4307,tt0247945,Badri,2000,0,0,0,0,0,,,,0,0,0,0,,
4308,tt0097770,Lock Up,1989,"10,000+",15573,826,823,416,3.3,50.0,,16,5,11,16,4.70,31.0
4309,tt0247945,Badri,2000,0,0,0,0,0,,,,0,0,0,0,,
4310,tt0071855,Moonchild,1972,Fewer than 50,1,0,1,0,,,,0,0,0,0,,
4311,tt1515091,Sherlock Holmes: A Game of Shadows,2011,"100,000+",168979,67910,20054,11073,3.9,77.0,,230,137,93,230,6.00,60.0
4312,tt0120856,Tarzan and the Lost City,1998,"5,000+",6861,36,118,64,2.5,23.0,,18,1,17,18,2.90,6.0
4313,tt1971365,Dangerous Ishhq,2012,100+,108,13,30,9,2.6,30.0,,5,1,4,5,3.50,20.0
4314,tt0136755,The Christmas List,1997,500+,618,73,36,32,3.8,67.0,,0,0,0,0,,
4315,tt0110892,Princess Caraboo,1994,"2,500+",3300,81,84,64,3.3,49.0,,17,11,6,17,6.30,65.0
4316,tt0070731,Steelyard Blues,1973,250+,344,13,29,15,3,31.0,,6,3,3,6,4.00,50.0
4317,tt4317600,Anandhapurathu Veedu,2010,0,0,0,0,0,,,,0,0,0,0,,
4318,tt1262986,The Last Play at Shea,2010,100+,138,67,6,32,4.2,92.0,,4,3,1,4,,
4319,tt0070022,Electra Glide in Blue,1973,"1,000+",2377,237,82,123,3.8,74.0,,14,9,5,14,6.40,64.0
4320,tt0113824,Whisper of the Heart,1995,"5,000+",5013,4497,516,1511,,,,19,18,1,19,7.60,95.0
4321,tt0137100,Maya Memsaab,1993,50+,95,9,12,4,3,43.0,,0,0,0,0,,
4322,tt0200530,Chuck & Buck,2000,"2,500+",4309,320,169,181,3.4,66.0,,90,76,14,90,7.10,84.0
4323,tt0480821,King of Sorrow,2007,0,0,0,0,0,,,,0,0,0,0,,
4324,tt1023142,Towncraft,2007,100+,188,9,3,4,4,75.0,,1,1,0,1,,
4325,tt0117774,The Substitute,1996,"10,000+",17306,339,493,240,3.1,41.0,,26,11,15,26,4.70,42.0
4326,tt0117774,The Substitute,1996,"10,000+",17306,339,493,240,3.1,41.0,,26,11,15,26,4.70,42.0
4327,tt0453115,"Jeni, Juno",2005,"1,000+",1014,118,65,78,3.6,65.0,,1,0,1,1,,
4328,tt0083033,Saturday the 14th,1981,"1,000+",2238,74,153,110,2.7,33.0,,10,1,9,10,3.40,10.0
4329,tt0829427,The Flying Scissors,2009,Fewer than 50,46,5,2,1,3.9,71.0,,1,0,1,1,,
4330,tt1087578,Still Walking,2008,"2,500+",3770,1090,118,299,4.2,90.0,,65,65,0,65,8.40,100.0
4331,tt0131857,BASEketball,1998,"100,000+",196516,9124,3203,5072,3.9,74.0,,51,21,30,51,5.30,41.0
4332,tt0240515,Freddy Got Fingered,2001,"100,000+",131804,3695,2893,4424,3.2,56.0,,96,10,86,96,3.20,10.0
4333,tt0139699,Varsity Blues,1999,"100,000+",122889,9288,2864,3279,3.9,76.0,,56,24,32,56,5.20,43.0
4334,tt1083448,A Princess for Christmas,2011,250+,310,110,101,36,3.4,52.0,,1,1,0,1,,
4335,tt0365929,Whiteout,2009,"250,000+",538888,1797,6681,3139,2.5,21.0,,118,8,110,118,3.50,7.0
4336,tt1138481,Sonny Boy,2011,Fewer than 50,16,8,4,1,3.7,67.0,,0,0,0,0,,
4337,tt0056606,Tower of London,1962,250+,422,29,42,29,3.1,41.0,,2,1,1,2,,
4338,tt0215865,I Could Read the Sky,1999,100+,225,1,0,0,,,,4,4,0,4,,
4339,tt0116364,A Friend's Betrayal,1996,100+,123,4,12,2,2.8,25.0,,0,0,0,0,,
4340,tt0065370,Act of the Heart,1970,100+,118,2,1,1,,,,4,2,2,4,,
4341,tt1519929,A Dog Named Christmas,2009,Fewer than 50,2,2,0,0,,,,0,0,0,0,,
4342,tt0138981,True Believers,1988,"2,500+",2657,196,117,88,3.6,63.0,,23,22,1,23,7.00,96.0
4343,tt0410454,The Work and the Glory,2004,"5,000+",5914,221,42,128,4.1,84.0,,12,2,10,12,5.10,17.0
4344,tt0213847,Malena,2000,"25,000+",29700,4557,838,1318,4,84.0,,78,42,36,78,5.60,54.0
4345,tt0385057,The Long Weekend,2005,500+,991,66,373,176,2.2,15.0,,6,0,6,6,3.10,0.0
4346,tt0415234,Red Doors,2005,"1,000+",1607,172,72,117,3.6,71.0,,25,16,9,25,6.00,64.0
4347,tt0108649,Zero Patience,1993,"1,000+",1038,21,23,21,3.3,48.0,,8,4,4,8,5.60,50.0
4348,tt1339098,The Hagstone Demon,2011,250+,399,1,6,3,2.4,14.0,,0,0,0,0,,
4349,tt0133643,Breast Men,1997,"1,000+",1008,64,132,51,2.9,33.0,,6,3,3,6,4.70,50.0
4350,tt1821607,Siruthai,2011,50+,60,13,13,4,3.3,50.0,,0,0,0,0,,
4351,tt0293854,The Little Bear Movie,2000,"1,000+",1980,28,13,26,3.8,68.0,,2,2,0,2,,
4352,tt0061203,Women of the Prehistoric Planet,1966,250+,403,3,37,13,1.7,8.0,,0,0,0,0,,
4353,tt0208988,Get Carter,2000,"25,000+",29933,547,1417,528,2.6,28.0,,62,7,55,62,3.70,11.0
4354,tt0816258,Pokiri,2006,"1,000+",1350,212,20,65,4.4,91.0,,0,0,0,0,,
4355,tt0099496,Elves,1989,100+,160,16,39,19,2.3,29.0,,5,0,5,5,2.50,0.0
4356,tt0793542,Late Marriage,2003,"1,000+",1098,185,50,58,3.8,79.0,,64,56,8,64,7.30,88.0
4357,tt0088275,The Times of Harvey Milk,1984,"2,500+",4100,719,46,284,4.3,94.0,,27,26,1,27,8.20,96.0
4358,tt0163591,The Courtesans of Bombay,1983,Fewer than 50,33,1,1,1,,,,0,0,0,0,,
4359,tt0830570,I Can't Think Straight,2008,"25,000+",36895,385,234,168,3.6,62.0,,33,6,27,33,3.70,18.0
4360,tt0056377,A Prize of Arms,1962,0,0,0,0,0,,,,0,0,0,0,,
4361,tt0073104,Hera Pheri,1976,50+,72,6,8,1,3.5,43.0,,0,0,0,0,,
4362,tt0112844,Denise Calls Up,1995,100+,111,10,8,5,3.5,56.0,,23,17,6,23,6.40,74.0
4363,tt1031254,Lost Boys 2: The Tribe,2008,"10,000+",12634,764,2248,1851,2.5,25.0,,7,0,7,7,2.90,0.0
4364,tt0112641,Casino,1995,0,0,0,0,0,,,,0,0,0,0,,
4365,tt0124014,The Mutilator,1984,500+,906,45,133,79,2.7,25.0,,3,1,2,3,,
4366,tt0060784,One of Our Spies Is Missing,1966,0,0,0,0,0,,,,0,0,0,0,,
4367,tt1031254,Lost Boys 2: The Tribe,2008,"10,000+",12634,764,2248,1851,2.5,25.0,,7,0,7,7,2.90,0.0
4368,tt0378025,Hawayein,2003,0,0,0,0,0,,,,0,0,0,0,,
4369,tt0095519,License to Drive,1988,"10,000+",21520,1162,727,770,3.6,61.0,,25,6,19,25,4.00,24.0
4370,tt0109847,A Friend to Die For,1994,500+,747,54,49,39,3.3,52.0,,0,0,0,0,,
4371,tt0182295,Love's Labour's Lost,2000,"2,500+",3715,141,214,161,3,40.0,,68,34,34,68,5.50,50.0
4372,tt2326087,Girl Vs. Monster,2012,250+,328,81,60,26,3.5,57.0,,4,4,0,4,,
4373,tt0239496,Jack Frost 2: Revenge of the Mutant Killer Snowman,2000,"5,000+",6956,90,219,195,2.4,29.0,,6,0,6,6,3.30,0.0
4374,tt0287535,The Lost Battalion,2001,"1,000+",2213,341,90,146,4,79.0,,0,0,0,0,,
4375,tt0318584,Ponga Pandit,1975,Fewer than 50,11,0,1,0,,,,0,0,0,0,,
4376,tt0078865,Birth of the Beatles,1979,100+,126,11,8,12,3.6,58.0,,0,0,0,0,,
4377,tt0119485,Kundun,1997,"10,000+",11848,1809,506,663,3.9,78.0,,62,46,16,62,7.30,74.0
4378,tt1376195,Gunless,2010,"1,000+",1407,277,153,156,3.5,65.0,,5,2,3,5,5.70,40.0
4379,tt0096080,Shadow Dancing,1988,50+,80,2,1,1,,,,0,0,0,0,,
4380,tt0094868,Chocolat,1988,"2,500+",2515,191,93,74,3.5,67.0,,14,10,4,14,7.10,71.0
4381,tt0091003,Eliminators,1986,500+,744,40,73,53,2.9,36.0,,3,1,2,3,,
4382,tt0437803,Alien Siege,2005,100+,216,4,23,7,2,15.0,,1,0,1,1,,
4383,tt0298228,Whale Rider,2002,"25,000+",49983,5843,779,2451,4.2,88.0,,156,142,14,156,7.80,91.0
4384,tt0068713,Horror Express,1972,"2,500+",4452,274,249,213,3.4,52.0,,15,12,3,15,7.00,80.0
4385,tt0464041,The Lazarus Project,2008,"2,500+",3802,617,764,446,3.2,45.0,,5,3,2,5,5.40,60.0
4386,tt0118048,Unlikely Angel,1996,"1,000+",1418,66,30,29,3.9,69.0,,1,0,1,1,,
4387,tt0231448,Deuces Wild,2002,"10,000+",10324,443,434,234,3.2,51.0,,74,2,72,74,3.20,3.0
4388,tt1075749,Reykjavik Whale Watching Massacre,2009,500+,818,33,130,82,2.6,20.0,,4,1,3,4,,
4389,tt0235376,Fail Safe,2000,"1,000+",1684,276,75,71,3.8,79.0,,5,5,0,5,8.20,100.0
4390,tt1227524,Aashayein,2010,100+,221,14,32,17,2.9,30.0,,2,1,1,2,,
4391,tt0330634,Mimic 3: Sentinel,2003,"2,500+",4737,40,226,96,2.1,15.0,,5,3,2,5,5.30,60.0
4392,tt0384096,Confessions of a Thug,2005,50+,99,4,3,0,3.3,57.0,,0,0,0,0,,
4393,tt0120001,Regeneration,1997,"1,000+",1190,36,12,13,3.9,75.0,,10,6,4,10,6.60,60.0
4394,tt0069375,Three on a Meathook,1972,100+,168,5,26,17,2.4,16.0,,0,0,0,0,,
4395,tt0082778,The Munsters' Revenge,1981,500+,907,74,29,39,3.9,72.0,,0,0,0,0,,
4396,tt0089705,Not My Kid,1985,Fewer than 50,12,2,1,1,,,,0,0,0,0,,
4397,tt0303298,American Standoff,2002,Fewer than 50,1,1,0,1,,,,0,0,0,0,,
4398,tt0106273,And the Band Played On,1993,"5,000+",7619,698,92,250,4.2,88.0,,12,12,0,12,7.30,100.0
4399,tt0120422,Up 'n' Under,1998,"1,000+",1230,27,26,23,3.5,51.0,,1,0,1,1,,
4400,tt0119640,McHale's Navy,1997,"5,000+",9203,228,374,181,2.9,38.0,,30,1,29,30,2.80,3.0
4401,tt0387057,Beat the Drum,2003,500+,733,116,16,48,4.1,88.0,,1,1,0,1,,
4402,tt1646876,16 Wishes,2010,"1,000+",1694,371,324,84,3.4,53.0,,0,0,0,0,,
4403,tt0086370,The Sting II,1983,"1,000+",1406,28,68,32,2.6,29.0,,9,0,9,9,3.70,0.0
4404,tt2224254,3 Bachelors,2012,Fewer than 50,2,1,1,0,,,,0,0,0,0,,
4405,tt0109890,The Getaway,1994,"5,000+",8830,237,596,183,2.8,28.0,,24,8,16,24,4.90,33.0
4406,tt0367499,Angaaray,1986,0,0,0,0,0,,,,0,0,0,0,,
4407,tt1204342,The Muppets,2011,"50,000+",89952,32484,8031,7380,4,80.0,,234,222,12,234,7.90,95.0
4408,tt0100280,Nuns on the Run,1990,"5,000+",8442,294,259,234,3.4,53.0,,26,11,15,26,4.60,42.0
4409,tt0938341,Tokyo Sonata,2008,"10,000+",12352,973,240,388,3.8,80.0,,90,85,5,90,7.40,94.0
4410,tt1104835,Feast II: Sloppy Seconds,2008,"1,000+",2444,204,497,385,2.6,29.0,,2,1,1,2,,
4411,tt2890140,Farewell Baghdad,2013,Fewer than 50,10,4,2,0,3.3,67.0,,0,0,0,0,,
4412,tt0096273,Tin Toy,1988,500+,690,150,104,61,3.5,59.0,,1,1,0,1,,
4413,tt0488508,Arctic Tale,2006,"10,000+",21102,784,499,435,3.5,61.0,,99,60,39,99,5.80,61.0
4414,tt0180274,Unhinged,1982,500+,637,19,58,49,2.3,25.0,,0,0,0,0,,
4415,tt1575583,Kalisundam Raa,2000,0,0,0,0,0,,,,0,0,0,0,,
4416,tt0080492,Can't Stop the Music,1980,"2,500+",3091,88,152,159,2.7,37.0,,18,4,14,18,3.10,22.0
4417,tt0056447,Satan Never Sleeps,1962,250+,359,5,11,7,3,31.0,,0,0,0,0,,
4418,tt0884859,Jacob's Ladder,1990,"50,000+",53254,7493,1392,2889,4,84.0,,69,50,19,69,6.60,72.0
4419,tt0116264,Face of Evil,1996,100+,109,6,9,8,3.1,40.0,,0,0,0,0,,
4420,tt1415256,Citizen Jane,2009,50+,91,7,10,11,3,41.0,,0,0,0,0,,
4421,tt0462522,Selling Innocence,2005,250+,369,26,19,9,3.5,58.0,,0,0,0,0,,
4422,tt0100707,Streets,1990,50+,85,9,5,1,3.5,64.0,,3,0,3,3,,
4423,tt0058329,Marnie,1964,"10,000+",19392,2568,973,944,3.7,73.0,,42,35,7,42,7.30,83.0
4424,tt1496025,Underworld: Awakening,2012,"50,000+",98665,22602,13997,5355,3.6,62.0,,77,19,58,77,4.40,25.0
4425,tt0212132,The Tracker,2002,"1,000+",1134,150,25,73,4,86.0,,33,29,4,33,7.10,88.0
4426,tt0313542,Runaway Jury,2003,"50,000+",62846,5431,1804,2095,3.7,75.0,,162,119,43,162,6.60,73.0
4427,tt0265087,Black Knight,2001,"100,000+",169210,1131,2199,1866,2.7,34.0,,98,15,83,98,3.60,15.0
4428,tt1156398,Zombieland,2009,"250,000+",644133,70916,11365,25769,4.1,86.0,,260,232,28,260,7.40,89.0
4429,tt0078503,Within the Woods,1978,250+,370,51,64,30,3.2,44.0,,0,0,0,0,,
4430,tt0353244,Bitter Jester,2003,0,0,0,0,0,,,,3,3,0,3,,
4431,tt0100258,Night of the Living Dead,1990,"50,000+",64289,3686,1730,2083,3.6,68.0,,34,23,11,34,6.30,68.0
4432,tt0428446,The Darwin Awards,2006,"5,000+",6521,819,1006,832,3.1,45.0,,12,3,9,12,5.30,25.0
4433,tt8929248,Azhagana Naatkal,2001,0,0,0,0,0,,,,0,0,0,0,,
4434,tt0082912,Pixote,1980,"2,500+",2513,401,31,133,4.3,93.0,,18,17,1,18,8.80,94.0
4435,tt0092575,Appointment with Fear,1985,Fewer than 50,28,1,4,1,1.8,20.0,,0,0,0,0,,
4436,tt0140090,Guna,1991,Fewer than 50,2,2,0,0,,,,0,0,0,0,,
4437,tt1535615,Best Player,2011,Fewer than 50,3,2,1,3,,,,0,0,0,0,,
4438,tt0171923,Wishbone's Dog Days of the West,1998,Fewer than 50,22,4,6,0,3.5,40.0,,0,0,0,0,,
4439,tt1398999,Earthling,2010,50+,81,10,27,15,2.1,27.0,,1,1,0,1,,
4440,tt0213790,The Ladies Man,2000,"10,000+",21214,752,1035,576,3,42.0,,72,8,64,72,3.40,11.0
4441,tt0156130,Thazhvaram,1990,0,0,0,0,0,,,,0,0,0,0,,
4442,tt0096302,Traxx,1988,50+,64,10,8,5,3.1,56.0,,0,0,0,0,,
4443,tt0084867,Vigilante,1982,"1,000+",1494,157,71,91,3.5,69.0,,5,1,4,5,4.50,20.0
4444,tt0061765,Hillbillys in a Haunted House,1967,500+,744,7,23,18,2.1,23.0,,0,0,0,0,,
4445,tt3176116,Helpless,2013,100+,137,51,21,11,3.6,71.0,,2,2,0,2,,
4446,tt1216492,Leap Year,2010,"2,500+",4454,224,178,86,3.3,56.0,,27,25,2,27,7.10,93.0
4447,tt0483812,Stephanie Daley,2006,"25,000+",49282,266,186,227,3.4,59.0,,50,45,5,50,7.30,90.0
4448,tt0056673,Waltz of the Toreadors,1962,100+,139,7,9,5,2.9,44.0,,2,1,1,2,,
4449,tt0264508,Dagon,2001,"5,000+",7644,692,536,523,3.3,56.0,,13,9,4,13,6.20,69.0
4450,tt0440601,Made in YU,2005,0,0,0,0,0,,,,0,0,0,0,,
4451,tt1839596,Rockstar,2011,"1,000+",1510,547,269,238,3.6,67.0,,6,5,1,6,6.40,83.0
4452,tt0292606,Nazar Ke Samne,1995,0,0,0,0,0,,,,0,0,0,0,,
4453,tt0380277,The Cookout,2004,"5,000+",7335,164,279,144,2.7,37.0,,42,2,40,42,2.90,5.0
4454,tt0076814,That's Carry On!,1977,500+,655,16,17,11,3.4,48.0,,0,0,0,0,,
4455,tt0094034,Steele Justice,1987,250+,307,16,23,19,3,41.0,,5,1,4,5,4.50,20.0
4456,tt0100343,Peacemaker,1990,Fewer than 50,43,4,5,3,3,44.0,,0,0,0,0,,
4457,tt0973785,The Bridge to Nowhere,2009,250+,361,32,61,39,2.7,34.0,,0,0,0,0,,
4458,tt0075909,Damnation Alley,1977,"1,000+",1416,72,140,96,2.9,34.0,,10,4,6,10,4.30,40.0
4459,tt0102691,The Pope Must Die,1991,250+,286,26,26,23,3.2,50.0,,7,2,5,7,3.40,29.0
4460,tt0121232,Dulaara,1994,Fewer than 50,28,1,2,0,,,,0,0,0,0,,
4461,tt1462041,Dream House,2011,Fewer than 50,2,1,0,1,,,,1,1,0,1,,
4462,tt5487250,Deswa,2011,0,0,0,0,0,,,,0,0,0,0,,
4463,tt0357137,Savithriyute Aranjanam,2002,0,0,0,0,0,,,,0,0,0,0,,
4464,tt0059162,The Face of Fu Manchu,1965,250+,250,15,36,20,2.9,29.0,,5,4,1,5,6.00,80.0
4465,tt0119552,Little Red Riding Hood,1997,Fewer than 50,33,1,0,0,,,,0,0,0,0,,
4466,tt0119552,Little Red Riding Hood,1997,Fewer than 50,33,1,0,0,,,,0,0,0,0,,
4467,tt0172726,Light It Up,1999,"5,000+",6743,419,137,194,3.9,75.0,,49,19,30,49,5.00,39.0
4468,tt0162346,Ghost World,2001,"50,000+",73651,12698,2448,4245,4,84.0,,165,153,12,165,7.80,93.0
4469,tt0252196,Aditya 369,1991,Fewer than 50,1,0,1,0,,,,0,0,0,0,,
4470,tt1273678,The Spy Next Door,2010,"100,000+",106344,3198,4780,2235,3,40.0,,92,11,81,92,3.70,12.0
4471,tt0117093,Mother Night,1996,"1,000+",2446,228,77,110,3.8,75.0,,28,18,10,28,6.30,64.0
4472,tt0493464,Wanted,2008,0,0,0,0,0,,,,0,0,0,0,,
4473,tt0493464,Wanted,2008,0,0,0,0,0,,,,0,0,0,0,,
4474,tt1176410,Beethoven's Big Break,2008,"10,000+",13037,63,92,38,3,41.0,,1,0,1,1,,
4475,tt0111687,Whale Music,1994,"1,000+",1237,51,24,37,3.9,68.0,,0,0,0,0,,
4476,tt0493464,Wanted,2008,0,0,0,0,0,,,,0,0,0,0,,
4477,tt0177489,Aag Ka Gola,1989,0,0,0,0,0,,,,0,0,0,0,,
4478,tt0358012,Peoria Babylon,1997,50+,51,0,1,1,,,,0,0,0,0,,
4479,tt0110255,Kickboxer 4: The Aggressor,1994,500+,834,28,60,28,2.8,32.0,,0,0,0,0,,
4480,tt0396962,Shwaas,2004,0,0,0,0,0,,,,0,0,0,0,,
4481,tt0428518,Fade to Black,2004,250+,285,13,26,19,2.8,33.0,,7,2,5,7,4.40,29.0
4482,tt0222270,Phir Bhi Dil Hai Hindustani,2000,"1,000+",2352,119,96,39,3.3,55.0,,0,0,0,0,,
4483,tt0054866,Fanny,1961,250+,432,71,34,36,3.8,68.0,,4,3,1,4,,
4484,tt0073349,Mandingo,1975,500+,692,106,59,60,3.5,64.0,,21,6,15,21,5.60,29.0
4485,tt0089177,My Lucky Stars,1985,250+,256,149,107,68,3.5,58.0,,4,2,2,4,,
4486,tt1169834,Mississippi Damned,2009,250+,286,92,20,18,4.1,82.0,,2,1,1,2,,
4487,tt0389328,Rise,2007,0,0,0,0,0,,,,0,0,0,0,,
4488,tt0274728,The Poof Point,2001,250+,346,14,38,12,2.8,27.0,,1,0,1,1,,
4489,tt0290218,Illusion,2004,500+,828,67,10,44,4.2,87.0,,11,4,7,11,4.90,36.0
4490,tt0058323,Man in the Middle,1964,50+,70,3,3,5,3.3,50.0,,1,1,0,1,,
4491,tt1153698,Love Simple,2009,Fewer than 50,21,3,8,2,2.9,27.0,,0,0,0,0,,
4492,tt0102614,Out for Justice,1991,"10,000+",20831,774,677,541,3.4,53.0,,22,5,17,22,3.80,23.0
4493,tt1422101,Ordinary People,2009,50+,63,6,9,5,2.8,40.0,,0,0,0,0,,
4494,tt0421045,Bickford Shmeckler's Cool Ideas,2006,"2,500+",2551,321,278,213,3.3,54.0,,6,3,3,6,5.80,50.0
4495,tt0338290,Normal,2003,"1,000+",2157,264,83,94,3.8,76.0,,8,8,0,8,7.00,100.0
4496,tt1637728,Ferocious Planet,2011,100+,219,9,84,32,2.1,10.0,,3,1,2,3,,
4497,tt0379370,Maqbool,2003,500+,732,216,16,56,4.2,93.0,,6,6,0,6,,100.0
4498,tt0067126,She'll Follow You Anywhere,1971,0,0,0,0,0,,,,0,0,0,0,,
4499,tt0110307,The Last Outlaw,1993,500+,615,54,52,29,3.3,51.0,,0,0,0,0,,
4500,tt0393635,Reeker,2005,50+,96,12,42,12,2.5,22.0,,1,1,0,1,,
4501,tt0489270,Saw III,2006,"250,000+",561280,43268,17922,28464,3.8,71.0,,95,28,67,95,4.50,29.0
4502,tt0118539,3 Ninjas: High Noon at Mega Mountain,1998,"50,000+",76151,236,570,568,2.4,29.0,,7,0,7,7,2.60,0.0
4503,tt0490919,Exorcism: The Possession of Gail Bowers,2006,100+,169,6,19,9,2.4,24.0,,0,0,0,0,,
4504,tt1612039,Souryam,2008,0,0,0,0,0,,,,0,0,0,0,,
4505,tt0254871,Wishmaster 3: Beyond the Gates of Hell,2001,"5,000+",9110,69,330,151,2.1,17.0,,3,0,3,3,,
4506,tt4315998,Rasikkum Seemane,2010,0,0,0,0,0,,,,0,0,0,0,,
4507,tt0057507,The Skydivers,1963,100+,179,1,49,18,0.9,2.0,,0,0,0,0,,
4508,tt1071223,Mag-ingat ka sa... Kulam,2008,50+,80,3,3,3,3.5,50.0,,0,0,0,0,,
4509,tt0110667,Night of the Demons 2,1994,"2,500+",4158,288,210,179,3.6,58.0,,5,4,1,5,6.00,80.0
4510,tt2146960,Vazhakku Enn 18/9,2012,50+,82,49,4,10,4.4,92.0,,0,0,0,0,,
4511,tt0091789,Pretty Smart,1987,100+,108,7,6,3,3.4,54.0,,0,0,0,0,,
4512,tt2304573,Daruvu,2012,0,0,0,0,0,,,,0,0,0,0,,
4513,tt1522218,Obselidia,2010,100+,154,27,14,13,3.6,66.0,,0,0,0,0,,
4514,tt0182508,Urbania,2000,"1,000+",1643,156,63,88,3.7,71.0,,30,22,8,30,6.90,73.0
4515,tt0109906,The Glass Shield,1994,"1,000+",1215,51,76,40,3,40.0,,25,17,8,25,5.60,68.0
4516,tt0107062,Gunsmoke: The Long Ride,1993,Fewer than 50,22,3,0,1,,,,2,2,0,2,,
4517,tt0141369,Inspektør Gadget,1999,"250,000+",275716,693,3114,4209,2.2,18.0,,64,13,51,64,4.10,20.0
4518,tt0166843,There's Always Vanilla,1971,250+,438,10,28,15,2.7,26.0,,2,0,2,2,,
4519,tt0111159,Shatter Dead,1994,500+,696,6,18,18,2.1,25.0,,1,1,0,1,,
4520,tt0112679,Circle of Friends,1995,0,0,0,0,0,,,,0,0,0,0,,
4521,tt0328671,Yeh Hai Jalwa,2002,250+,336,13,18,4,3,42.0,,0,0,0,0,,
4522,tt0096200,Sweet Hearts Dance,1988,"1,000+",1445,17,31,10,3.2,35.0,,9,4,5,9,5.40,44.0
4523,tt0112345,American Job,1996,0,0,0,0,0,,,,3,2,1,3,,
4524,tt0989757,Dear John,2010,"250,000+",619135,15213,12374,7230,3.4,55.0,,139,40,99,139,4.40,29.0
4525,tt0989757,Dear John,2010,"250,000+",619135,15213,12374,7230,3.4,55.0,,139,40,99,139,4.40,29.0
4526,tt2082197,Barfi!,2012,"2,500+",4937,1278,207,324,4.1,86.0,,15,12,3,15,7.00,80.0
4527,tt0081071,The Long Riders,1980,"5,000+",5524,445,168,227,3.7,73.0,,27,22,5,27,6.80,81.0
4528,tt0084590,The Return of the Soldier,1982,50+,70,3,4,4,3.6,43.0,,1,1,0,1,,
4529,tt0120755,Mission: Impossible II,2000,"250,000+",452679,10706,14686,11023,3,42.0,,155,87,68,155,5.90,56.0
4530,tt0421640,Arul,2004,50+,65,3,4,0,2.9,43.0,,0,0,0,0,,
4531,tt1246600,Tantric Tourists,2009,100+,165,2,2,1,,,,3,2,1,3,,
4532,tt0379296,Game Over: Kasparov and the Machine,2003,100+,225,36,31,26,3.3,55.0,,29,22,7,29,6.70,76.0
4533,tt0429177,The Thing About My Folks,2005,"10,000+",17514,101,97,99,3.3,51.0,,65,29,36,65,5.60,45.0
4534,tt0889600,To Be Fat Like Me,2007,"1,000+",2242,152,112,102,3.4,58.0,,0,0,0,0,,
4535,tt0069711,Anamika,1973,50+,51,1,0,0,,,,0,0,0,0,,
4536,tt1037705,The Book of Eli,2010,"250,000+",351093,32167,17753,15258,3.6,64.0,,210,98,112,210,5.50,47.0
4537,tt1785333,Chittagong,2012,Fewer than 50,12,5,3,1,3.6,62.0,,2,2,0,2,,
4538,tt0174336,Whipped,2000,"2,500+",4602,86,180,99,2.6,32.0,,68,9,59,68,3.40,13.0
4539,tt0418773,Junebug,2005,"25,000+",46900,3724,1347,2002,3.7,73.0,,135,116,19,135,7.50,86.0
4540,tt0109578,Death Wish V: The Face of Death,1994,"5,000+",8599,158,338,178,2.7,32.0,,6,0,6,6,3.40,0.0
4541,tt0056850,Bandini,1963,50+,55,5,2,1,3.4,71.0,,0,0,0,0,,
4542,tt0127045,Neon Maniacs,1986,250+,387,34,68,52,2.7,34.0,,0,0,0,0,,
4543,tt0223268,Faust: Love of the Damned,2000,"2,500+",2606,44,176,100,2.2,20.0,,3,1,2,3,,
4544,tt0824375,Nishabd,2007,"1,000+",1487,53,80,59,3,40.0,,2,0,2,2,,
4545,tt0092537,The Allnighter,1987,"1,000+",1380,34,58,37,2.9,37.0,,9,0,9,9,2.90,0.0
4546,tt0451038,The Derby Stallion,2005,"5,000+",6930,357,195,329,3.6,65.0,,2,1,1,2,,
4547,tt2186943,Mambattiyan,2011,0,0,0,0,0,,,,0,0,0,0,,
4548,tt1833846,Eating Out: The Open Weekend,2011,250+,309,41,67,24,3,38.0,,1,1,0,1,,
4549,tt0120478,Star Kid,1997,"5,000+",5088,113,201,88,2.8,36.0,,14,6,8,14,5.40,43.0
4550,tt0444593,500 Years Later,2005,250+,344,29,5,14,4.4,85.0,,0,0,0,0,,
4551,tt0191972,Down Will Come Baby,1999,100+,151,6,6,4,3.4,50.0,,0,0,0,0,,
4552,tt0092557,Anantaram,1987,0,0,0,0,0,,,,1,1,0,1,,
4553,tt0499375,Guru,2007,"5,000+",7783,1109,212,415,4,84.0,,13,11,2,13,7.10,85.0
4554,tt0096355,Uttar Dakshin,1987,50+,63,1,2,0,,,,0,0,0,0,,
4555,tt0443649,"10,000 BC",2008,"250,000+",411242,16624,27782,21576,2.8,37.0,,148,14,134,148,3.40,9.0
4556,tt0101301,All I Want for Christmas,1991,"5,000+",9742,234,163,157,3.5,59.0,,15,1,14,15,3.80,7.0
4557,tt0825225,American Pastime,2007,"1,000+",1570,73,34,42,3.6,68.0,,9,3,6,9,5.40,33.0
4558,tt0119099,Fallen,1998,"50,000+",52095,4528,1744,1933,3.7,72.0,,57,23,34,57,5.30,40.0
4559,tt0802956,Bryan Loves You,2008,250+,324,5,29,17,1.9,15.0,,0,0,0,0,,
4560,tt0070653,Scorpio,1973,250+,497,45,67,35,3.1,40.0,,22,13,9,22,6.50,59.0
4561,tt1855401,Tim and Eric's Billion Dollar Movie,2012,"2,500+",4831,1107,1272,531,3,47.0,,74,28,46,74,4.50,38.0
4562,tt0057242,Ladybug Ladybug,1963,Fewer than 50,48,22,3,4,4.1,88.0,,4,3,1,4,,
4563,tt0071650,Ilsa: She Wolf of the SS,1975,"2,500+",3774,251,342,262,3,42.0,,11,4,7,11,4.60,36.0
4564,tt1330039,Las Meninas,2008,0,0,0,0,0,,,,0,0,0,0,,
4565,tt0090992,Eat and Run,1986,Fewer than 50,34,4,7,1,3.1,36.0,,0,0,0,0,,
4566,tt1815726,Gosht Choti Dongraevadhi,2009,0,0,0,0,0,,,,0,0,0,0,,
4567,tt0092933,Dudes,1987,250+,444,53,32,30,3.5,62.0,,4,1,3,4,,
4568,tt1847736,U R My Jaan,2011,Fewer than 50,2,1,0,1,,,,0,0,0,0,,
4569,tt0164023,Exiled,1998,0,0,0,0,0,,,,0,0,0,0,,
4570,tt0212860,Cheerleaders Beach Party,1978,0,0,0,0,0,,,,0,0,0,0,,
4571,tt0089826,Porky's Revenge,1985,"5,000+",9562,289,587,157,2.9,33.0,,12,3,9,12,3.90,25.0
4572,tt0088184,Stranger Than Paradise,1984,"10,000+",15689,3082,419,764,4.1,88.0,,28,27,1,28,7.70,96.0
4573,tt0274155,Tanguy,2001,"2,500+",4117,326,180,95,3.6,64.0,,1,1,0,1,,
4574,tt1270835,Hatchet II,2010,"2,500+",2943,455,805,416,2.9,36.0,,36,15,21,36,4.50,42.0
4575,tt0120587,Antz,1998,"250,000+",652266,9811,9157,9636,3.3,52.0,,91,84,7,91,7.60,92.0
4576,tt0398872,Clifford's Really Big Movie,2004,"1,000+",1802,40,68,48,3,37.0,,31,17,14,31,5.70,55.0
4577,tt0086619,Yentl,1983,"5,000+",7937,825,276,401,3.9,75.0,,76,52,24,76,6.60,68.0
4578,tt1986926,Otelo Burning,2011,50+,78,5,1,3,3.6,83.0,,9,6,3,9,5.80,67.0
4579,tt0083017,SS girls,1977,250+,312,14,25,21,2.8,36.0,,0,0,0,0,,
4580,tt1509119,You Lucky Dog,2010,Fewer than 50,3,0,2,0,,,,1,1,0,1,,
4581,tt0487958,Stephanie's Image,2009,Fewer than 50,38,0,2,2,,,,0,0,0,0,,
4582,tt0267904,Sandhyakku Virinja Poovu,1983,0,0,0,0,0,,,,0,0,0,0,,
4583,tt0109566,Dead Funny,1994,50+,61,3,3,1,3.2,50.0,,2,0,2,2,,
4584,tt0106941,For Love or Money,1993,"5,000+",9099,308,370,150,3.2,45.0,,19,7,12,19,4.40,37.0
4585,tt0099171,Box-Office Bunny,1990,Fewer than 50,1,1,0,1,,,,0,0,0,0,,
4586,tt1212436,The Back-up Plan,2010,"100,000+",135588,6597,7843,3648,3.1,46.0,,150,26,124,150,3.70,17.0
4587,tt0056397,Reach for Glory,1962,0,0,0,0,0,,,,0,0,0,0,,
4588,tt0818662,Chairman George,2005,0,0,0,0,0,,,,0,0,0,0,,
4589,tt0174204,Simpatico,1999,"1,000+",1147,14,80,24,2.2,14.0,,60,15,45,60,4.70,25.0
4590,tt0224267,Tom Sawyer,2000,"1,000+",1760,23,11,19,3.8,68.0,,1,1,0,1,,
4591,tt0329334,Bleed,2002,"1,000+",1727,5,33,22,1.8,13.0,,0,0,0,0,,
4592,tt0098694,All About Ah-Long,1989,500+,577,110,16,35,4.1,87.0,,1,1,0,1,,
4593,tt2215348,Best of Luck,2013,100+,103,3,6,1,3,33.0,,0,0,0,0,,
4594,tt0111345,T-Force,1994,50+,67,3,4,4,3.2,43.0,,0,0,0,0,,
4595,tt0116378,The Funeral,1996,"2,500+",4417,375,180,126,3.6,67.0,,35,28,7,35,7.00,80.0
4596,tt0307116,Maa Tujhhe Salaam,2002,50+,75,1,1,1,,,,0,0,0,0,,
4597,tt0496328,Itty Bitty Titty Committee,2007,"2,500+",4166,339,271,214,3.3,56.0,,8,3,5,8,5.00,38.0
4598,tt0134928,Rasen,1998,"1,000+",1229,48,132,87,2.6,27.0,,1,0,1,1,,
4599,tt0384683,What We Do Is Secret,2007,"5,000+",8010,189,167,140,3.3,53.0,,47,21,26,47,5.20,45.0
4600,tt1291465,Raajneeti,2010,"1,000+",2077,476,262,286,3.5,65.0,,9,2,7,9,4.40,22.0
4601,tt0276053,Out of Bounds,2003,50+,58,1,2,2,,,,0,0,0,0,,
4602,tt0814295,Rocky,2006,0,0,0,0,0,,,,0,0,0,0,,
4603,tt0081061,The Little Dragons,1979,Fewer than 50,14,0,2,1,,,,0,0,0,0,,
4604,tt0105500,Suryavanshi,1992,0,0,0,0,0,,,,0,0,0,0,,
4605,tt0387131,The Constant Gardener,2005,"100,000+",217727,19169,4208,7508,3.9,82.0,,192,160,32,192,7.60,83.0
4606,tt0062516,The Young Warriors,1967,Fewer than 50,8,0,2,2,,,,0,0,0,0,,
4607,tt0169514,Witchblade,2000,Fewer than 50,1,1,0,1,,,,0,0,0,0,,
4608,tt0161942,Revelation,1999,50+,89,2,9,3,1.9,18.0,,3,2,1,3,,
4609,tt0161942,Revelation,1999,50+,89,2,9,3,1.9,18.0,,3,2,1,3,,
4610,tt2152896,Subramaniapuram,2008,50+,99,33,4,14,4.1,89.0,,1,1,0,1,,
4611,tt0282163,Shredder,2001,"1,000+",1734,42,122,93,2.6,26.0,,3,2,1,3,,
4612,tt0356099,Swapna Lokathe Balabhaskaran,1996,0,0,0,0,0,,,,0,0,0,0,,
4613,tt0055608,Voyage to the Bottom of the Sea,1961,500+,768,101,161,100,3,39.0,,17,13,4,17,6.40,76.0
4614,tt0126771,Halloween with the New Addams Family,1977,Fewer than 50,4,0,4,0,,,,0,0,0,0,,
4615,tt2081438,Zombie Massacre,2013,50+,72,4,51,14,1.5,7.0,,1,0,1,1,,
4616,tt0065489,Brancaleone alle Crociate,1970,0,0,0,0,0,,,,0,0,0,0,,
4617,tt0306069,The Singles Ward,2002,"5,000+",5048,205,78,125,3.8,73.0,,8,4,4,8,5.40,50.0
4618,tt0306069,The Singles Ward,2002,"5,000+",5048,205,78,125,3.8,73.0,,8,4,4,8,5.40,50.0
4619,tt1826894,The Eyes of Thailand,2012,Fewer than 50,16,4,1,0,3.9,80.0,,0,0,0,0,,
4620,tt0299478,Sarabande,2003,"5,000+",5114,674,103,175,4,87.0,,84,76,8,84,7.80,90.0
4621,tt0355739,Mangalam Veettil Manaseswari Gupta,1995,0,0,0,0,0,,,,0,0,0,0,,
4622,tt0387549,The Roost,2005,500+,902,70,117,91,2.7,38.0,,21,11,10,21,6.00,52.0
4623,tt1461418,The Gruffalo,2009,500+,546,257,69,68,3.9,79.0,,3,3,0,3,,
4624,tt0379557,Touching the Void,2003,"10,000+",11136,2827,243,930,4.3,92.0,,139,130,9,139,8.00,94.0
4625,tt0800369,Thor,2011,"250,000+",250522,113092,36295,19988,3.8,76.0,,296,229,67,296,6.70,77.0
4626,tt0092006,Star Crystal,1986,250+,269,5,25,19,2,17.0,,1,1,0,1,,
4627,tt0118523,'Til There Was You,1997,"10,000+",12678,73,135,55,2.7,35.0,,40,2,38,40,4.00,5.0
4628,tt1367417,Our Disappeared/Nuestros desaparecidos,2008,Fewer than 50,23,4,0,3,,,,1,1,0,1,,
4629,tt0364456,Kasethan Kadavulada,1972,0,0,0,0,0,,,,0,0,0,0,,
4630,tt0439869,Varsham,2004,100+,100,23,0,4,4.4,100.0,,0,0,0,0,,
4631,tt0446029,Scott Pilgrim vs. the World,2010,"100,000+",143009,48035,9358,14502,4.1,84.0,,273,225,48,273,7.60,82.0
4632,tt0120678,Free Money,1998,"1,000+",1360,30,89,28,2.6,25.0,,7,2,5,7,4.30,29.0
4633,tt2337164,Just One Summer,2012,Fewer than 50,2,0,2,1,,,,0,0,0,0,,
4634,tt0117407,Pusher,1996,"5,000+",7878,1899,333,470,3.9,85.0,,18,15,3,18,7.10,83.0
4635,tt0095082,Eight Men Out,1988,"10,000+",12724,1541,397,516,3.8,79.0,,54,47,7,54,7.20,87.0
4636,tt0418129,Salvador Allende,2004,500+,610,63,12,11,4.1,84.0,,13,11,2,13,7.00,85.0
4637,tt1319694,Glorious 39,2009,"1,000+",2134,208,281,181,3.1,43.0,,25,11,14,25,4.90,44.0
4638,tt0291930,Gandharvam,1993,0,0,0,0,0,,,,0,0,0,0,,
4639,tt0486099,Kraken: Tentacles of the Deep,2006,250+,418,12,56,38,2,18.0,,2,0,2,2,,
4640,tt2331167,Naan,2012,Fewer than 50,3,2,1,0,,,,1,1,0,1,,
4641,tt0078292,Solos en la madrugada,1978,0,0,0,0,0,,,,0,0,0,0,,
4642,tt0169606,Beyond the Law,1968,100+,104,9,21,12,2.8,30.0,,3,3,0,3,,
4643,tt0075409,W.C. Fields and Me,1976,Fewer than 50,31,8,5,3,3.6,62.0,,6,4,2,6,,67.0
4644,tt0279491,Ullasa Paravaigal,1980,Fewer than 50,26,0,1,0,,,,0,0,0,0,,
4645,tt0331934,Chitram,2000,0,0,0,0,0,,,,0,0,0,0,,
4646,tt5313896,The Princess and the Frog,2009,"250,000+",261606,20775,7204,9363,3.8,74.0,,202,172,30,202,7.40,85.0
4647,tt0988045,Sherlock Holmes,2009,0,0,0,0,0,,,,0,0,0,0,,
4648,tt0079817,Rocky II,1979,"250,000+",346837,19022,4169,6744,4,82.0,,33,23,10,33,6.70,70.0
4649,tt0988045,Sherlock Holmes,2009,0,0,0,0,0,,,,0,0,0,0,,
4650,tt0988045,Sherlock Holmes,2009,0,0,0,0,0,,,,0,0,0,0,,
4651,tt1298540,Berlin '36,2009,100+,122,19,20,7,3.2,49.0,,7,3,4,7,4.90,43.0
4652,tt0052376,War Is Hell,1961,Fewer than 50,4,2,0,0,,,,0,0,0,0,,
4653,tt0988045,Sherlock Holmes,2009,0,0,0,0,0,,,,0,0,0,0,,
4654,tt0423977,Charlie Bartlett,2007,"100,000+",105139,9771,3969,5612,3.7,71.0,,131,76,55,131,5.80,58.0
4655,tt0259518,Prem Nazirine Kanmanilla,1983,0,0,0,0,0,,,,0,0,0,0,,
4656,tt1283887,Burning Palms,2010,"1,000+",1323,99,180,92,2.8,35.0,,8,3,5,8,4.60,38.0
4657,tt0120685,Godzilla,1998,"250,000+",303342,3983,10275,8772,2.5,28.0,,150,30,120,150,4.50,20.0
4658,tt0064179,The Comic,1969,100+,104,12,9,6,3.3,57.0,,6,4,2,6,7.20,67.0
4659,tt0074659,I Will... I Will... For Now,1976,50+,60,1,0,0,,,,4,1,3,4,,
4660,tt0433116,Looking for Comedy in the Muslim World,2005,"10,000+",14537,150,406,297,2.5,27.0,,108,46,62,108,5.40,43.0
4661,tt0095806,The Outside Chance of Maximilian Glick,1988,Fewer than 50,26,2,4,4,3.2,33.0,,0,0,0,0,,
4662,tt0377845,Ek Chadar Maili Si,1986,Fewer than 50,21,1,1,0,,,,0,0,0,0,,
4663,tt0492968,Everyone Stares: The Police Inside Out,2006,50+,58,10,5,4,3.8,67.0,,7,2,5,7,5.00,29.0
4664,tt0097423,"Get Smart, Again!",1989,250+,423,38,29,27,3.6,57.0,,1,0,1,1,,
4665,tt3508268,Romance on Lushan Mountain,1980,0,0,0,0,0,,,,0,0,0,0,,
4666,tt0084911,Witness for the Prosecution,1982,100+,146,22,13,9,3.7,63.0,,0,0,0,0,,
4667,tt0177650,Company Man,2000,"1,000+",1447,38,49,20,3,44.0,,63,9,54,63,3.40,14.0
4668,tt0115624,Barb Wire,1996,"25,000+",47325,227,1350,874,1.9,14.0,,36,10,26,36,4.20,28.0
4669,tt0075263,St. Ives,1976,100+,166,21,33,14,3.2,40.0,,12,4,8,12,4.90,33.0
4670,tt0081233,Nightmares,1980,"1,000+",1775,53,114,59,2.9,32.0,,7,2,5,7,5.50,29.0
4671,tt0077429,Devil Dog: The Hound of Hell,1978,250+,373,11,42,23,2.6,21.0,,2,0,2,2,,
4672,tt0097731,Let It Ride,1989,"2,500+",3457,373,119,186,3.9,76.0,,11,3,8,11,5.00,27.0
4673,tt2022490,Pennin Manathai Thottu,2000,0,0,0,0,0,,,,0,0,0,0,,
4674,tt0116041,The Daytrippers,1996,"2,500+",2958,218,78,94,3.7,74.0,,27,20,7,27,6.40,74.0
4675,tt0112571,Boys on the Side,1995,"25,000+",35225,1101,505,558,3.7,69.0,,113,83,30,113,6.50,73.0
4676,tt0101764,Double Impact,1991,"25,000+",48856,848,1157,751,3.1,42.0,,21,7,14,21,4.20,33.0
4677,tt0446750,Nightwatching,2007,"1,000+",1517,200,126,103,3.3,62.0,,19,14,5,19,6.30,74.0
4678,tt0373469,Kiss Kiss Bang Bang,2005,"100,000+",203681,24840,3735,10415,4,87.0,,184,158,26,184,7.50,86.0
4679,tt0057997,Dead Ringer,1963,"1,000+",1919,239,61,89,3.9,80.0,,10,10,0,10,6.80,100.0
4680,tt1439572,Perfect Sense,2011,"5,000+",5974,1751,1187,502,3.4,60.0,,65,37,28,65,5.80,57.0
4681,tt0352864,Spivs,2004,500+,578,17,15,18,3.4,53.0,,3,1,2,3,,
4682,tt0115042,Zamaana Deewana,1995,0,0,0,0,0,,,,0,0,0,0,,
4683,tt0239452,Haseena Maan Jayegi,1968,0,0,0,0,0,,,,0,0,0,0,,
4684,tt0385351,Yeh Lamhe Judaai Ke,2004,0,0,0,0,0,,,,0,0,0,0,,
4685,tt6811008,Kovilpatti Veeralakshmi,2003,0,0,0,0,0,,,,0,0,0,0,,
4686,tt0756632,The Christmas Blessing,2005,250+,447,69,32,33,3.8,68.0,,0,0,0,0,,
4687,tt1703122,Shirome,2010,Fewer than 50,14,3,5,2,2.8,38.0,,1,1,0,1,,
4688,tt0091534,Modern Girls,1986,500+,728,88,50,52,3.7,63.0,,5,2,3,5,4.50,40.0
4689,tt0091067,For Love Alone,1986,0,0,0,0,0,,,,0,0,0,0,,
4690,tt0118924,Dance of the Wind,1997,0,0,0,0,0,,,,0,0,0,0,,
4691,tt0897361,I Know Who Killed Me,2007,"100,000+",142910,3032,8755,6548,2.3,26.0,,78,7,71,78,2.80,9.0
4692,tt0360921,Red Trousers: The Life of the Hong Kong Stuntmen,2003,500+,582,9,18,10,2.9,33.0,,17,4,13,17,4.90,24.0
4693,tt0305819,Meleparambil Aanveedu,1993,0,0,0,0,0,,,,0,0,0,0,,
4694,tt0902253,Another Perfect Stranger,2006,250+,258,34,7,17,4,83.0,,0,0,0,0,,
4695,tt2022522,Runway,2010,Fewer than 50,18,1,2,0,,,,1,0,1,1,,
4696,tt0250468,Killing Me Softly,2002,"5,000+",8504,514,758,387,3,40.0,,22,0,22,22,3.40,0.0
4697,tt1560970,Neds,2010,"2,500+",3206,794,327,276,3.6,71.0,,35,33,2,35,7.50,94.0
4698,tt0055767,Baat Ek Raat Ki,1962,0,0,0,0,0,,,,0,0,0,0,,
4699,tt0099524,Evil Toons,1992,"1,000+",1548,26,76,38,2.5,25.0,,6,2,4,6,4.00,33.0
4700,tt0427944,Thank You for Smoking,2005,"250,000+",258735,33286,4840,13203,4,87.0,,183,158,25,183,7.30,86.0
4701,tt0119744,Mystery Monsters,1997,Fewer than 50,49,0,6,2,1.5,0.0,,2,0,2,2,,
4702,tt0078935,Cannibal Holocaust,1980,"25,000+",25832,3417,2153,2737,3.4,61.0,,18,12,6,18,5.50,67.0
4703,tt0076725,Sleeping Dogs,1977,100+,179,18,14,10,3.3,56.0,,4,3,1,4,,
4704,tt0065511,C.C. & Company,1970,50+,97,6,20,11,2.4,23.0,,2,0,2,2,,
4705,tt1629737,Panchakshari,2010,0,0,0,0,0,,,,0,0,0,0,,
4706,tt0071714,Kasauti,1974,0,0,0,0,0,,,,0,0,0,0,,
4707,tt1582560,Namo Venkatesa,2010,0,0,0,0,0,,,,0,0,0,0,,
4708,tt0071391,Dark Places,1974,Fewer than 50,13,2,3,2,3.6,40.0,,0,0,0,0,,
4709,tt0089284,Hold-Up,1985,250+,350,22,33,8,3.2,40.0,,0,0,0,0,,
4710,tt10197858,Annayya,1993,0,0,0,0,0,,,,0,0,0,0,,
4711,tt0955381,Off the Ledge,2009,50+,52,6,2,3,4.2,75.0,,0,0,0,0,,
4712,tt0198284,After Sex,2000,100+,178,1,21,3,1.8,5.0,,0,0,0,0,,
4713,tt0064462,I Start Counting,1970,Fewer than 50,35,11,8,6,3.4,58.0,,1,1,0,1,,
4714,tt0156290,Anubhav,1971,Fewer than 50,33,3,2,0,3.6,60.0,,1,1,0,1,,
4715,tt0082226,D.O.A.,1980,100+,119,11,1,3,4.1,92.0,,1,1,0,1,,
4716,tt0113277,Heat,1995,"100,000+",222922,37130,2472,12085,4.4,94.0,,95,84,11,95,7.90,88.0
4717,tt0098255,Sati,1989,100+,127,5,1,2,4,83.0,,0,0,0,0,,
4718,tt0192023,Finder's Fee,2001,"1,000+",1606,106,76,81,3.5,58.0,,5,3,2,5,6.80,60.0
4719,tt1535438,Hope Springs,2012,"25,000+",47068,6742,5413,1842,3.4,55.0,,173,130,43,173,6.70,75.0
4720,tt0275230,Blood: The Last Vampire,2000,"10,000+",23904,1162,592,824,3.6,66.0,,18,9,9,18,5.50,50.0
4721,tt0069817,The Borrowers,1973,Fewer than 50,29,5,6,6,3.2,45.0,,0,0,0,0,,
4722,tt0060048,40 Guns to Apache Pass,1967,100+,193,7,13,8,3.2,37.0,,1,0,1,1,,
4723,tt0080437,The Big Red One,1980,"5,000+",9078,919,262,335,3.8,78.0,,49,44,5,49,7.80,90.0
4724,tt0430710,Udayananu Tharam,2005,0,0,0,0,0,,,,0,0,0,0,,
4725,tt0243931,Good Advice,2001,"2,500+",4103,165,174,91,3.2,49.0,,6,2,4,6,5.10,33.0
4726,tt1119191,The Killing Room,2009,"2,500+",2616,445,651,387,3,41.0,,7,5,2,7,5.80,71.0
4727,tt4328084,Nanjupuram,2011,0,0,0,0,0,,,,0,0,0,0,,
4728,tt1394316,Chaowa Pawa,2009,0,0,0,0,0,,,,0,0,0,0,,
4729,tt0076191,The Incredible Melting Man,1977,"1,000+",1731,69,221,139,2.4,24.0,,14,1,13,14,3.20,7.0
4730,tt0230670,Pyar Ka Mausam,1969,0,0,0,0,0,,,,0,0,0,0,,
4731,tt1621809,Koodal Nagar,2007,0,0,0,0,0,,,,0,0,0,0,,
4732,tt1526284,Ay Lav Yu,2010,0,0,0,0,0,,,,0,0,0,0,,
4733,tt0102558,Nothing But Trouble,1991,"10,000+",18893,1040,1142,841,3.1,48.0,,26,4,22,26,2.90,15.0
4734,tt0831884,Reservation Road,2007,"10,000+",14591,1854,1732,1615,3.3,52.0,,112,42,70,112,5.20,38.0
4735,tt0098089,Phantom of the Mall: Eric's Revenge,1989,500+,521,16,36,26,2.9,31.0,,3,1,2,3,,
4736,tt1527186,Melancholia,2011,"25,000+",44825,11718,5803,3658,3.5,67.0,,209,167,42,209,7.50,80.0
4737,tt1014672,Bheja Fry,2007,"2,500+",3315,410,81,225,4,83.0,,2,1,1,2,,
4738,tt0117128,Mystery Science Theater 3000: The Movie,1996,"25,000+",26960,2631,358,1523,4.2,88.0,,56,45,11,56,6.70,80.0
4739,tt0119304,Home Fries,1998,"25,000+",39489,426,843,471,2.8,34.0,,36,11,25,36,4.90,31.0
4740,tt0096455,The Wizard of Loneliness,1988,50+,93,3,1,1,,,,3,2,1,3,,
4741,tt0070201,"Hurry Up, or I'll Be 30",1973,Fewer than 50,49,2,0,1,,,,0,0,0,0,,
4742,tt1598828,One for the Money,2012,"25,000+",36913,5233,7120,1728,3,42.0,,54,1,53,54,3.20,2.0
4743,tt0099768,Hidden Agenda,1990,500+,774,132,51,38,3.7,72.0,,21,18,3,21,6.90,86.0
4744,tt0948462,Priyamanavale,2000,0,0,0,0,0,,,,0,0,0,0,,
4745,tt1791614,Struck by Lightning,2012,"5,000+",9704,1795,1626,341,3.4,52.0,,33,11,22,33,5.20,33.0
4746,tt0371693,Going for Broke,2003,250+,332,12,6,6,3.8,67.0,,0,0,0,0,,
4747,tt1477835,Bitter Feast,2010,250+,256,40,85,36,2.8,32.0,,6,4,2,6,5.20,67.0
4748,tt0058153,Good Neighbor Sam,1964,100+,157,43,23,14,3.6,65.0,,5,4,1,5,7.00,80.0
4749,tt0066171,O.K.,1970,0,0,0,0,0,,,,1,1,0,1,,
4750,tt0285156,The Groomsmen,2003,"10,000+",18240,289,367,284,3.1,44.0,,32,17,15,32,5.60,53.0
4751,tt0431091,Going Under,2004,250+,480,5,5,2,3,50.0,,6,1,5,6,4.60,17.0
4752,tt0179626,15 Minutes,2001,"50,000+",50679,1044,1788,657,3,37.0,,123,39,84,123,4.40,32.0
4753,tt0068458,Death Line,1972,"1,000+",1731,129,155,123,3.1,45.0,,11,10,1,11,7.20,91.0
4754,tt0066194,The Over-the-Hill Gang Rides Again,1970,50+,97,4,9,7,2.7,31.0,,0,0,0,0,,
4755,tt0060145,Baharen Phir Bhi Aayengi,1966,Fewer than 50,26,1,0,0,,,,0,0,0,0,,
4756,tt0982860,Chase Me,2003,Fewer than 50,3,0,3,0,,,,0,0,0,0,,
4757,tt0893532,Kill Theory,2009,"1,000+",1050,104,297,149,2.7,26.0,,0,0,0,0,,
4758,tt1231586,A Good Old Fashioned Orgy,2011,"5,000+",8681,923,1321,334,3.1,41.0,,64,23,41,64,4.70,36.0
4759,tt2118771,Yesterday Today Tomorrow,2011,0,0,0,0,0,,,,0,0,0,0,,
4760,tt0312898,Late One Night,2001,100+,100,7,2,3,4,78.0,,0,0,0,0,,
4761,tt0195685,Erin Brockovich,2000,"250,000+",418943,13393,3174,8239,3.9,81.0,,150,127,23,150,7.50,85.0
4762,tt0082121,Bustin' Loose,1981,"2,500+",4474,138,91,74,3.6,61.0,,5,3,2,5,6.00,60.0
4763,tt0366276,Calcutta Mail,2003,100+,182,2,7,1,2.9,22.0,,0,0,0,0,,
4764,tt0341554,Saath Saath,1982,0,0,0,0,0,,,,0,0,0,0,,
4765,tt0953318,Ben X,2007,"5,000+",6748,1343,339,544,3.9,80.0,,39,27,12,39,6.30,69.0
4766,tt1314169,Case 219,2010,0,0,0,0,0,,,,0,0,0,0,,
4767,tt1322312,Going the Distance,2010,"50,000+",57469,5680,5195,2713,3.3,52.0,,167,90,77,167,5.80,54.0
4768,tt0072913,Master of the Flying Guillotine,1976,"5,000+",5880,596,88,316,4.2,87.0,,21,19,2,21,6.90,90.0
4769,tt1196701,A Summer in the Cage,2007,Fewer than 50,18,4,0,0,,,,0,0,0,0,,
4770,tt0271136,Quicksand,2003,"1,000+",1291,22,92,36,2.6,19.0,,2,0,2,2,,
4771,tt0054059,Manzil,1960,Fewer than 50,22,1,0,0,,,,0,0,0,0,,
4772,tt0091499,Maximum Overdrive,1986,"25,000+",44904,1448,1446,1628,3.2,50.0,,13,2,11,13,4.00,15.0
4773,tt0234393,One of the Hollywood Ten,2000,Fewer than 50,4,1,0,1,,,,1,0,1,1,,
4774,tt0061098,To Trap a Spy,1964,Fewer than 50,1,1,0,0,,,,0,0,0,0,,
4775,tt0804497,It's Kind of a Funny Story,2010,"25,000+",34202,7328,3856,2143,3.6,65.0,,139,81,58,139,6.00,58.0
4776,tt1232776,Fish Tank,2009,"10,000+",14199,4822,1269,1337,3.8,79.0,,152,138,14,152,7.60,91.0
4777,tt0139414,Lake Placid,1999,"100,000+",125944,1952,3334,2982,2.9,37.0,,96,45,51,96,5.10,47.0
4778,tt1318514,Rise of the Planet of the Apes,2011,"250,000+",449825,294551,85873,14770,4,77.0,,272,224,48,272,7.20,82.0
4779,tt0212879,Citizen Toxie: The Toxic Avenger IV,2000,"5,000+",7296,418,230,295,3.5,64.0,,10,6,4,10,5.90,60.0
4780,tt1821480,Kahaani,2012,"1,000+",1326,862,123,253,4.1,88.0,,7,7,0,7,6.90,100.0
4781,tt0435665,House of the Dead 2,2005,"10,000+",11540,168,605,427,2.3,22.0,,3,0,3,3,,
4782,tt0097534,Howling V: The Rebirth,1989,500+,979,49,132,59,2.6,27.0,,2,0,2,2,,
4783,tt1483797,Redline,2009,100+,107,94,13,46,4.3,88.0,,10,7,3,10,6.80,70.0
4784,tt0112638,Carrotblanca,1995,50+,56,15,5,4,3.9,75.0,,1,1,0,1,,
4785,tt0437863,The Benchwarmers,2006,"250,000+",422059,18382,10482,14458,3.5,64.0,,71,9,62,71,3.20,13.0
4786,tt0437863,The Benchwarmers,2006,"250,000+",422059,18382,10482,14458,3.5,64.0,,71,9,62,71,3.20,13.0
4787,tt1483797,Redline,2009,100+,107,94,13,46,4.3,88.0,,10,7,3,10,6.80,70.0
4788,tt0382932,Rottatouille,2007,"250,000+",1073590,155944,23103,79183,4.1,87.0,,253,242,11,253,8.50,96.0
4789,tt0803029,Linha de Passe,2008,500+,752,168,64,86,3.7,72.0,,22,17,5,22,6.50,77.0
4790,tt0430224,L'enfer,2005,"1,000+",1063,154,59,66,3.6,72.0,,10,7,3,10,6.00,70.0
4791,tt1095091,Dog Altogether,2007,Fewer than 50,6,2,0,0,,,,0,0,0,0,,
4792,tt0154992,Parda Hai Parda,1992,0,0,0,0,0,,,,0,0,0,0,,
4793,tt0137363,Arlington Road,1999,"25,000+",42941,3472,1214,1649,3.7,74.0,,92,58,34,92,6.10,63.0
4794,tt0493451,The Skeptic,2009,"10,000+",10250,116,314,161,2.6,27.0,,12,1,11,12,3.20,8.0
4795,tt0225566,Drohi,1992,0,0,0,0,0,,,,0,0,0,0,,
4796,tt1862079,Safety Not Guaranteed,2012,"25,000+",47081,16186,4112,2752,3.9,80.0,,155,141,14,155,7.50,91.0
4797,tt0329216,I Witness,2003,250+,493,25,53,31,2.9,32.0,,2,1,1,2,,
4798,tt2122340,Ferrari Ki Sawaari,2012,"1,000+",1925,86,70,37,3.4,55.0,,3,1,2,3,,
4799,tt0285958,Pyaar Ishq Aur Mohabbat,2001,250+,474,19,28,7,3,40.0,,0,0,0,0,,
4800,tt1333994,Fat Head,2009,500+,609,243,72,105,3.8,77.0,,0,0,0,0,,
4801,tt0107566,Mi vida loca,1993,"5,000+",8570,522,79,164,4.4,87.0,,23,17,6,23,6.40,74.0
4802,tt0756729,Year of the Dog,2007,"25,000+",41652,1270,1677,1729,3,43.0,,145,101,44,145,6.40,70.0
4803,tt0490798,When a Killer Calls,2006,250+,495,17,34,16,2.8,34.0,,1,0,1,1,,
4804,tt0339921,The Work and the Story,2003,500+,529,4,4,8,3.4,50.0,,3,1,2,3,,
4805,tt0161100,The Wood,1999,"25,000+",34785,3989,340,1115,4.5,92.0,,57,35,22,57,6.00,61.0
4806,tt0108187,Son of the Pink Panther,1993,"5,000+",5295,58,263,112,2.2,18.0,,34,2,32,34,3.40,6.0
4807,tt0340163,Hostage,2005,250+,468,22,11,12,3.4,69.0,,1,1,0,1,,
4808,tt0113752,The Man Who Wouldn't Die,1994,50+,57,4,5,1,3.2,44.0,,0,0,0,0,,
4809,tt4771828,Minister Fatakesto,2007,0,0,0,0,0,,,,0,0,0,0,,
4810,tt0109307,Blue Tiger,1994,50+,74,7,6,5,3.5,54.0,,0,0,0,0,,
4811,tt0364120,Wild Side,2004,500+,867,44,11,18,3.9,80.0,,16,10,6,16,5.90,63.0
4812,tt0113382,If Someone Had Known,1995,250+,421,18,8,10,3.8,69.0,,0,0,0,0,,
4813,tt0338249,Merci Docteur Rey,2002,500+,548,11,6,5,3.4,65.0,,22,0,22,22,3.20,0.0
4814,tt1479670,Arasu,2003,Fewer than 50,35,1,1,0,,,,0,0,0,0,,
4815,tt0235198,Audition,1999,"50,000+",56887,7974,2021,4507,3.9,80.0,,84,70,14,84,7.40,83.0
4816,tt0249478,Domestic Disturbance,2001,"25,000+",42631,739,1247,600,2.9,37.0,,99,23,76,99,4.00,23.0
4817,tt1710396,Joyful Noise,2012,"25,000+",28843,4674,2485,1029,3.7,65.0,,129,41,88,129,4.60,32.0
4818,tt0449565,"I Do, They Don't",2005,100+,193,12,13,2,3.4,48.0,,0,0,0,0,,
4819,tt0053768,Dinosaurus!,1960,250+,321,18,40,27,2.7,31.0,,6,4,2,6,5.10,67.0
4820,tt0289181,Failan,2001,"1,000+",1952,285,47,97,4.1,86.0,,3,3,0,3,,
4821,tt0801335,Coma Girl: The State of Grace,2005,0,0,0,0,0,,,,0,0,0,0,,
4822,tt0458050,Paruthiveeran,2007,100+,239,25,2,7,4.1,93.0,,1,1,0,1,,
4823,tt0094078,Surrender,1987,250+,476,15,29,10,2.8,34.0,,9,2,7,9,4.10,22.0
4824,tt0080455,The Blues Brothers,1980,"250,000+",256285,21353,1786,10438,4.4,92.0,,90,65,25,90,7.60,72.0
4825,tt0086494,Two of a Kind,1983,"5,000+",9524,115,196,135,3,37.0,,12,2,10,12,3.80,17.0
4826,tt0079221,Gol Maal,1979,500+,623,113,9,33,4.5,93.0,,1,1,0,1,,
4827,tt0265709,Scenes of the Crime,2001,250+,339,5,45,10,2.5,10.0,,6,3,3,6,5.40,50.0
4828,tt0112744,The Crossing Guard,1995,"5,000+",7526,515,462,252,3.3,53.0,,28,21,7,28,6.50,75.0
4829,tt0867404,Prajapathi,2006,0,0,0,0,0,,,,0,0,0,0,,
4830,tt0318641,The Rutles 2: Can't Buy Me Lunch,2003,"1,000+",1223,21,42,28,3,34.0,,0,0,0,0,,
4831,tt0286635,Fulltime Killer,2001,"5,000+",8240,820,249,366,3.8,77.0,,34,20,14,34,6.20,59.0
4832,tt0094588,'Gator Bait 2: Cajun Justice,1988,Fewer than 50,30,2,4,2,2.8,33.0,,0,0,0,0,,
4833,tt0114825,Vampire in Brooklyn,1995,"50,000+",51453,630,1396,764,2.7,31.0,,34,4,30,34,3.80,12.0
4834,tt0857285,Let Them Chirp Awhile,2007,100+,218,5,4,4,3.4,56.0,,8,3,5,8,4.80,38.0
4835,tt0368580,Asambhav,2004,100+,217,4,10,3,2.2,29.0,,1,0,1,1,,
4836,tt0070332,Lolly-Madonna XXX,1973,50+,88,4,9,1,3.2,31.0,,0,0,0,0,,
4837,tt0071315,Chinatown,1974,"50,000+",78347,22145,1730,5247,4.4,93.0,,79,78,1,79,9.40,99.0
4838,tt1403249,Suicide Dolls,2010,Fewer than 50,2,2,0,0,,,,0,0,0,0,,
4839,tt0102782,Return to the Blue Lagoon,1991,"10,000+",15881,594,841,344,3,41.0,,32,0,32,32,2.70,0.0
4840,tt0054346,The Stranglers of Bombay,1959,250+,305,2,24,12,2.7,8.0,,1,1,0,1,,
4841,tt0923811,Evangelion: 1.0 You Are (Not) Alone,2007,"1,000+",1759,1505,254,501,4.1,86.0,,7,5,2,7,7.00,71.0
4842,tt0186963,Dharma Yuddham,1979,0,0,0,0,0,,,,0,0,0,0,,
4843,tt0247992,Dulhan Hum Le Jayenge,2000,500+,589,36,33,13,3.2,52.0,,0,0,0,0,,
4844,tt0072362,A Very Natural Thing,1974,500+,619,13,19,12,3.1,41.0,,5,4,1,5,4.00,80.0
4845,tt0412366,Samantha: An American Girl Holiday,2004,"2,500+",3391,226,62,99,4,78.0,,1,0,1,1,,
4846,tt0101692,Death in Brunswick,1990,500+,925,54,34,34,3.7,61.0,,6,4,2,6,5.90,67.0
4847,tt0097332,Far from Home,1989,"1,000+",2091,52,75,29,3.2,40.0,,0,0,0,0,,
4848,tt1326221,Fruit Fly,2009,100+,104,16,15,12,3.3,52.0,,1,0,1,1,,
4849,tt0455528,Hell's Half Acre,2006,Fewer than 50,43,4,0,0,,,,0,0,0,0,,
4850,tt0460793,Felicity: An American Girl Adventure,2005,500+,860,134,50,54,3.9,73.0,,1,0,1,1,,
4851,tt0072791,Cleopatra Jones and the Casino of Gold,1975,50+,86,15,17,12,3.2,47.0,,4,2,2,4,,
4852,tt0065054,Sweet Charity,1969,"5,000+",5460,375,135,231,3.7,73.0,,11,9,2,11,6.40,82.0
4853,tt0114168,Powder,1995,"50,000+",51747,2344,1061,1532,3.7,69.0,,20,10,10,20,5.80,50.0
4854,tt0070687,Showdown,1973,Fewer than 50,27,6,9,3,3.2,40.0,,3,1,2,3,,
4855,tt0280427,The Anarchists,2000,50+,92,8,5,5,3.4,62.0,,0,0,0,0,,
4856,tt0476888,"Tom, Dick, and Harry",2006,100+,147,5,9,3,2.7,36.0,,0,0,0,0,,
4857,tt1314274,Hulla,2008,0,0,0,0,0,,,,0,0,0,0,,
4858,tt1303707,Ein Shams,2008,0,0,0,0,0,,,,0,0,0,0,,
4859,tt2100402,Babangluksa,2011,0,0,0,0,0,,,,0,0,0,0,,
4860,tt0411195,Breakfast on Pluto,2005,"50,000+",86017,3571,892,1735,3.9,80.0,,123,71,52,123,6.10,58.0
4861,tt1429323,BFF: Best Friends Forever,2009,50+,94,5,9,1,3.1,36.0,,0,0,0,0,,
4862,tt1365048,3-D Sex and Zen: Extreme Ecstasy,2011,500+,857,66,125,35,2.8,35.0,,24,6,18,24,4.30,25.0
4863,tt0348155,Suzie Gold,2004,"1,000+",1196,28,40,24,3.1,40.0,,7,5,2,7,5.80,71.0
4864,tt1999141,Dragon Crusaders,2011,50+,87,5,21,7,1.9,19.0,,0,0,0,0,,
4865,tt1251725,Bunny and the Bull,2009,"2,500+",3474,486,257,230,3.5,65.0,,33,22,11,33,6.00,67.0
4866,tt0373024,Imaginary Heroes,2004,"5,000+",9186,1305,307,537,4,81.0,,106,37,69,106,5.20,35.0
4867,tt0109306,Blue Sky,1994,"2,500+",3854,206,148,104,3.4,58.0,,25,20,5,25,6.40,80.0
4868,tt0320691,Underworld,2003,"250,000+",496238,50087,13565,21773,3.9,79.0,,163,51,112,163,4.70,31.0
4869,tt0103936,Chain of Desire,1992,Fewer than 50,30,3,1,1,,,,5,3,2,5,4.30,60.0
4870,tt0118150,Where's Marlowe?,1998,500+,551,10,8,6,3.5,56.0,,12,2,10,12,4.30,17.0
4871,tt1534085,Beyond the Black Rainbow,2010,"2,500+",3408,592,527,300,3.3,53.0,,37,23,14,37,6.30,62.0
4872,tt0430216,The Impossible Kid,1982,100+,199,7,6,8,3.3,54.0,,0,0,0,0,,
4873,tt0105417,Sister Act,1992,"250,000+",726517,8062,4281,10848,3.6,65.0,,28,21,7,28,5.80,75.0
4874,tt0274557,Hounded,2001,500+,546,43,54,24,3.1,44.0,,1,0,1,1,,
4875,tt0091647,Nomads,1986,"1,000+",1707,82,138,64,2.9,37.0,,13,4,9,13,4.50,31.0
4876,tt0071411,Dersu Uzala,1975,"5,000+",7688,1622,105,386,4.4,94.0,,15,11,4,15,7.50,73.0
4877,tt0088395,Where the Boys Are,1984,250+,299,15,36,20,2.6,29.0,,2,0,2,2,,
4878,tt0079749,Alibaba Aur 40 Chor,1980,50+,70,2,0,0,,,,0,0,0,0,,
4879,tt1465493,Hum Tum Aur Ghost,2010,50+,61,5,12,3,2.5,29.0,,1,0,1,1,,
4880,tt0215907,Kitaab,1977,Fewer than 50,40,3,2,1,3.7,60.0,,0,0,0,0,,
4881,tt0077630,Grayeagle,1977,100+,187,13,6,10,3.5,68.0,,1,0,1,1,,
4882,tt0374900,Napoleon Dynamite,2004,"250,000+",790244,56396,19840,51152,3.7,74.0,,175,126,49,175,6.40,72.0
4883,tt0332436,Behind the Camera: The Unauthorized Story of 'Three's Company',2003,0,0,0,0,0,,,,0,0,0,0,,
4884,tt1327833,Sorry Bhai!,2008,250+,286,28,40,38,3.1,41.0,,1,1,0,1,,
4885,tt0126234,Chamatkar,1992,500+,842,33,48,14,3,41.0,,0,0,0,0,,
4886,tt0455385,Chakram,2005,50+,67,8,4,1,3.9,67.0,,0,0,0,0,,
4887,tt0101550,Cast a Deadly Spell,1991,500+,911,90,66,62,3.3,58.0,,1,0,1,1,,
4888,tt1826051,Yeh Dooriyan,2011,0,0,0,0,0,,,,0,0,0,0,,
4889,tt0084780,Tesna koza,1982,0,0,0,0,0,,,,0,0,0,0,,
4890,tt0840304,Ice Spiders,2007,"1,000+",1324,55,259,166,2,18.0,,3,3,0,3,,
4891,tt0431308,P.S. I Love You,2007,"250,000+",254304,50979,13139,26489,4,80.0,,105,26,79,105,4.50,25.0
4892,tt0431308,P.S. I Love You,2007,"250,000+",254304,50979,13139,26489,4,80.0,,105,26,79,105,4.50,25.0
4893,tt0117397,Project: ALF,1996,500+,842,99,73,64,3.5,58.0,,1,1,0,1,,
4894,tt0116410,Ghosts of Mississippi,1996,"5,000+",8691,590,362,236,3.5,62.0,,30,13,17,30,5.70,43.0
4895,tt0109773,Fast Getaway II,1994,500+,796,22,38,18,3.1,37.0,,0,0,0,0,,
4896,tt0180037,Paperback Hero,1999,"1,000+",2451,104,65,79,3.6,62.0,,0,0,0,0,,
4897,tt0116996,Mars Attacks!,1996,"250,000+",436783,11973,10660,11326,3.3,53.0,,86,48,38,86,6.00,56.0
4898,tt0140642,Two a Penny,1967,Fewer than 50,2,0,1,0,,,,1,0,1,1,,
4899,tt0120633,A Civil Action,1998,"10,000+",21498,1064,857,447,3.4,55.0,,71,45,26,71,6.30,63.0
4900,tt2778412,Naanayam,2010,0,0,0,0,0,,,,0,0,0,0,,
4901,tt0347473,Main Hoon Na,2004,"10,000+",15212,1339,308,591,4.1,81.0,,4,4,0,4,,
4902,tt1994577,The Pastor's Wife,2011,Fewer than 50,23,6,14,4,2.5,30.0,,0,0,0,0,,
4903,tt0419373,Supernova,2005,250+,455,19,68,32,2.3,22.0,,0,0,0,0,,
4904,tt0181288,American Movie,1999,"10,000+",12519,2284,243,998,4.3,90.0,,49,46,3,49,8.30,94.0
4905,tt1313244,Hypothermia,2010,100+,150,11,111,43,1.9,9.0,,1,0,1,1,,
4906,tt0120786,The Patriot,1998,"250,000+",423525,36207,8302,15661,4,81.0,,138,85,53,138,6.10,62.0
4907,tt6754698,Swarnamukhi,1998,0,0,0,0,0,,,,0,0,0,0,,
4908,tt1764651,The Expendables 2,2012,"250,000+",315609,50554,25292,7734,3.7,67.0,,135,90,45,135,5.90,67.0
4909,tt0120786,The Patriot,1998,"250,000+",423525,36207,8302,15661,4,81.0,,138,85,53,138,6.10,62.0
4910,tt1134854,Survival of the Dead,2009,"5,000+",7981,519,2137,1059,2.4,20.0,,92,27,65,92,4.80,29.0
4911,tt0307541,Takkari Donga,2002,0,0,0,0,0,,,,0,0,0,0,,
4912,tt1499658,Horrible Bosses,2011,"100,000+",106962,40739,17479,9279,3.7,70.0,,224,154,70,224,6.30,69.0
4913,tt0070511,Papillon,1973,"25,000+",48813,6057,659,1633,4.2,90.0,,32,23,9,32,7.70,72.0
4914,tt0060476,The Great St. Trinian's Train Robbery,1966,"1,000+",1348,45,32,21,3.6,58.0,,0,0,0,0,,
4915,tt1083456,Fired Up!,2009,"100,000+",174696,3042,2848,2671,3.3,52.0,,106,26,80,106,4.10,25.0
4916,tt1083456,Fired Up!,2009,"100,000+",174696,3042,2848,2671,3.3,52.0,,106,26,80,106,4.10,25.0
4917,tt0102492,My Girl,1991,"250,000+",394821,9451,2772,11101,4,77.0,,16,8,8,16,5.50,50.0
4918,tt0110932,Quiz Show,1994,"25,000+",31681,4204,645,1053,4,87.0,,59,57,2,59,8.20,97.0
4919,tt0111488,Trial by Jury,1994,"1,000+",1148,15,37,7,2.7,29.0,,13,1,12,13,3.50,8.0
4920,tt0289879,The Butterfly Effect,2004,"250,000+",623740,62399,14908,27996,4,81.0,,172,58,114,172,4.80,34.0
4921,tt0085412,Deal of the Century,1983,500+,538,25,111,28,2.5,19.0,,10,1,9,10,4.10,10.0
4922,tt0289879,The Butterfly Effect,2004,"250,000+",623740,62399,14908,27996,4,81.0,,172,58,114,172,4.80,34.0
4923,tt0289879,The Butterfly Effect,2004,"250,000+",623740,62399,14908,27996,4,81.0,,172,58,114,172,4.80,34.0
4924,tt1967688,Desperately Seeking Santa,2011,50+,84,31,27,7,3.4,53.0,,0,0,0,0,,
4925,tt0310154,In This World,2002,"2,500+",3138,349,49,117,4.1,88.0,,63,56,7,63,7.50,89.0
4926,tt0059260,Help!,1965,"25,000+",28134,3267,521,1533,4.2,86.0,,28,24,4,28,7.20,86.0
4927,tt1886493,Catch .44,2011,"1,000+",1593,152,945,240,2.1,14.0,,3,0,3,3,,
4928,tt0458449,The Other Half,2006,100+,164,6,27,9,2.4,18.0,,0,0,0,0,,
4929,tt0077783,Junoon,1979,250+,301,26,4,8,4.2,87.0,,1,1,0,1,,
4930,tt0400611,Love Chronicles,2003,500+,873,9,12,2,3.1,43.0,,1,0,1,1,,
4931,tt0235164,Adventures in Babysitting,1989,"100,000+",110681,4557,1938,2701,3.7,70.0,,45,32,13,45,6.50,71.0
4932,tt0454429,Chingaari,2006,250+,289,9,6,9,3.6,60.0,,0,0,0,0,,
4933,tt2172071,Student of the Year,2012,"1,000+",2458,271,282,106,3.2,49.0,,6,3,3,6,5.30,50.0
4934,tt1060277,Cloverfield,2008,"250,000+",420779,78947,36744,59497,3.6,68.0,,217,170,47,217,6.80,78.0
4935,tt0117692,Sometimes They Come Back... Again,1996,"1,000+",1131,53,101,38,2.7,35.0,,4,0,4,4,,
4936,tt1703199,Grave Encounters,2011,"5,000+",5583,1702,1784,905,3.2,49.0,,17,11,6,17,5.50,65.0
4937,tt0157472,Clockstoppers,2002,"50,000+",58128,528,1216,745,2.7,30.0,,86,25,61,86,4.80,29.0
4938,tt0098343,Skin Deep,1989,"2,500+",2823,111,86,83,3.6,56.0,,28,9,19,28,5.10,32.0
4939,tt1876547,Zombie Apocalypse,2011,250+,423,55,267,113,2.1,17.0,,3,1,2,3,,
4940,tt0165499,The Storm Riders,1998,"5,000+",6616,387,201,205,3.6,66.0,,5,5,0,5,7.50,100.0
4941,tt0083096,Smash Palace,1981,500+,658,48,11,33,3.9,81.0,,7,7,0,7,8.60,100.0
4942,tt0092972,Epidemic,1987,"2,500+",3527,227,189,91,3.3,54.0,,8,2,6,8,5.30,25.0
4943,tt0298744,Auto Focus,2002,"5,000+",6027,552,352,288,3.4,61.0,,163,116,47,163,6.70,71.0
4944,tt5554958,The Pagemaster,1994,"50,000+",50752,2214,2344,1606,3.2,49.0,,19,4,15,19,4.40,21.0
4945,tt0388182,King of California,2007,"10,000+",16558,2675,1477,1834,3.5,64.0,,67,42,25,67,6.20,63.0
4946,tt1787777,Page One: Inside the New York Times,2011,"1,000+",2244,605,197,215,3.7,75.0,,111,87,24,111,6.80,78.0
4947,tt0940580,Afterwards,2008,"1,000+",1153,126,206,105,2.9,38.0,,1,0,1,1,,
4948,tt0104235,Fatal Deception: Mrs. Lee Harvey Oswald,1993,0,0,0,0,0,,,,0,0,0,0,,
4949,tt0105462,Stalin,1992,250+,352,56,22,15,3.7,72.0,,4,4,0,4,,
4950,tt0287733,Straight Into Darkness,2004,250+,338,25,40,25,2.8,38.0,,7,4,3,7,6.50,57.0
4951,tt0076731,Snowbeast,1977,250+,409,29,93,73,2.5,24.0,,0,0,0,0,,
4952,tt0273517,Darkness,2002,"25,000+",28908,534,1210,811,2.5,31.0,,57,3,54,57,3.00,5.0
4953,tt0183288,Halloween Is Grinch Night,1977,250+,334,33,26,11,3.4,56.0,,0,0,0,0,,
4954,tt0099138,The Big Steal,1990,100+,144,33,11,14,3.8,75.0,,0,0,0,0,,
4955,tt0478984,The Book of Caleb,2008,100+,131,9,3,3,4,75.0,,0,0,0,0,,
4956,tt0377092,Mean Girls,2004,"250,000+",32167706,99348,50787,1243725,3,66.0,,193,163,30,193,7.00,84.0
4957,tt1320431,Mail Order Bride,2008,100+,198,12,23,12,2.9,34.0,,0,0,0,0,,
4958,tt0346507,Andaaz,2003,250+,355,13,32,7,2.9,30.0,,0,0,0,0,,
4959,tt0136244,Hideous Kinky,1998,"5,000+",7811,455,302,240,3.5,60.0,,53,35,18,53,6.10,66.0
4960,tt0328077,Love Object,2003,"2,500+",3484,218,161,183,3.3,57.0,,24,9,15,24,4.80,38.0
4961,tt0847889,Narasimhudu,2005,0,0,0,0,0,,,,0,0,0,0,,
4962,tt0091969,Slaughter High,1986,"2,500+",2579,127,248,185,2.9,34.0,,5,0,5,5,3.70,0.0
4963,tt0434139,The Last Kiss,2006,"50,000+",96851,9384,6484,6882,3.4,59.0,,134,62,72,134,5.70,46.0
4964,tt0117373,Precious Find,1996,100+,131,1,11,2,1.7,8.0,,1,0,1,1,,
4965,tt1477675,Blood Out,2011,500+,593,58,226,82,2.4,20.0,,2,0,2,2,,
4966,tt0303353,The Kid Stays in the Picture,2002,"2,500+",4720,595,148,279,3.9,80.0,,113,103,10,113,7.70,91.0
4967,tt1226681,Pontypool,2008,"5,000+",7601,2276,1057,1093,3.6,68.0,,86,72,14,86,6.60,84.0
4968,tt0425295,Niagara Motel,2005,500+,574,25,47,25,2.8,35.0,,14,5,9,14,5.00,36.0
4969,tt1487118,Chalet Girl,2011,"5,000+",8448,1122,998,303,3.3,53.0,,43,33,10,43,5.80,77.0
4970,tt0094794,The Brain,1988,500+,598,31,57,37,2.8,36.0,,4,2,2,4,,
4971,tt0080913,The Idolmaker,1980,"1,000+",1026,74,14,46,4.1,84.0,,10,9,1,10,6.30,90.0
4972,tt0104802,The Mambo Kings,1992,"5,000+",6131,273,125,118,3.8,69.0,,29,23,6,29,6.60,79.0
4973,tt0469937,Like Mike 2: Streetball,2006,"5,000+",8311,317,197,161,3.6,62.0,,2,1,1,2,,
4974,tt0054453,The Wackiest Ship in the Army,1960,"1,000+",1347,35,45,36,3.1,44.0,,4,1,3,4,,
4975,tt0457308,Come Early Morning,2006,"2,500+",4746,244,252,250,3.2,49.0,,49,41,8,49,6.60,84.0
4976,tt0278823,Hollywood Ending,2002,"10,000+",10519,983,1035,380,3.2,49.0,,133,62,71,133,5.40,47.0
4977,tt0914372,Hallowed Ground,2007,500+,594,41,100,72,2.6,29.0,,1,0,1,1,,
4978,tt0054777,The Curse of the Werewolf,1961,"1,000+",1919,191,140,125,3.4,58.0,,5,3,2,5,5.60,60.0
4979,tt1210817,Kotha Bangaru Lokam,2008,50+,65,7,4,1,3.2,64.0,,0,0,0,0,,
4980,tt0330082,Boom,2003,500+,848,9,31,17,2.1,22.0,,0,0,0,0,,
4981,tt0080166,Knockabout,1979,"1,000+",1398,76,8,38,4.2,90.0,,1,1,0,1,,
4982,tt0086122,The Ploughman's Lunch,1983,50+,71,7,10,4,2.9,41.0,,3,2,1,3,,
4983,tt0118966,Desperate Measures,1998,"10,000+",12170,346,583,223,3,37.0,,31,6,25,31,4.30,19.0
4984,tt0436302,Fellowship of the Dice,2005,0,0,0,0,0,,,,0,0,0,0,,
4985,tt0457502,Through the Fire,2005,"50,000+",84365,199,65,132,4,76.0,,32,22,10,32,6.50,69.0
4986,tt1684555,Horrid Henry: The Movie,2011,"2,500+",3565,195,294,146,2.8,40.0,,22,2,20,22,3.60,9.0
4987,tt0077409,Death Drug,1978,Fewer than 50,13,1,2,2,,,,0,0,0,0,,
4988,tt1059793,Garfield Gets Real,2007,"1,000+",1269,110,195,127,2.8,36.0,,2,1,1,2,,
4989,tt0160484,Lost Souls,2000,"10,000+",10752,158,560,218,2.5,22.0,,93,7,86,93,3.20,8.0
4990,tt0470995,Danny Roane: First Time Director,2006,500+,996,23,60,46,2.6,28.0,,2,1,1,2,,
4991,tt0110399,A Low Down Dirty Shame,1994,"25,000+",29810,603,259,308,3.8,70.0,,23,1,22,23,3.80,4.0
4992,tt1046947,Last Chance Harvey,2008,"25,000+",27809,2483,2175,2053,3.3,53.0,,156,111,45,156,6.20,71.0
4993,tt1114733,Bharya Swantham Suhruthu,2009,Fewer than 50,22,0,1,0,,,,0,0,0,0,,
4994,tt0095802,Out of Time,1988,0,0,0,0,0,,,,0,0,0,0,,
4995,tt0091993,SpaceCamp,1986,"10,000+",14651,515,509,416,3.3,50.0,,13,6,7,13,5.10,46.0
4996,tt0386032,Sicko,2007,"250,000+",250800,31378,4800,20007,4.1,87.0,,218,199,19,218,7.70,91.0
4997,tt0085811,Krull,1983,"25,000+",29969,1337,1252,1123,3.3,52.0,,26,9,17,26,4.40,35.0
4998,tt0221218,The Glass House,2001,"50,000+",58270,1359,2131,1091,3,39.0,,87,19,68,87,4.30,22.0
4999,tt0084489,Personal Best,1982,"1,000+",1273,71,65,49,3.3,52.0,,33,24,9,33,6.50,73.0
5000,tt0155855,Manthrigari Viyyankudu,1983,0,0,0,0,0,,,,0,0,0,0,,
5001,tt0105151,The Player,1992,"10,000+",20712,3372,626,901,4,84.0,,68,66,2,68,8.70,97.0
5002,tt0773318,Déficit,2007,500+,731,35,151,73,2.4,18.0,,0,0,0,0,,
5003,tt0056211,The Magic Sword,1962,"1,000+",1373,31,82,60,2.6,27.0,,7,2,5,7,4.80,29.0
5004,tt0079710,A Perfect Couple,1979,100+,238,15,14,8,3.3,52.0,,4,2,2,4,,
5005,tt1090360,Welcome to the Jungle,2007,"1,000+",1795,95,258,179,2.3,27.0,,2,2,0,2,,
5006,tt0248227,Needhikku Thalai Vanangu,1976,0,0,0,0,0,,,,0,0,0,0,,
5007,tt0085679,High School U.S.A.,1983,"1,000+",1301,38,59,28,3.1,39.0,,0,0,0,0,,
5008,tt1189340,The Lincoln Lawyer,2011,"50,000+",69013,22407,5059,5266,3.9,82.0,,177,148,29,177,6.70,84.0
5009,tt0283897,Assassination Tango,2002,"1,000+",2193,62,128,63,2.8,33.0,,89,42,47,89,5.60,47.0
5010,tt1091229,Chandni Chowk to China,2009,"5,000+",9172,203,457,299,2.6,31.0,,59,25,34,59,5.20,42.0
5011,tt0429068,The Second Chance,2006,"50,000+",79543,400,112,282,4,78.0,,16,7,9,16,5.20,44.0
5012,tt0067176,Hands of the Ripper,1971,100+,155,41,44,32,3.2,48.0,,8,7,1,8,7.00,88.0
5013,tt0439464,Bewafa Sanam,1995,0,0,0,0,0,,,,0,0,0,0,,
5014,tt1510909,Stonerville,2011,Fewer than 50,3,0,3,0,,,,0,0,0,0,,
5015,tt0445939,The Burrowers,2008,"10,000+",10885,307,594,433,2.9,34.0,,11,8,3,11,5.80,73.0
5016,tt0282771,The Mystic Masseur,2001,100+,117,5,15,9,2.7,25.0,,65,33,32,65,5.80,51.0
5017,tt8929664,Bommalattam,2008,0,0,0,0,0,,,,0,0,0,0,,
5018,tt0093777,Prince of Darkness,1987,"10,000+",14041,1488,950,822,3.5,61.0,,39,24,15,39,6.20,62.0
5019,tt0172345,Don't Look Down,1998,"1,000+",1651,10,37,31,2.4,21.0,,2,0,2,2,,
5020,tt0301357,Good Bye Lenin!,2003,"50,000+",55960,12404,1006,2988,4.2,92.0,,110,100,10,110,7.50,91.0
5021,tt1784589,Players,2012,"1,000+",1969,40,142,43,2.3,22.0,,7,3,4,7,5.70,43.0
5022,tt0385278,She's Too Young,2004,"2,500+",2512,239,105,125,3.8,69.0,,0,0,0,0,,
5023,tt0146232,Replacing Dad,1999,0,0,0,0,0,,,,0,0,0,0,,
5024,tt0165859,Liberty Heights,1999,"5,000+",5515,432,134,172,3.7,76.0,,49,42,7,49,7.30,86.0
5025,tt0319690,Kizhakku Vasal,1990,Fewer than 50,1,1,0,0,,,,0,0,0,0,,
5026,tt0156166,Vedam Puthithu,1987,0,0,0,0,0,,,,0,0,0,0,,
5027,tt0339343,The Man Who Saved Christmas,2002,100+,113,14,15,8,3.4,48.0,,0,0,0,0,,
5028,tt1486193,5 Days of War,2011,"2,500+",2524,296,526,165,2.7,36.0,,34,12,22,34,4.60,35.0
5029,tt0092048,Tanpopo,1985,"5,000+",9275,2056,148,720,4.4,93.0,,57,57,0,57,8.50,100.0
5030,tt1376168,Comedown,2012,100+,106,13,67,24,2.2,16.0,,0,0,0,0,,
5031,tt0089887,A Reason to Live,1985,Fewer than 50,3,0,2,0,,,,0,0,0,0,,
5032,tt0463998,Freedom Writers,2007,"250,000+",293605,28172,4239,14592,4.2,87.0,,126,88,38,126,6.30,70.0
5033,tt0080482,Bye Bye Brasil,1980,500+,676,72,26,24,3.7,73.0,,2,2,0,2,,
5034,tt0067341,Let's Scare Jessica to Death,1971,"1,000+",2428,272,276,227,3.2,50.0,,11,4,7,11,4.80,36.0
5035,tt0053865,Girl of the Night,1960,Fewer than 50,1,1,0,1,,,,0,0,0,0,,
5036,tt0118571,Air Force One,1997,"250,000+",379133,10366,5259,8188,3.6,66.0,,65,51,14,65,7.10,78.0
5037,tt0105466,Stay Tuned,1992,"5,000+",8255,411,332,314,3.4,55.0,,17,8,9,17,4.60,47.0
5038,tt0077807,King of the Gypsies,1978,500+,648,31,18,11,3.5,63.0,,8,6,2,8,6.30,75.0
5039,tt1687901,The Awakening,2011,0,0,0,0,0,,,,0,0,0,0,,
5040,tt1401236,The Fields,2011,250+,321,43,114,55,2.4,27.0,,5,3,2,5,5.70,60.0
5041,tt0490196,Phat Girlz,2006,"50,000+",67244,1039,567,1116,3.7,65.0,,47,10,37,47,3.80,21.0
5042,tt0069792,Black Caesar,1973,"2,500+",3054,172,100,109,3.6,63.0,,14,9,5,14,5.90,64.0
5043,tt0105631,Traces of Red,1992,"1,000+",1040,18,25,16,3.1,42.0,,7,2,5,7,4.50,29.0
5044,tt0422029,Crutch,2004,250+,438,5,15,10,2.7,25.0,,2,1,1,2,,
5045,tt1680310,Harry Potter and the Deathly Hallows - Part 2,2011,"250,000+",393569,153810,18301,19733,4.4,89.0,,332,319,13,332,8.30,96.0
5046,tt1139789,Elle veut le chaos,2008,50+,66,2,5,1,3.1,29.0,,1,1,0,1,,
5047,tt0081554,Stardust Memories,1980,"5,000+",9090,1560,435,504,3.9,78.0,,32,21,11,32,6.60,66.0
5048,tt1548628,Scream of the Banshee,2011,"1,000+",1051,29,177,63,2,14.0,,1,0,1,1,,
5049,tt0490117,Dreams on Spec,2007,100+,120,20,8,11,3.5,71.0,,0,0,0,0,,
5050,tt0080040,Tourist Trap,1979,"2,500+",2893,262,291,246,3.2,47.0,,5,2,3,5,6.40,40.0
5051,tt0093006,Family Viewing,1987,250+,293,24,17,12,3.5,59.0,,4,3,1,4,,
5052,tt0056659,Village of Daughters,1962,0,0,0,0,0,,,,0,0,0,0,,
5053,tt1603794,Avakai Biryani,2008,0,0,0,0,0,,,,0,0,0,0,,
5054,tt0260878,Emotional Backgammon,2003,0,0,0,0,0,,,,0,0,0,0,,
5055,tt0483726,Man of the Year,2006,"100,000+",203506,4128,5036,6120,3.1,45.0,,145,31,114,145,4.40,21.0
5056,tt0095334,Howling IV: The Original Nightmare,1988,"5,000+",6237,34,189,101,2.1,15.0,,2,0,2,2,,
5057,tt0377057,Elvis Has Left the Building,2004,"1,000+",1040,56,96,33,2.8,37.0,,3,0,3,3,,
5058,tt0785035,Ong Bak 2,2008,"10,000+",21212,1541,1365,1136,3.3,53.0,,70,34,36,70,5.40,49.0
5059,tt0106579,"Clean, Shaven",1993,"2,500+",2695,439,90,199,3.8,83.0,,11,10,1,11,7.80,91.0
5060,tt0090948,The Dirt Bike Kid,1985,"1,000+",1353,94,67,57,3.5,58.0,,3,1,2,3,,
5061,tt0785035,Ong Bak 2,2008,"10,000+",21212,1541,1365,1136,3.3,53.0,,70,34,36,70,5.40,49.0
5062,tt0120179,Speed 2: Cruise Control,1997,"100,000+",222118,1292,6850,4357,2.1,16.0,,76,3,73,76,3.60,4.0
5063,tt1511489,The Sentimental Engine Slayer,2010,50+,54,16,2,4,4.2,89.0,,0,0,0,0,,
5064,tt0272736,Mujhse Dosti Karoge!,2002,"5,000+",7273,443,142,194,3.9,76.0,,2,1,1,2,,
5065,tt0278488,How High,2001,"50,000+",67169,8811,2387,2947,4.1,79.0,,59,15,44,59,3.90,25.0
5066,tt0380817,Winter Passing,2005,"50,000+",81860,1314,828,940,3.5,61.0,,52,21,31,52,5.30,40.0
5067,tt0100486,Reversal of Fortune,1990,"5,000+",5494,717,205,228,3.8,78.0,,53,49,4,53,7.90,92.0
5068,tt0320114,Naan Mahaan Alla,1984,0,0,0,0,0,,,,0,0,0,0,,
5069,tt1000768,Pilgrim's Progress,2008,Fewer than 50,2,2,0,1,,,,0,0,0,0,,
5070,tt1202203,Pray the Devil Back to Hell,2008,"1,000+",1220,113,18,40,4,86.0,,36,36,0,36,7.80,100.0
5071,tt0093578,Mr. India,1987,"2,500+",2721,213,40,81,4.1,84.0,,1,1,0,1,,
5072,tt0106257,American Ninja 5,1993,"5,000+",7174,31,93,39,2.3,25.0,,0,0,0,0,,
5073,tt0928026,Care Bears Nutcracker Suite,1988,Fewer than 50,5,3,2,3,2.9,60.0,,0,0,0,0,,
5074,tt0102227,Knight Rider 2000,1991,"1,000+",1041,68,94,60,3,42.0,,1,0,1,1,,
5075,tt0220627,Maelström,2000,"1,000+",2265,277,89,97,3.8,76.0,,38,30,8,38,6.70,79.0
5076,tt0087062,City Heat,1984,"5,000+",6177,114,362,140,2.7,24.0,,18,4,14,18,4.00,22.0
5077,tt0102217,The King of the Kickboxers,1990,500+,789,58,43,52,3.6,58.0,,0,0,0,0,,
5078,tt0082200,Continental Divide,1981,"2,500+",2584,133,114,67,3.3,54.0,,11,8,3,11,6.20,73.0
5079,tt0084756,Tag: The Assassination Game,1982,0,0,0,0,0,,,,1,1,0,1,,
5080,tt1068242,Footloose,2011,"50,000+",68823,9914,6392,2500,3.5,61.0,,173,118,55,173,6.00,68.0
5081,tt0062426,Up the Junction,1968,500+,511,54,13,21,4,81.0,,2,1,1,2,,
5082,tt1307456,Natalee Holloway,2009,100+,233,25,55,20,2.8,31.0,,0,0,0,0,,
5083,tt1342409,Parameshi Prema Prasanga,1985,0,0,0,0,0,,,,0,0,0,0,,
5084,tt0245829,Chantabbai,1986,0,0,0,0,0,,,,0,0,0,0,,
5085,tt1206082,The Dead Outside,2008,100+,193,14,70,32,2,17.0,,1,0,1,1,,
5086,tt0082378,Final Exam,1981,250+,380,29,134,62,2.4,18.0,,8,1,7,8,4.00,13.0
5087,tt0101489,Blue Tornado,1991,Fewer than 50,49,1,4,1,2.5,20.0,,0,0,0,0,,
5088,tt0945571,Lifted,2006,"1,000+",2246,524,66,153,4.2,89.0,,1,1,0,1,,
5089,tt0060306,Devar,1966,0,0,0,0,0,,,,0,0,0,0,,
5090,tt0377062,Flight of the Phoenix,2004,"50,000+",59233,1498,2252,1453,3,40.0,,120,37,83,120,4.80,31.0
5091,tt0195165,Possessed,2000,0,0,0,0,0,,,,0,0,0,0,,
5092,tt0160395,An Ideal Husband,1999,"10,000+",11030,1019,453,390,3.7,69.0,,67,57,10,67,7.30,85.0
5093,tt0763850,Rough Cut,2009,100+,197,60,19,20,3.7,76.0,,0,0,0,0,,
5094,tt1651062,Christopher and His Kind,2011,250+,435,173,90,54,3.7,66.0,,2,2,0,2,,
5095,tt1890559,The Callback Queen,2013,Fewer than 50,12,1,2,1,,,,1,0,1,1,,
5096,tt0475382,The Scorned,2005,500+,690,1,26,20,2,4.0,,1,0,1,1,,
5097,tt1248971,Cherrybomb,2009,"1,000+",2355,297,379,124,3.1,44.0,,12,5,7,12,4.70,42.0
5098,tt0105789,The Waterdance,1992,"1,000+",1472,67,39,26,3.5,63.0,,17,16,1,17,7.30,94.0
5099,tt0107692,Ninja Scroll,1993,"50,000+",55029,5984,706,2212,4.2,89.0,,18,16,2,18,7.40,89.0
5100,tt0317740,The Italian Job,2003,"250,000+",567948,46358,11952,19165,3.9,80.0,,181,130,51,181,6.40,72.0
5101,tt1529559,Hotel Lux,2011,Fewer than 50,34,8,14,2,3.1,36.0,,0,0,0,0,,
5102,tt1409078,Biyer Lagna,2008,0,0,0,0,0,,,,0,0,0,0,,
5103,tt0186549,The Simian Line,2000,100+,141,20,8,4,4.1,71.0,,18,4,14,18,3.80,22.0
5104,tt0060863,Promise Her Anything,1966,Fewer than 50,43,5,13,9,2.6,28.0,,2,0,2,2,,
5105,tt0116675,Jaded,1998,"1,000+",1022,7,18,9,3,28.0,,1,0,1,1,,
5106,tt0074851,The Man Who Fell to Earth,1976,"10,000+",12939,1861,846,970,3.6,69.0,,70,56,14,70,7.80,80.0
5107,tt0330793,The Punisher,2004,"250,000+",268549,13705,8026,9850,3.5,63.0,,172,50,122,172,4.60,29.0
5108,tt0101889,The Fisher King,1991,"25,000+",45912,6256,1060,1826,4,85.0,,65,55,10,65,7.10,85.0
5109,tt0282687,Life or Something Like It,2002,"25,000+",44528,1213,1555,858,3.1,44.0,,121,33,88,121,4.50,27.0
5110,tt0112492,Beware: Children at Play,1989,500+,931,24,75,59,2.5,24.0,,0,0,0,0,,
5111,tt0235048,Wicked Spring,2002,"1,000+",1047,15,12,11,3,56.0,,0,0,0,0,,
5112,tt1988774,Salt n' Pepper,2011,Fewer than 50,28,12,5,5,3.8,71.0,,0,0,0,0,,
5113,tt1092541,"Mom, Dad and Her",2008,50+,69,17,7,4,3.6,71.0,,0,0,0,0,,
5114,tt0206226,Psycho Beach Party,2000,"5,000+",8613,662,337,336,3.6,66.0,,35,19,16,35,5.90,54.0
5115,tt0087265,The Flamingo Kid,1984,"5,000+",5516,171,139,78,3.4,55.0,,20,17,3,20,6.80,85.0
5116,tt1381418,You May Not Kiss the Bride,2011,500+,679,110,219,54,2.7,33.0,,9,0,9,9,3.50,0.0
5117,tt0065161,La vacanza,1971,0,0,0,0,0,,,,0,0,0,0,,
5118,tt0468520,Nice Guys,2006,100+,247,10,30,18,2.7,25.0,,0,0,0,0,,
5119,tt1124401,True Confessions of a Hollywood Starlet,2008,"1,000+",2235,121,100,58,3.3,55.0,,1,0,1,1,,
5120,tt1405520,Shibaji,2008,0,0,0,0,0,,,,0,0,0,0,,
5121,tt0496301,For the Love of Dolly,2006,250+,406,9,4,7,3.6,69.0,,1,1,0,1,,
5122,tt0062345,A Taste of Blood,1967,100+,109,10,15,10,2.7,40.0,,1,0,1,1,,
5123,tt0076827,The Sentimental Swordsman,1977,0,0,0,0,0,,,,0,0,0,0,,
5124,tt0118301,Dead Man on Campus,1998,"25,000+",45740,1030,856,865,3.4,55.0,,47,7,40,47,3.80,15.0
5125,tt0207002,Paradise Grove,2003,0,0,0,0,0,,,,0,0,0,0,,
5126,tt0465580,Push,2009,"250,000+",2026579,11366,15469,11682,3.1,42.0,,127,30,97,127,4.30,24.0
5127,tt3171844,Ullasa Uthsaha,2010,Fewer than 50,1,1,0,0,,,,0,0,0,0,,
5128,tt0100500,Riverbend,1989,Fewer than 50,30,0,1,1,,,,0,0,0,0,,
5129,tt0063136,Interlude,1968,0,0,0,0,0,,,,0,0,0,0,,
5130,tt0446701,Gisaku,2005,250+,255,3,11,4,2.6,21.0,,0,0,0,0,,
5131,tt0790712,The Messenger,2009,"10,000+",21624,4199,1396,1586,3.7,75.0,,162,145,17,162,7.50,90.0
5132,tt0790712,The Messenger,2009,"10,000+",21624,4199,1396,1586,3.7,75.0,,162,145,17,162,7.50,90.0
5133,tt0071756,Lifespan,1975,50+,67,3,2,4,3,60.0,,0,0,0,0,,
5134,tt1051981,Another Gay Sequel: Gays Gone Wild!,2008,"1,000+",1590,104,200,138,2.7,34.0,,22,5,17,22,3.80,23.0
5135,tt0099329,Cry-Baby,1990,"100,000+",211545,15159,4489,8478,4,77.0,,58,42,16,58,6.60,72.0
5136,tt0102536,Night on Earth,1991,"10,000+",20630,4017,412,944,4.2,91.0,,25,19,6,25,6.40,76.0
5137,tt0109683,God of Gamblers Return,1994,"2,500+",3387,190,98,50,3.6,66.0,,0,0,0,0,,
5138,tt0105793,Wayne's World,1992,"250,000+",462188,28646,5277,14319,4.1,84.0,,97,77,20,97,6.70,79.0
5139,tt0443473,The Condemned,2007,Fewer than 50,19,3,4,1,3.1,43.0,,0,0,0,0,,
5140,tt0267891,The Ringer,2005,"250,000+",398226,9748,4664,11877,3.7,68.0,,89,36,53,89,5.00,40.0
5141,tt0096142,Sorority Babes in the Slimeball Bowl-O-Rama,1988,"1,000+",1412,68,113,70,2.8,37.0,,2,2,0,2,,
5142,tt0997152,The Experiment,2010,0,0,0,0,0,,,,0,0,0,0,,
5143,tt0083726,The Challenge,1982,250+,322,38,16,20,3.7,70.0,,17,9,8,17,5.30,53.0
5144,tt2391706,Thappana,2012,Fewer than 50,16,0,3,0,,,,0,0,0,0,,
5145,tt1504467,Puppet Master: Axis of Evil,2010,250+,290,27,106,57,2.4,20.0,,1,0,1,1,,
5146,tt0192111,Head Over Heels,2001,"25,000+",47033,1195,933,1001,3.4,56.0,,89,9,80,89,3.40,10.0
5147,tt0083726,The Challenge,1982,250+,322,38,16,20,3.7,70.0,,17,9,8,17,5.30,53.0
5148,tt0478188,King of the Lost World,2004,250+,494,7,46,33,1.6,12.0,,2,0,2,2,,
5149,tt0393452,Manassinakkare,2003,0,0,0,0,0,,,,0,0,0,0,,
5150,tt0455782,The Hunting Party,2007,"25,000+",39955,2656,1328,1644,3.5,67.0,,93,51,42,93,6.00,55.0
5151,tt1209378,ExTerminators,2009,500+,524,44,150,50,2.6,23.0,,1,0,1,1,,
5152,tt0098112,Powwow Highway,1988,Fewer than 50,3,2,1,1,,,,0,0,0,0,,
5153,tt0414982,Final Destination 3,2006,"250,000+",538923,14430,10964,20368,3.4,57.0,,116,50,66,116,5.10,43.0
5154,tt0105526,The Taking of Beverly Hills,1991,100+,174,15,27,12,2.8,36.0,,5,2,3,5,4.00,40.0
5155,tt0074958,Network,1976,"25,000+",36527,8996,676,3222,4.4,93.0,,75,69,6,75,8.50,92.0
5156,tt2200860,Born to Love You,2012,0,0,0,0,0,,,,0,0,0,0,,
5157,tt0122143,The Last Broadcast,1998,"1,000+",2291,147,228,152,2.9,39.0,,18,9,9,18,6.00,50.0
5158,tt0086435,Thursday's Child,1983,50+,77,1,2,1,,,,0,0,0,0,,
5159,tt1092011,Kutsal Damacana,2007,0,0,0,0,0,,,,0,0,0,0,,
5160,tt0066578,The Wizard of Gore,1970,"2,500+",3236,191,241,212,3,44.0,,4,0,4,4,,
5161,tt1062965,Severed Ways: The Norse Discovery of America,2007,"10,000+",12201,43,72,61,2.6,37.0,,22,9,13,22,4.70,41.0
5162,tt0914813,Mega Snake,2007,250+,366,13,65,43,2.1,17.0,,0,0,0,0,,
5163,tt0119984,Ravager,1997,Fewer than 50,11,1,3,1,,,,0,0,0,0,,
5164,tt0453533,Unrest,2006,"5,000+",6517,399,815,660,2.8,33.0,,3,1,2,3,,
5165,tt0199314,About Adam,2000,"5,000+",9438,318,364,219,3.2,47.0,,57,39,18,57,6.00,68.0
5166,tt1111313,The Elephant in the Living Room,2010,500+,658,201,39,68,4.1,84.0,,23,19,4,23,7.30,83.0
5167,tt0804551,Walking Tall: Lone Justice,2007,"2,500+",3653,28,118,78,2.6,19.0,,0,0,0,0,,
5168,tt0054989,The Honeymoon Machine,1961,100+,112,12,16,9,3.4,43.0,,1,0,1,1,,
5169,tt0089960,Vagabond,1985,"1,000+",1795,416,77,132,4,85.0,,23,23,0,23,8.80,100.0
5170,tt0122037,The Dead Pit,1989,250+,404,39,60,45,2.9,39.0,,2,0,2,2,,
5171,tt0090327,Witchboard,1986,"5,000+",6895,196,290,186,3,40.0,,16,8,8,16,5.30,50.0
5172,tt0448120,Single White Female 2: The Psycho,2005,"1,000+",1583,22,104,53,2.1,17.0,,2,0,2,2,,
5173,tt1034419,White Lightnin',2009,500+,590,151,59,58,3.7,72.0,,16,13,3,16,6.70,81.0
5174,tt1388351,Love in Japan,2006,0,0,0,0,0,,,,0,0,0,0,,
5175,tt0057897,The Brass Bottle,1964,Fewer than 50,43,8,10,6,3.1,44.0,,5,2,3,5,4.80,40.0
5176,tt1014808,The Understudy,2008,100+,116,5,2,0,3.8,71.0,,3,1,2,3,,
5177,tt0375785,Gray Matters,2006,"10,000+",10295,801,970,840,3.1,45.0,,65,5,60,65,3.80,8.0
5178,tt0059037,The Cincinnati Kid,1965,"5,000+",6040,761,213,281,3.8,78.0,,23,20,3,23,7.60,87.0
5179,tt0088207,Surf II,1983,100+,240,19,16,17,3.2,53.0,,2,0,2,2,,
5180,tt0159273,Behind Enemy Lines,2001,"250,000+",321903,8491,5250,5221,3.5,62.0,,131,48,83,131,4.80,37.0
5181,tt0292740,Yeh Raaste Hain Pyaar Ke,2001,0,0,0,0,0,,,,0,0,0,0,,
5182,tt0071436,Dost,1974,0,0,0,0,0,,,,0,0,0,0,,
5183,tt0956299,Konservy,2007,0,0,0,0,0,,,,0,0,0,0,,
5184,tt0357474,Belly of the Beast,2003,"10,000+",10044,171,314,179,2.8,35.0,,2,0,2,2,,
5185,tt0770806,The Contractor,2007,"5,000+",6236,284,727,453,2.7,28.0,,1,0,1,1,,
5186,tt1545464,Restless City,2011,100+,120,9,23,7,2.9,28.0,,11,5,6,11,6.00,45.0
5187,tt0366840,Okkadu,2003,50+,98,35,7,4,4,83.0,,0,0,0,0,,
5188,tt1124215,Queen Sized,2008,500+,585,77,103,82,3.2,42.0,,1,1,0,1,,
5189,tt0318434,May minamahal,1993,0,0,0,0,0,,,,0,0,0,0,,
5190,tt0056560,Tarzan Goes to India,1962,Fewer than 50,29,3,10,6,2.7,23.0,,1,0,1,1,,
5191,tt0974536,Chemical Wedding,2008,500+,504,39,90,79,2.5,30.0,,0,0,0,0,,
5192,tt0462538,The Simpsons Movie,2007,"250,000+",1823763,186345,55978,101690,3.9,77.0,,221,193,28,221,7.50,87.0
5193,tt0100129,Meet the Applegates,1990,"2,500+",3714,87,95,78,3.2,48.0,,11,1,10,11,4.20,9.0
5194,tt1031241,From Time to Time,2009,500+,507,176,112,61,3.5,61.0,,7,3,4,7,5.90,43.0
5195,tt0067528,On the Buses,1971,500+,505,55,37,35,3.7,60.0,,0,0,0,0,,
5196,tt0486583,Fred Claus,2007,"250,000+",371652,10762,13137,8003,3.1,45.0,,143,30,113,143,4.30,21.0
5197,tt0475286,Graduation,2007,"1,000+",1397,191,112,122,3.5,63.0,,6,0,6,6,3.10,0.0
5198,tt0054627,Anatomy of a Psycho,1961,250+,411,2,14,6,2.2,12.0,,0,0,0,0,,
5199,tt0065371,Adam at Six A.M.,1970,50+,67,3,5,2,3.2,38.0,,1,0,1,1,,
5200,tt0429573,An American Haunting,2005,"50,000+",89150,2022,3685,3375,2.7,35.0,,69,9,60,69,3.60,13.0
5201,tt5226426,Aattakatha,2013,0,0,0,0,0,,,,0,0,0,0,,
5202,tt0086589,Suburbia,1983,"5,000+",5146,589,143,264,4,80.0,,15,14,1,15,6.50,93.0
5203,tt0354623,Hellraiser: Hellworld,2005,"10,000+",17720,257,890,388,2.3,22.0,,6,0,6,6,3.20,0.0
5204,tt0423853,Be Here to Love Me: A Film About Townes Van Zandt,2004,"5,000+",8280,170,16,72,4.3,91.0,,35,33,2,35,7.60,94.0
5205,tt1264895,Moonlight & Mistletoe,2008,250+,283,40,38,20,3.4,51.0,,0,0,0,0,,
5206,tt0970521,Turtle: The Incredible Journey,2009,"1,000+",1022,146,44,40,3.9,77.0,,17,12,5,17,5.90,71.0
5207,tt0096170,Stealing Heaven,1988,100+,128,24,7,7,3.9,77.0,,4,1,3,4,,
5208,tt0081361,Portrait of the Artist as a Young Bunny,1980,Fewer than 50,42,2,5,0,3.4,29.0,,0,0,0,0,,
5209,tt0214641,Dragonheart: A New Beginning,1999,"25,000+",37600,250,472,419,2.7,35.0,,5,2,3,5,4.80,40.0
5210,tt0058142,Girl with Green Eyes,1964,100+,181,19,12,13,3.6,60.0,,6,5,1,6,7.00,83.0
5211,tt0112461,The Basketball Diaries,1995,"50,000+",56268,6345,1983,2193,3.8,76.0,,43,20,23,43,5.30,47.0
5212,tt0206554,Anpadh,1962,0,0,0,0,0,,,,0,0,0,0,,
5213,tt0090863,The Color of Money,1986,"25,000+",46235,4321,1566,1284,3.7,73.0,,49,43,6,49,7.10,88.0
5214,tt0091375,Lamb,1985,100+,224,19,5,11,3.8,79.0,,2,0,2,2,,
5215,tt0460976,Vallavan,2006,500+,558,20,16,9,3.4,56.0,,0,0,0,0,,
5216,tt0116102,Different for Girls,1996,"1,000+",1368,76,26,35,3.8,75.0,,25,12,13,25,5.80,48.0
5217,tt0096341,Uninvited,1987,100+,210,23,33,18,2.8,41.0,,0,0,0,0,,
5218,tt0108515,The War Room,1993,"2,500+",2636,370,76,139,3.9,83.0,,26,25,1,26,8.10,96.0
5219,tt0088423,Drunken Tai Chi,1984,Fewer than 50,19,9,6,5,3.4,60.0,,0,0,0,0,,
5220,tt0125144,Himala,1982,250+,397,56,2,31,4.6,97.0,,0,0,0,0,,
5221,tt0918557,Saving Sarah Cain,2007,"5,000+",9942,335,122,223,3.8,73.0,,2,1,1,2,,
5222,tt1675197,Zohi Sdom,2010,Fewer than 50,45,18,5,4,3.9,78.0,,0,0,0,0,,
5223,tt1530891,Kaana Kanmani,2009,0,0,0,0,0,,,,0,0,0,0,,
5224,tt0054033,The Little Shop of Horrors,1960,"50,000+",54936,1415,1151,856,3.4,55.0,,15,14,1,15,6.40,93.0
5225,tt0105790,Waterland,1992,"1,000+",1748,79,49,36,3.6,62.0,,15,8,7,15,6.00,53.0
5226,tt0096943,Blaze,1989,"1,000+",2122,68,72,36,3.3,49.0,,12,9,3,12,6.40,75.0
5227,tt0060831,Picture Mommy Dead,1966,100+,101,11,10,7,3.3,52.0,,2,1,1,2,,
5228,tt0058403,The Night Walker,1964,250+,451,28,22,20,3.4,56.0,,3,2,1,3,,
5229,tt0805184,Bhagam Bhag,2006,0,0,0,0,0,,,,0,0,0,0,,
5230,tt1185416,When in Rome,2010,"100,000+",158013,6313,9125,3644,3,41.0,,113,19,94,113,3.70,17.0
5231,tt0065007,Sole Survivor,1970,0,0,0,0,0,,,,0,0,0,0,,
5232,tt0454945,She's the Man,2006,"250,000+",607830,64002,17067,41705,4,79.0,,114,50,64,114,5.10,44.0
5233,tt0492931,The 11th Hour,2007,"25,000+",29320,1438,639,897,3.7,69.0,,94,63,31,94,6.50,67.0
5234,tt1204883,Boogeyman 3,2008,"1,000+",1533,96,320,166,2.4,23.0,,0,0,0,0,,
5235,tt1365041,Tholi Valapu,2001,0,0,0,0,0,,,,0,0,0,0,,
5236,tt0996979,Alien Raiders,2008,"1,000+",2193,206,401,268,2.8,34.0,,6,6,0,6,7.20,100.0
5237,tt1792589,Mitti,2010,Fewer than 50,2,1,0,1,,,,0,0,0,0,,
5238,tt0448011,Knowing,2009,Fewer than 50,1,0,1,0,,,,0,0,0,0,,
5239,tt1754799,The Suite Life Movie,2011,250+,467,116,102,39,3.4,53.0,,1,1,0,1,,
5240,tt0355987,'Salem's Lot,2004,"5,000+",8124,419,441,333,3.2,49.0,,25,17,8,25,5.20,68.0
5241,tt0160481,The Long Road Home,1999,50+,61,1,5,1,2.6,17.0,,0,0,0,0,,
5242,tt0101497,The Boneyard,1991,250+,278,20,24,24,3.1,45.0,,3,2,1,3,,
5243,tt1174693,The Four-Faced Liar,2010,250+,447,81,105,38,3.1,44.0,,0,0,0,0,,
5244,tt0453047,Elsa y Fred,2005,"5,000+",5364,1108,94,471,4.5,92.0,,31,17,14,31,5.60,55.0
5245,tt0488374,The Bong Connection,2006,250+,337,34,14,19,3.6,71.0,,1,1,0,1,,
5246,tt0112408,Attack of the 60 Foot Centerfolds,1995,50+,60,4,15,6,2.5,21.0,,0,0,0,0,,
5247,tt0949731,The Happening,2008,"250,000+",370555,11789,36746,28252,2.4,24.0,,187,33,154,187,4.00,18.0
5248,tt0384680,The Weather Man,2005,"100,000+",214042,6448,5122,5528,3.3,56.0,,136,81,55,136,6.20,60.0
5249,tt0961118,The Minx,2007,100+,128,1,3,1,,,,0,0,0,0,,
5250,tt1210106,St Trinian's 2: The Legend of Fritton's Gold,2009,"25,000+",29378,923,1145,700,3.1,45.0,,21,3,18,21,3.50,14.0
5251,tt0073317,Lucky Lady,1975,100+,111,6,10,5,2.6,38.0,,9,3,6,9,6.00,33.0
5252,tt0290839,Sainik,1993,0,0,0,0,0,,,,0,0,0,0,,
5253,tt0176105,Roti,1974,Fewer than 50,1,0,1,0,,,,0,0,0,0,,
5254,tt0117258,Organ,1996,50+,76,3,10,5,2.8,23.0,,3,0,3,3,,
5255,tt0449487,Passengers,2008,"25,000+",29564,1497,2751,1692,2.9,35.0,,31,6,25,31,4.10,19.0
5256,tt0056556,Taras Bulba,1962,500+,983,127,56,55,3.7,69.0,,1,0,1,1,,
5257,tt6420528,Like a Dragon: Prologue,2005,0,0,0,0,0,,,,0,0,0,0,,
5258,tt1783258,Dalaw,2010,0,0,0,0,0,,,,0,0,0,0,,
5259,tt0075716,Backroads,1977,Fewer than 50,7,0,2,1,,,,0,0,0,0,,
5260,tt0058138,Gertrud,1964,"1,000+",1291,233,77,83,3.8,75.0,,22,16,6,22,8.60,73.0
5261,tt0366444,Fighting Tommy Riley,2004,500+,812,27,24,20,3.3,53.0,,8,5,3,8,6.00,63.0
5262,tt0247196,Before Night Falls,2000,"10,000+",22213,2381,476,805,4,83.0,,101,75,26,101,6.80,74.0
5263,tt1438251,The Best and the Brightest,2010,"1,000+",1061,68,156,50,2.7,30.0,,19,5,14,19,5.00,26.0
5264,tt0119632,The MatchMaker,1997,"5,000+",6922,444,189,246,3.8,70.0,,32,16,16,32,5.70,50.0
5265,tt0449999,Kabhi Alvida Naa Kehna,2006,"10,000+",15711,1399,671,805,3.7,68.0,,12,7,5,12,6.00,58.0
5266,tt0138074,Santa and the Ice Cream Bunny,1972,500+,512,7,53,28,1.2,12.0,,1,0,1,1,,
5267,tt0286488,Barood,1998,Fewer than 50,6,0,1,0,,,,0,0,0,0,,
5268,tt0113189,GoldenEye,1995,"250,000+",286089,17668,3578,10236,4,83.0,,85,68,17,85,7.10,80.0
5269,tt0093073,Gardens of Stone,1987,"1,000+",2440,126,103,66,3.5,55.0,,16,7,9,16,4.90,44.0
5270,tt0852937,Bhargavacharitham Moonnam Khandam,2006,0,0,0,0,0,,,,0,0,0,0,,
5271,tt1510788,Lakshmi Kataksham,1970,0,0,0,0,0,,,,0,0,0,0,,
5272,tt0112553,Bombay,1995,"2,500+",2865,305,37,97,4.2,89.0,,3,3,0,3,,
5273,tt1883290,Pak! Pak! My Dr. Kwak!,2011,0,0,0,0,0,,,,0,0,0,0,,
5274,tt1483020,Spork,2010,500+,552,175,68,49,3.9,72.0,,11,6,5,11,6.10,55.0
5275,tt0458525,X-Men Origins: Wolverine,2009,"250,000+",562304,48310,35411,41425,3.4,58.0,,259,98,161,259,5.10,38.0
5276,tt0483722,"Lovers, Liars and Lunatics",2006,100+,222,8,2,4,4,80.0,,0,0,0,0,,
5277,tt0250081,Storytelling,2001,"5,000+",8986,1297,626,538,3.6,67.0,,91,49,42,91,5.60,54.0
5278,tt0102975,Star Trek VI: The Undiscovered Country,1991,"50,000+",63297,6503,1282,2364,4,84.0,,59,49,10,59,6.90,83.0
5279,tt0053629,Bombai Ka Babu,1960,Fewer than 50,26,2,0,0,,,,0,0,0,0,,
5280,tt0348662,Kucch To Hai,2003,100+,197,5,9,2,2.6,36.0,,0,0,0,0,,
5281,tt0120376,Trojan War,1997,250+,373,78,122,37,3,39.0,,0,0,0,0,,
5282,tt0215245,Thakshak,1999,50+,79,4,3,0,3.4,57.0,,0,0,0,0,,
5283,tt0193444,Bobbili Raja,1990,0,0,0,0,0,,,,0,0,0,0,,
5284,tt0277941,Ned Kelly,2003,"25,000+",41365,1655,1446,1146,3.4,53.0,,60,33,27,60,5.60,55.0
5285,tt0411705,9 Songs,2004,"5,000+",9998,710,1487,843,2.7,32.0,,96,23,73,96,4.50,24.0
5286,tt1172996,Love for Sale,2008,250+,442,42,30,24,3.6,58.0,,0,0,0,0,,
5287,tt0187109,Gurudev,1993,Fewer than 50,12,0,4,1,,,,0,0,0,0,,
5288,tt0485976,Rob-B-Hood,2006,"5,000+",7183,712,297,403,3.7,70.0,,3,3,0,3,,
5289,tt0055813,Brushfire,1962,Fewer than 50,1,0,1,1,,,,0,0,0,0,,
5290,tt0250774,Tera Jadoo Chal Gayaa,2000,50+,79,2,4,2,2.7,33.0,,0,0,0,0,,
5291,tt0089984,The Secret of the Sword,1985,"2,500+",4438,273,72,172,4.1,79.0,,5,3,2,5,7.70,60.0
5292,tt1183665,Cracks,2009,"5,000+",8130,701,746,322,3.2,48.0,,53,25,28,53,5.50,47.0
5293,tt0160509,Agnes Browne,1999,"1,000+",1268,84,35,32,3.9,71.0,,27,11,16,27,5.40,41.0
5294,tt0062687,Asterix og Kleopatra,1968,"2,500+",3412,307,83,66,3.9,79.0,,0,0,0,0,,
5295,tt0089194,Geraftaar,1985,0,0,0,0,0,,,,0,0,0,0,,
5296,tt0313443,Out of Time,2003,"50,000+",58882,3472,2546,1349,3.4,58.0,,152,98,54,152,6.40,64.0
5297,tt0313443,Out of Time,2003,"50,000+",58882,3472,2546,1349,3.4,58.0,,152,98,54,152,6.40,64.0
5298,tt1685328,The Graveyard of Death,2005,0,0,0,0,0,,,,0,0,0,0,,
5299,tt0061680,Follow That Camel,1967,500+,735,61,70,32,3.2,47.0,,1,0,1,1,,
5300,tt0382842,Meerayude Dukhavum Muthuvinte Swapnavum,2003,0,0,0,0,0,,,,0,0,0,0,,
5301,tt0093964,Shy People,1987,250+,415,37,10,13,4,78.0,,11,7,4,11,6.20,64.0
5302,tt7947592,One Piece Film: Strong World,2010,250+,465,256,32,53,4.3,89.0,,2,2,0,2,,
5303,tt0346723,Chalte Chalte,2003,"5,000+",7405,487,198,192,3.8,71.0,,3,1,2,3,,
5304,tt0259605,Swathi Thirunal,1987,0,0,0,0,0,,,,0,0,0,0,,
5305,tt0088828,Bloody Wednesday,1987,50+,79,6,14,10,2.3,30.0,,0,0,0,0,,
5306,tt1883121,404: Error Not Found,2011,Fewer than 50,21,8,8,4,3,50.0,,1,0,1,1,,
5307,tt0120879,Velvet Goldmine,1998,"25,000+",40087,5364,1362,2099,4,80.0,,50,31,19,50,6.50,62.0
5308,tt0434424,Undiscovered,2005,"5,000+",9314,282,310,315,3.2,48.0,,74,6,68,74,3.30,8.0
5309,tt0430105,Four Brothers,2005,"250,000+",392518,22134,5534,11132,4,80.0,,133,70,63,133,5.70,53.0
5310,tt0073198,"Jeanne Dielman, 23 quai du Commerce, 1080 Bruxelles",1975,"1,000+",1300,366,94,145,4,80.0,,57,54,3,57,8.60,95.0
5311,tt0062006,The Mummy's Shroud,1967,250+,495,15,60,36,2.7,20.0,,4,1,3,4,,
5312,tt0246879,Qurbani,1980,500+,618,52,9,17,4,85.0,,0,0,0,0,,
5313,tt0329028,Dumb and Dumberer: When Harry Met Lloyd,2003,"250,000+",259001,1613,5390,5154,2.2,23.0,,119,12,107,119,3.00,10.0
5314,tt0088103,Sheena,1984,"5,000+",5877,79,157,124,2.8,33.0,,8,1,7,8,3.30,13.0
5315,tt0084503,Pink Floyd: The Wall,1982,"50,000+",71497,11024,1308,4378,4.3,89.0,,29,21,8,29,7.30,72.0
5316,tt0094291,Wall Street,1987,"50,000+",50820,8890,2072,2701,3.9,81.0,,62,49,13,62,7.00,79.0
5317,tt0096029,Salome's Last Dance,1988,500+,560,67,12,27,4.1,85.0,,9,3,6,9,5.80,33.0
5318,tt0102842,"Sarah, Plain and Tall",1991,"2,500+",3438,205,82,97,3.8,71.0,,5,4,1,5,7.70,80.0
5319,tt2457548,Arike,2012,0,0,0,0,0,,,,0,0,0,0,,
5320,tt0067983,Whoever Slew Auntie Roo?,1972,250+,353,33,43,29,3.1,43.0,,10,6,4,10,4.80,60.0
5321,tt0881891,All About Steve,2009,"250,000+",465667,4495,10368,4826,2.7,30.0,,140,9,131,140,3.10,6.0
5322,tt1179891,My Bloody Valentine,2009,"100,000+",208746,5509,6878,8025,3.1,44.0,,109,67,42,109,5.80,61.0
5323,tt0296621,Everybody Says I'm Fine!,2001,250+,269,17,15,7,3.4,53.0,,15,7,8,15,5.80,47.0
5324,tt1319733,Road Trip: Beer Pong,2009,"1,000+",1872,136,454,186,2.4,23.0,,0,0,0,0,,
5325,tt0087931,Pope John Paul II,1984,Fewer than 50,15,2,1,0,,,,0,0,0,0,,
5326,tt0303361,May,2002,"25,000+",30216,3068,1029,1787,3.8,75.0,,70,49,21,70,6.20,70.0
5327,tt1663633,DC Showcase: Green Arrow,2010,100+,198,81,28,19,3.7,74.0,,0,0,0,0,,
5328,tt0252684,Manic,2001,"5,000+",8473,1365,368,553,3.9,79.0,,62,42,20,62,6.30,68.0
5329,tt1843968,Living Together,2011,0,0,0,0,0,,,,0,0,0,0,,
5330,tt1258197,Exam,2009,"5,000+",6097,2143,1675,909,3.4,56.0,,29,18,11,29,5.80,62.0
5331,tt0165078,After Life,1998,"5,000+",6807,1106,115,388,4.3,91.0,,35,31,4,35,7.30,89.0
5332,tt0411291,Dirty Filthy Love,2004,500+,521,122,35,53,3.8,78.0,,2,2,0,2,,
5333,tt0454824,Flyboys,2006,"50,000+",88533,5165,2599,3552,3.6,66.0,,129,43,86,129,5.00,33.0
5334,tt1134674,ZMD: Zombies of Mass Destruction,2009,"2,500+",2591,173,334,215,2.8,34.0,,6,4,2,6,6.10,67.0
5335,tt0464096,Lonely Street,2008,100+,195,8,40,19,2.5,17.0,,1,1,0,1,,
5336,tt0272839,Shackleton,2002,500+,659,101,30,39,3.9,77.0,,5,5,0,5,7.90,100.0
5337,tt2004191,Chaappa Kurish,2011,Fewer than 50,1,0,1,0,,,,0,0,0,0,,
5338,tt0073768,Supervixens,1975,"2,500+",2861,216,118,128,3.6,65.0,,6,6,0,6,7.00,100.0
5339,tt1270792,Sunday School Musical,2008,250+,319,21,63,31,2.4,25.0,,0,0,0,0,,
5340,tt1611823,Gallants,2010,250+,281,102,61,63,3.4,63.0,,0,0,0,0,,
5341,tt0173052,The Prince and the Surfer,1999,500+,540,4,7,2,2.7,36.0,,2,0,2,2,,
5342,tt0988849,Donkey Punch,2008,"10,000+",12589,404,1279,882,2.5,24.0,,51,27,24,51,5.50,53.0
5343,tt0375021,Rules: Pyaar Ka Superhit Formula,2003,250+,413,24,19,13,3.6,56.0,,0,0,0,0,,
5344,tt0080716,Fame,1980,"25,000+",40470,1846,842,1118,3.7,69.0,,34,27,7,34,7.00,79.0
5345,tt0090802,A Case of Deadly Force,1986,0,0,0,0,0,,,,0,0,0,0,,
5346,tt0094998,Demonwarp,1988,50+,82,4,10,4,2.6,29.0,,0,0,0,0,,
5347,tt0100401,Pratibandh,1990,0,0,0,0,0,,,,0,0,0,0,,
5348,tt0055783,Bees Saal Baad,1962,0,0,0,0,0,,,,0,0,0,0,,
5349,tt0094625,Akira,1988,"100,000+",149015,22563,2400,8615,4.3,90.0,,54,49,5,54,7.90,91.0
5350,tt0120383,"Truth or Consequences, N.M.",1997,"2,500+",4275,146,171,114,3.2,46.0,,16,6,10,16,5.00,38.0
5351,tt0796314,A Dog's Breakfast,2007,"2,500+",3164,504,84,319,4.2,86.0,,1,1,0,1,,
5352,tt0437232,Catch a Fire,2006,"25,000+",28977,1270,527,789,3.6,71.0,,146,110,36,146,6.70,75.0
5353,tt0119707,Mortal Kombat: Annihilation,1997,"50,000+",88466,1487,4593,2548,2.3,24.0,,53,2,51,53,2.50,4.0
5354,tt1865573,Bad Kids Go to Hell,2012,"2,500+",4688,285,518,117,2.8,35.0,,9,4,5,9,4.30,44.0
5355,tt1393000,Wrong Turn at Tahoe,2009,500+,966,88,241,83,2.6,27.0,,2,0,2,2,,
5356,tt0079781,Real Life,1979,"1,000+",1275,185,39,74,3.8,83.0,,21,17,4,21,6.70,81.0
5357,tt0085975,"Murder Me, Murder You",1983,0,0,0,0,0,,,,0,0,0,0,,
5358,tt4759292,Chore Chore Mastuto Bhai,2005,0,0,0,0,0,,,,0,0,0,0,,
5359,tt0207415,Doli Saja Ke Rakhna,1998,250+,396,15,11,5,3.6,58.0,,0,0,0,0,,
5360,tt0120793,A Price Above Rubies,1998,"1,000+",1582,87,77,36,3.3,53.0,,30,17,13,30,5.80,57.0
5361,tt0143127,Batman & Mr. Freeze: SubZero,1998,"50,000+",77141,1656,804,675,3.7,67.0,,12,11,1,12,6.60,92.0
5362,tt0304676,Scrapbook,2000,"1,000+",1081,32,42,45,2.7,43.0,,2,0,2,2,,
5363,tt0252277,Bichhoo,2000,250+,259,4,14,3,2.4,22.0,,0,0,0,0,,
5364,tt0436262,Ellie Parker,2005,"5,000+",5897,202,268,224,3,43.0,,48,25,23,48,5.60,52.0
5365,tt0446747,Mutual Appreciation,2005,"2,500+",3409,340,132,195,3.6,72.0,,56,48,8,56,7.60,86.0
5366,tt1966566,Stalingrad,2013,"5,000+",6888,473,652,151,3,42.0,,74,38,36,74,5.60,51.0
5367,tt0156126,Thakara,1979,0,0,0,0,0,,,,0,0,0,0,,
5368,tt0929858,Final Approach,2007,Fewer than 50,21,1,2,1,,,,2,0,2,2,,
5369,tt0074434,Drive In Massacre,1976,500+,767,4,80,46,1.9,5.0,,2,0,2,2,,
5370,tt0117342,Pinocchio's Revenge,1996,"1,000+",2394,58,186,106,2.3,23.0,,4,1,3,4,,
5371,tt0325258,Dickie Roberts: Former Child Star,2003,"50,000+",65275,1253,1446,1338,3.2,46.0,,120,26,94,120,4.50,22.0
5372,tt2301900,Puppet Master X: Axis Rising,2012,100+,120,19,59,24,2.5,24.0,,1,1,0,1,,
5373,tt0207374,Carnival Magic,1983,50+,64,1,33,14,1.3,3.0,,2,2,0,2,,
5374,tt0160127,Charlie's Angels,2000,"250,000+",729359,6863,8307,11787,3.1,45.0,,146,100,46,146,6.20,68.0
5375,tt0105001,Night and the City,1992,500+,862,48,106,24,3,31.0,,14,8,6,14,5.70,57.0
5376,tt1125929,Love Ranch,2010,"1,000+",1236,99,249,114,2.7,28.0,,50,6,44,50,3.70,12.0
5377,tt0416243,Submerged,2005,"5,000+",5662,82,259,116,2.4,24.0,,2,0,2,2,,
5378,tt0109949,Guantanamera,1995,"1,000+",1039,79,30,28,3.7,72.0,,10,8,2,10,6.90,80.0
5379,tt1602487,Treasure Planet,2002,"50,000+",68712,5440,2088,2180,3.8,72.0,,149,103,46,149,6.50,69.0
5380,tt0116695,Jerry Maguire,1996,"250,000+",442800,17609,4708,11179,3.9,79.0,,90,76,14,90,7.80,84.0
5381,tt0465461,Four Last Songs,2007,500+,953,63,60,60,3.2,51.0,,1,1,0,1,,
5382,tt0451824,My Wife's Murder,2005,250+,255,6,16,2,2.6,27.0,,1,0,1,1,,
5383,tt0110057,Hoop Dreams,1994,"10,000+",12652,3089,249,886,4.4,93.0,,61,60,1,61,8.80,98.0
5384,tt0110395,Love and a .45,1994,"2,500+",3747,260,113,137,3.8,70.0,,7,5,2,7,5.60,71.0
5385,tt0115734,Bottle Rocket,1996,"50,000+",61718,10838,2813,3378,3.9,79.0,,73,63,10,73,6.80,86.0
5386,tt0236247,Gavilán o paloma,1985,Fewer than 50,20,1,0,0,,,,0,0,0,0,,
5387,tt0305689,Jab Jab Phool Khile,1965,100+,169,8,6,5,3.5,57.0,,0,0,0,0,,
5388,tt0385890,My Big Fat Independent Movie,2005,"2,500+",4680,65,140,106,2.4,32.0,,13,3,10,13,4.00,23.0
5389,tt1781840,Jayne Mansfield's Car,2012,"1,000+",1586,104,152,56,3,41.0,,37,13,24,37,5.40,35.0
5390,tt0915473,This Is Not a Test,2008,"1,000+",2052,7,6,9,3.3,54.0,,0,0,0,0,,
5391,tt0069919,Cops and Robbers,1973,50+,74,5,11,5,2.8,31.0,,3,2,1,3,,
5392,tt1720182,October Baby,2011,"25,000+",32475,2593,689,698,4.1,79.0,,40,10,30,40,4.60,25.0
5393,tt0995039,Ghost Town,2008,50+,72,9,25,7,2.2,26.0,,0,0,0,0,,
5394,tt0120820,Senseless,1998,"10,000+",10115,407,490,237,3.1,45.0,,18,1,17,18,3.90,6.0
5395,tt0118698,Bent,1997,"5,000+",8190,670,204,289,3.9,77.0,,25,18,7,25,6.40,72.0
5396,tt0119227,Snow White: A Tale of Terror,1997,"10,000+",10949,626,483,446,3.4,56.0,,11,6,5,11,5.90,55.0
5397,tt0130370,Best of the Best 4: Without Warning,1998,"1,000+",1423,27,49,25,2.8,36.0,,0,0,0,0,,
5398,tt1102257,Lanka,2006,0,0,0,0,0,,,,0,0,0,0,,
5399,tt0108031,Samba Traoré,1992,Fewer than 50,12,1,0,0,,,,0,0,0,0,,
5400,tt0071647,Idaho Transfer,1973,100+,165,13,27,21,2.9,32.0,,0,0,0,0,,
5401,tt0078522,Zero to Sixty,1978,Fewer than 50,13,1,5,1,1.9,17.0,,0,0,0,0,,
5402,tt0095640,Miles from Home,1988,500+,612,33,23,19,3.4,59.0,,5,3,2,5,4.40,60.0
5403,tt1500516,Videocracy,2009,250+,439,67,105,52,3,39.0,,27,18,9,27,6.30,67.0
5404,tt0469251,Tripping Forward,2009,Fewer than 50,34,3,4,1,3,43.0,,0,0,0,0,,
5405,tt0171580,Nurse Betty,2000,"25,000+",35310,1007,1258,589,3.1,45.0,,131,109,22,131,7.20,83.0
5406,tt1130988,JCVD,2008,"10,000+",22529,3587,1261,2187,3.7,74.0,,107,90,17,107,6.90,84.0
5407,tt0100119,Masters of Menace,1990,100+,110,13,6,5,3.8,68.0,,0,0,0,0,,
5408,tt0404756,Alien Apocalypse,2005,"5,000+",6393,166,377,375,2.6,31.0,,1,1,0,1,,
5409,tt10122538,Sigaram,1991,0,0,0,0,0,,,,0,0,0,0,,
5410,tt3116840,The Smurfs 2,2013,"50,000+",73683,7809,6163,1068,3.4,56.0,,94,13,81,94,4.10,14.0
5411,tt0084509,The Plague Dogs,1982,"2,500+",3100,595,69,259,4.3,90.0,,9,6,3,9,7.30,67.0
5412,tt14116906,Murai Maman,1995,0,0,0,0,0,,,,0,0,0,0,,
5413,tt0758794,We Are Marshall,2006,"100,000+",202869,12716,3464,6749,4,79.0,,127,62,65,127,5.80,49.0
5414,tt0187150,Himmatwala,1983,Fewer than 50,1,1,0,0,,,,0,0,0,0,,
5415,tt0087884,"Paris, Texas",1984,"10,000+",24508,5805,419,1249,4.4,93.0,,53,50,3,53,8.30,94.0
5416,tt0298203,8 Mile,2002,"250,000+",32167884,62605,53123,1027848,3.1,54.0,,211,159,52,211,6.70,75.0
5417,tt1877691,Love Breakups Zindagi,2011,Fewer than 50,39,8,16,8,2.7,33.0,,2,0,2,2,,
5418,tt0093266,Instant Justice,1986,50+,99,5,14,7,2.4,26.0,,0,0,0,0,,
5419,tt0097334,Farewell to the King,1989,"1,000+",1387,67,56,34,3.4,54.0,,11,6,5,11,5.50,55.0
5420,tt1210356,"Raat Gayi, Baat Gayi?",2009,Fewer than 50,39,2,6,2,2.9,25.0,,1,1,0,1,,
5421,tt0134154,Ride with the Devil,1999,"5,000+",7473,671,350,319,3.6,66.0,,67,43,24,67,6.30,64.0
5422,tt0136153,English Babu Desi Mem,1996,500+,790,18,35,8,2.6,34.0,,0,0,0,0,,
5423,tt0120782,Palmetto,1998,"2,500+",3405,104,234,71,2.9,31.0,,36,14,22,36,5.20,39.0
5424,tt0413300,Spider-Man 3,2007,"250,000+",2265043,154100,150869,271426,3.3,51.0,,262,165,97,262,6.20,63.0
5425,tt1169841,Return of Hanuman,2007,100+,116,11,3,4,3.9,79.0,,0,0,0,0,,
5426,tt1486190,Tamara Drewe,2010,"5,000+",9409,1028,1418,667,3.1,42.0,,129,83,46,129,6.30,64.0
5427,tt0080636,We're Going to Eat You,1980,100+,190,24,16,13,3.4,60.0,,1,1,0,1,,
5428,tt0202409,Jackie's Back!,1999,250+,257,41,6,16,4.3,87.0,,1,0,1,1,,
5429,tt0137362,Anuradha,1960,Fewer than 50,47,2,0,2,,,,0,0,0,0,,
5430,tt0258068,The Quiet American,2002,"10,000+",10709,1404,536,475,3.7,72.0,,155,135,20,155,7.70,87.0
5431,tt0154506,Following,1998,"10,000+",22907,5974,1061,1760,3.9,85.0,,38,32,6,38,7.10,84.0
5432,tt0913413,The Marc Pease Experience,2009,"1,000+",1832,39,243,92,2.1,14.0,,11,2,9,11,3.20,18.0
5433,tt8942386,Sabrina Goes to Rome,1998,"2,500+",3290,111,152,66,3.1,42.0,,0,0,0,0,,
5434,tt1065106,Pigs,2007,"1,000+",2172,63,284,141,2.2,18.0,,1,0,1,1,,
5435,tt0475756,Thirupaachi,2005,250+,276,11,11,2,3.5,50.0,,0,0,0,0,,
5436,tt0107088,The Hawk,1993,250+,318,4,12,8,2.8,25.0,,4,1,3,4,,
5437,tt0286179,Sunshine State,2002,"2,500+",2538,128,94,62,3.4,58.0,,111,89,22,111,7.00,80.0
5438,tt1524137,Contraband,2012,"50,000+",70112,14567,11132,3206,3.5,57.0,,165,84,81,165,5.40,51.0
5439,tt0288415,Air Bud: Seventh Inning Fetch,2002,"50,000+",71526,202,199,382,3.2,50.0,,2,0,2,2,,
5440,tt1392996,Sarah's Choice,2009,100+,166,40,30,15,3.4,57.0,,1,0,1,1,,
5441,tt0072737,Breakout,1975,"1,000+",1957,43,58,30,3.2,43.0,,14,8,6,14,5.60,57.0
5442,tt0058765,Your Cheatin' Heart,1964,100+,136,14,7,9,3.4,67.0,,1,1,0,1,,
5443,tt0266850,Phantom of the Megaplex,2000,"1,000+",1499,160,118,66,3.5,57.0,,1,1,0,1,,
5444,tt0843873,Snakes on a Train,2006,"5,000+",8772,98,442,338,1.7,18.0,,4,0,4,4,,
5445,tt0291883,Ek Ladka Ek Ladki,1992,250+,457,13,16,4,3.1,45.0,,0,0,0,0,,
5446,tt0160009,The Art of War,2000,"25,000+",26645,562,1021,353,2.9,35.0,,81,13,68,81,3.90,16.0
5447,tt1560954,Gun,2010,0,0,0,0,0,,,,0,0,0,0,,
5448,tt0251833,Megham,1999,0,0,0,0,0,,,,0,0,0,0,,
5449,tt0111293,The Stöned Age,1994,"2,500+",3429,272,123,171,3.7,69.0,,1,0,1,1,,
5450,tt0103312,Young Soul Rebels,1991,100+,143,11,11,5,3.4,50.0,,2,2,0,2,,
5451,tt1499486,Little Alien,2009,0,0,0,0,0,,,,0,0,0,0,,
5452,tt1420568,The National Tree,2009,50+,75,16,16,8,3.2,50.0,,0,0,0,0,,
5453,tt0054367,Tall Story,1960,100+,104,13,19,10,3.2,41.0,,3,0,3,3,,
5454,tt0072870,Dharam Karam,1975,Fewer than 50,37,0,2,0,,,,0,0,0,0,,
5455,tt0195002,Kaun?,1999,50+,82,21,7,8,3.8,75.0,,1,1,0,1,,
5456,tt1522329,Tum Mile,2009,250+,341,28,78,62,2.8,27.0,,2,1,1,2,,
5457,tt1573072,Housefull,2010,Fewer than 50,3,1,2,0,,,,0,0,0,0,,
5458,tt0115639,Beautiful Girls,1996,"10,000+",22155,2640,649,911,4,80.0,,49,38,11,49,7.00,78.0
5459,tt0264578,The Endurance: Shackleton's Legendary Antarctic Expedition,2000,"1,000+",1382,168,22,58,4.1,88.0,,65,62,3,65,7.70,95.0
5460,tt0846736,Tokusou sentai Dekarenjâ vs Abaranger,2005,0,0,0,0,0,,,,0,0,0,0,,
5461,tt0080341,Akaler Sandhane,1981,0,0,0,0,0,,,,0,0,0,0,,
5462,tt0058754,Woman of Straw,1964,250+,267,30,18,17,3.5,62.0,,0,0,0,0,,
5463,tt0068310,The Boxer from Shantung,1972,500+,618,43,8,23,3.9,84.0,,1,1,0,1,,
5464,tt0489049,Fanboys,2009,"50,000+",69216,4812,3604,3254,3.4,57.0,,97,31,66,97,4.80,32.0
5465,tt0827521,The Shepherd: Border Patrol,2008,"1,000+",2010,113,317,168,2.7,26.0,,2,0,2,2,,
5466,tt0098600,The Vineyard,1989,50+,86,4,21,5,2.6,16.0,,1,0,1,1,,
5467,tt0101545,Career Opportunities,1991,"5,000+",7180,336,566,264,3,37.0,,18,7,11,18,4.90,39.0
5468,tt0203408,The Omega Code,1999,"2,500+",3779,88,197,96,2.5,31.0,,25,2,23,25,3.10,8.0
5469,tt0119664,Metro,1997,0,0,0,0,0,,,,0,0,0,0,,
5470,tt0236021,Bhaiyya,1961,0,0,0,0,0,,,,0,0,0,0,,
5471,tt1189072,New Brooklyn,2009,Fewer than 50,1,1,0,0,,,,1,1,0,1,,
5472,tt0082085,Blow Out,1981,"10,000+",11887,2527,576,793,3.9,81.0,,60,53,7,60,7.90,88.0
5473,tt1370426,Costa Rican Summer,2010,100+,117,10,30,11,2.2,25.0,,0,0,0,0,,
5474,tt0366627,The Jacket,2005,"50,000+",79046,7342,2698,3416,3.8,73.0,,162,72,90,162,5.40,44.0
5475,tt0103045,Fight Back to School,1991,"2,500+",4462,535,84,102,4,86.0,,0,0,0,0,,
5476,tt0086433,Those Glory Glory Days,1983,50+,99,6,8,8,3.5,43.0,,0,0,0,0,,
5477,tt0137523,Fight Club,1999,"250,000+",1096207,248447,10810,73823,4.5,96.0,,184,146,38,184,7.40,79.0
5478,tt1069225,Decaying Orbit,2007,0,0,0,0,0,,,,3,3,0,3,,
5479,tt0135161,Bhai,1997,50+,73,1,1,2,,,,0,0,0,0,,
5480,tt0497351,"Dance Party, USA",2006,"1,000+",1189,51,52,45,3.2,50.0,,8,7,1,8,6.80,88.0
5481,tt0071196,Barry McKenzie Holds His Own,1974,100+,190,11,10,9,3.3,52.0,,2,1,1,2,,
5482,tt0066011,Love Story,1970,"25,000+",35361,2670,908,1386,3.9,75.0,,29,19,10,29,6.00,66.0
5483,tt0074949,Nagin,1976,50+,67,2,2,1,,,,0,0,0,0,,
5484,tt0249964,Sirivennela,1986,0,0,0,0,0,,,,0,0,0,0,,
5485,tt0088846,Brazil,1985,"100,000+",103269,24366,2676,7429,4.3,90.0,,54,53,1,54,8.80,98.0
5486,tt0076868,Valentino,1977,100+,133,22,32,22,3,41.0,,13,6,7,13,6.70,46.0
5487,tt1082601,Fighting,2009,"250,000+",765978,2731,4823,3461,2.9,36.0,,130,51,79,130,4.90,39.0
5488,tt0072198,The Spikes Gang,1974,250+,352,17,19,20,3.1,47.0,,2,1,1,2,,
5489,tt0098636,When He's Not a Stranger,1989,0,0,0,0,0,,,,0,0,0,0,,
5490,tt0897387,Shrek the Halls,2007,"25,000+",27566,1279,750,685,3.6,63.0,,3,2,1,3,,
5491,tt0167752,The 4th Floor,1999,"2,500+",3062,99,135,69,3,42.0,,3,1,2,3,,
5492,tt0102340,Love Crimes,1992,100+,106,2,21,2,2,9.0,,5,0,5,5,4.70,0.0
5493,tt0347278,Jhankaar Beats,2003,500+,937,142,25,37,4.1,85.0,,0,0,0,0,,
5494,tt0381116,D.C. Sniper: 23 Days of Fear,2003,100+,167,17,16,8,3.4,52.0,,1,0,1,1,,
5495,tt0924248,Madhumasam,2007,50+,98,0,1,0,,,,0,0,0,0,,
5496,tt1580704,That Girl in Yellow Boots,2010,250+,339,110,83,55,3.2,57.0,,10,5,5,10,5.50,50.0
5497,tt0084637,The Scarlet Pimpernel,1982,"5,000+",7735,842,100,497,4.4,89.0,,1,1,0,1,,
5498,tt0111625,Vijaypath,1994,0,0,0,0,0,,,,0,0,0,0,,
5499,tt0188863,Love Stinks,1999,"5,000+",6762,397,229,224,3.6,63.0,,47,9,38,47,3.80,19.0
5500,tt0245333,Ondu Muthina Kathe,1987,0,0,0,0,0,,,,0,0,0,0,,
5501,tt0093220,House II: The Second Story,1987,"5,000+",8436,225,307,223,3,42.0,,14,1,13,14,3.30,7.0
5502,tt0099423,Die Hard 2,1990,"250,000+",415341,23273,9899,11051,3.7,70.0,,67,47,20,67,6.30,70.0
5503,tt0338261,"Monsters, Inc.",2001,"250,000+",1254638,92934,10234,65706,3.8,90.0,,199,191,8,199,8.10,96.0
5504,tt0301250,Tera Mera Saath Rahen,2001,0,0,0,0,0,,,,0,0,0,0,,
5505,tt0117382,Twists of Terror,1997,50+,57,2,2,1,,,,3,1,2,3,,
5506,tt0127500,Darklands,1996,100+,223,5,10,7,2.7,33.0,,0,0,0,0,,
5507,tt0082335,This Unnameable Little Broom,1985,0,0,0,0,0,,,,0,0,0,0,,
5508,tt0326449,Zona Zamfirova,2002,0,0,0,0,0,,,,0,0,0,0,,
5509,tt0099581,Flashback,1990,"5,000+",5813,178,121,99,3.5,60.0,,15,6,9,15,4.90,40.0
5510,tt0497391,Iru Malargal,1967,0,0,0,0,0,,,,0,0,0,0,,
5511,tt0109550,Dark Waters,1993,"5,000+",8684,62,52,53,3.3,54.0,,6,4,2,6,6.10,67.0
5512,tt0843858,Lady Godiva,2008,50+,87,1,4,3,1.7,20.0,,3,0,3,3,,
5513,tt1547035,When Love Is Not Enough: The Lois Wilson Story,2010,100+,227,45,41,22,3.4,52.0,,1,0,1,1,,
5514,tt0112851,Desperado,1995,"100,000+",188549,13762,3577,5141,3.9,79.0,,52,36,16,52,6.50,69.0
5515,tt0108556,When a Stranger Calls Back,1993,"5,000+",9884,212,135,149,3.6,61.0,,8,5,3,8,6.30,63.0
5516,tt0120481,Washington Square,1997,"1,000+",2114,167,76,64,3.7,69.0,,31,25,6,31,7.20,81.0
5517,tt0102210,Killer Tomatoes Eat France!,1992,"2,500+",2530,47,69,53,2.8,41.0,,0,0,0,0,,
5518,tt0158331,Victoria No. 203,1972,0,0,0,0,0,,,,0,0,0,0,,
5519,tt0117102,Mr. Wrong,1996,"5,000+",8961,141,409,252,2.4,26.0,,31,2,29,31,3.20,6.0
5520,tt0065820,The Hawaiians,1970,100+,126,15,13,11,3.4,54.0,,2,1,1,2,,
5521,tt0109665,Dream Lover,1993,500+,944,68,110,45,3,38.0,,14,8,6,14,5.60,57.0
5522,tt0240402,The Center of the World,2001,"2,500+",2545,112,165,95,3,40.0,,82,28,54,82,4.80,34.0
5523,tt0127640,Laserhawk,1997,250+,414,12,34,29,2.7,26.0,,2,1,1,2,,
5524,tt0408196,Sniper 3,2004,"5,000+",6486,133,173,80,3,43.0,,1,1,0,1,,
5525,tt0090927,The Delta Force,1986,"10,000+",15592,661,670,528,3.3,50.0,,13,2,11,13,4.10,15.0
5526,tt0408985,Last Holiday,2006,"250,000+",373085,4672,2301,5777,3.7,67.0,,123,68,55,123,5.80,55.0
5527,tt0077372,Corvette Summer,1978,"2,500+",3964,104,140,105,3.2,43.0,,9,5,4,9,5.80,56.0
5528,tt0779745,Mosagalaku Mosagaadu,1971,0,0,0,0,0,,,,0,0,0,0,,
5529,tt0097812,Main Azaad Hoon,1989,50+,75,5,1,0,4.1,83.0,,0,0,0,0,,
5530,tt1168764,Urduja,2008,Fewer than 50,1,1,0,0,,,,0,0,0,0,,
5531,tt0477067,Poison Dust,2005,0,0,0,0,0,,,,0,0,0,0,,
5532,tt0087525,Just the Way You Are,1984,250+,459,25,15,12,3.5,62.0,,3,1,2,3,,
5533,tt1611224,Abraham Lincoln: Vampire Hunter,2012,"100,000+",242702,20224,20072,6550,3.3,50.0,,193,65,128,193,5.00,34.0
5534,tt0316396,Peter Pan,2003,"250,000+",427284,10970,3767,11903,3.9,74.0,,144,111,33,144,6.80,77.0
5535,tt0922424,Falafel,2006,250+,298,13,15,6,3.3,46.0,,3,3,0,3,,
5536,tt1416733,Kasturi Nivasa,1970,0,0,0,0,0,,,,0,0,0,0,,
5537,tt0492486,Shrooms,2007,"10,000+",16822,834,2223,1723,2.5,27.0,,18,4,14,18,4.20,22.0
5538,tt0299693,Commissioner,1994,0,0,0,0,0,,,,0,0,0,0,,
5539,tt0199389,Cabin by the Lake,2000,500+,818,112,68,61,3.5,62.0,,3,0,3,3,,
5540,tt0104576,Just Like a Woman,1992,250+,492,15,11,16,3.6,58.0,,6,3,3,6,5.60,50.0
5541,tt0246831,Oral Mathram,1997,0,0,0,0,0,,,,0,0,0,0,,
5542,tt0250687,Rat Race,2001,"250,000+",403803,8752,4995,10446,3.5,64.0,,128,57,71,128,5.00,45.0
5543,tt0250687,Rat Race,2001,"250,000+",403803,8752,4995,10446,3.5,64.0,,128,57,71,128,5.00,45.0
5544,tt0099857,Iron & Silk,1990,100+,111,15,4,7,3.6,79.0,,6,5,1,6,6.30,83.0
5545,tt0096978,Brenda Starr,1989,"1,000+",1693,20,41,22,2.7,33.0,,0,0,0,0,,
5546,tt0089730,Once Bitten,1985,"25,000+",28363,653,1012,621,3,39.0,,10,1,9,10,3.30,10.0
5547,tt0496321,D' Lucky Ones!,2006,100+,123,5,2,4,3.7,71.0,,0,0,0,0,,
5548,tt0250122,Yeshwant,1997,0,0,0,0,0,,,,0,0,0,0,,
5549,tt0079135,Fascination,1979,250+,481,50,59,41,3.2,46.0,,2,2,0,2,,
5550,tt0157117,Tokyo Eyes,1998,500+,735,87,43,27,3.6,67.0,,6,5,1,6,7.10,83.0
5551,tt0224581,Nothin' 2 Lose,2000,50+,76,4,0,0,,,,0,0,0,0,,
5552,tt1740799,My Reincarnation,2011,250+,296,20,8,6,3.5,71.0,,15,11,4,15,6.60,73.0
5553,tt0222167,Lucky 13,2005,"1,000+",1653,23,59,49,2.6,28.0,,2,0,2,2,,
5554,tt0156014,Red Rose,1980,100+,233,17,8,6,3.5,68.0,,0,0,0,0,,
5555,tt0067052,Endless Night,1972,500+,615,20,30,16,3.1,39.0,,3,2,1,3,,
5556,tt1537392,Armless,2010,50+,99,10,15,8,3,40.0,,0,0,0,0,,
5557,tt1610996,Absentia,2011,"1,000+",1495,527,552,298,3.1,49.0,,16,14,2,16,7.10,88.0
5558,tt0813996,Alag: He Is Different.... He Is Alone...,2006,0,0,0,0,0,,,,0,0,0,0,,
5559,tt1139319,A Film with Me in It,2008,500+,797,212,142,118,3.4,60.0,,13,8,5,13,6.20,62.0
5560,tt1152398,Beastly,2011,"50,000+",58130,6399,7042,2588,3.2,48.0,,98,21,77,98,3.70,21.0
5561,tt4339030,Potta Potti,2011,0,0,0,0,0,,,,0,0,0,0,,
5562,tt0101272,The Addams Family,1991,"250,000+",315630,12284,6202,5841,3.7,66.0,,52,35,17,52,5.90,67.0
5563,tt0156887,Perfect Blue,1997,"10,000+",20657,3640,447,1210,4.1,89.0,,54,45,9,54,7.30,83.0
5564,tt1190894,"Road, Movie",2009,250+,279,44,43,33,3.1,51.0,,9,6,3,9,5.00,67.0
5565,tt0309698,Identity,2003,"100,000+",191129,12933,4340,6731,3.7,75.0,,170,107,63,170,6.40,63.0
5566,tt0253618,Saboot,1980,0,0,0,0,0,,,,0,0,0,0,,
5567,tt0454457,Frostbiten,2006,"1,000+",1628,43,83,54,2.5,34.0,,4,2,2,4,,
5568,tt0243415,Mercy Streets,2000,100+,118,11,9,5,3.3,55.0,,8,1,7,8,4.10,13.0
5569,tt0285823,Once Upon a Time in Mexico,2003,"250,000+",285624,11780,6638,8574,3.5,64.0,,168,111,57,168,6.20,66.0
5570,tt0108000,Ruby in Paradise,1993,500+,513,112,33,59,4,77.0,,29,25,4,29,7.50,86.0
5571,tt0229480,Island of Blood,1982,Fewer than 50,6,1,3,0,,,,1,0,1,1,,
5572,tt0187738,Blade II,2002,"250,000+",451214,24570,11656,10441,3.7,68.0,,150,86,64,150,6.00,57.0
5573,tt0058296,The Lively Set,1964,Fewer than 50,1,1,0,0,,,,0,0,0,0,,
5574,tt1194173,The Bourne Legacy,2012,"250,000+",282434,33853,24485,7949,3.5,58.0,,234,130,104,234,5.90,56.0
5575,tt0347591,My Name Is Modesty: A Modesty Blaise Adventure,2004,"1,000+",2356,62,140,73,2.6,31.0,,0,0,0,0,,
5576,tt0106697,Demolition Man,1993,"250,000+",270746,13091,6591,5569,3.7,67.0,,42,26,16,42,5.60,62.0
5577,tt0253194,Kunwara,2000,100+,108,2,6,1,2.4,25.0,,0,0,0,0,,
5578,tt0295526,Leaving Metropolis,2002,"1,000+",1184,19,20,26,3.1,49.0,,6,1,5,6,4.90,17.0
5579,tt0192618,Smart House,1999,"2,500+",2586,246,219,104,3.4,53.0,,2,2,0,2,,
5580,tt0209144,Memento,2000,"250,000+",382236,96121,5700,27555,4.4,94.0,,185,173,12,185,8.30,94.0
5581,tt0947798,Black Swan,2010,"100,000+",178813,69051,13379,19954,4,84.0,,320,272,48,320,8.20,85.0
5582,tt0339111,Headrush,2003,250+,440,5,6,7,3.2,45.0,,0,0,0,0,,
5583,tt0947798,Black Swan,2010,"100,000+",178813,69051,13379,19954,4,84.0,,320,272,48,320,8.20,85.0
5584,tt0491183,Take a Chance,2006,"1,000+",1074,19,17,22,3.4,53.0,,0,0,0,0,,
5585,tt0154844,Maqsad,1984,0,0,0,0,0,,,,0,0,0,0,,
5586,tt0214665,Ek Phool Do Mali,1969,Fewer than 50,25,3,0,0,,,,0,0,0,0,,
5587,tt1344337,Reuniting the Rubins,2010,250+,259,18,28,12,2.9,39.0,,18,0,18,18,3.50,0.0
5588,tt0116587,Hustler White,1996,"1,000+",1625,61,57,47,3.2,52.0,,2,1,1,2,,
5589,tt0069448,Up the Front,1972,Fewer than 50,42,4,7,4,2.5,36.0,,0,0,0,0,,
5590,tt0174917,Merlin's Shop of Mystical Wonders,1996,"1,000+",1255,20,104,77,1.6,16.0,,1,0,1,1,,
5591,tt0160620,Oxygen,1999,"2,500+",3187,168,137,93,3.3,55.0,,13,10,3,13,6.60,77.0
5592,tt0861347,The Extra,2006,250+,341,10,13,14,3,43.0,,0,0,0,0,,
5593,tt0805526,Facing the Giants,2006,"50,000+",88267,8681,1494,5244,4.3,85.0,,25,4,21,25,4.30,16.0
5594,tt0068833,The Last House on the Left,1972,"2,500+",4909,2463,2446,2084,3.2,50.0,,40,26,14,40,6.30,65.0
5595,tt1107859,Kill Switch,2008,"1,000+",1652,49,249,158,2,16.0,,1,1,0,1,,
5596,tt0185937,The Blair Witch Project,1999,"250,000+",403007,12993,9964,16443,3.2,57.0,,170,146,24,170,7.70,86.0
5597,tt1521709,Broken Springs,2010,Fewer than 50,4,1,0,0,,,,0,0,0,0,,
5598,tt0366780,Mirrormask,2005,"50,000+",70954,5694,1421,3729,4,80.0,,89,48,41,89,5.80,54.0
5599,tt0250665,Pratighatana,1985,0,0,0,0,0,,,,0,0,0,0,,
5600,tt0113666,Little Criminals,1996,100+,198,19,5,9,4,79.0,,0,0,0,0,,
5601,tt2009480,Gautam Govinda,2002,0,0,0,0,0,,,,0,0,0,0,,
5602,tt0212985,Hannibal,2001,"250,000+",403433,15048,9243,10620,3.5,62.0,,172,67,105,172,5.10,39.0
5603,tt0410377,Nim's Island,2008,"100,000+",181207,4061,4793,4169,3.2,46.0,,106,56,50,106,5.70,53.0
5604,tt0775482,Highwater,2009,500+,991,20,7,9,3.9,74.0,,14,6,8,14,5.30,43.0
5605,tt0054759,Come September,1961,"2,500+",3069,217,61,80,4,78.0,,7,6,1,7,6.40,86.0
5606,tt1027862,Swing Vote,2008,"50,000+",98290,1730,2439,1899,3,41.0,,151,58,93,151,5.20,38.0
5607,tt1132589,Hijack,2008,100+,228,2,31,16,2.3,6.0,,1,0,1,1,,
5608,tt0800026,Fatal Contact: Bird Flu in America,2006,100+,198,4,16,5,2.6,20.0,,1,0,1,1,,
5609,tt0800026,Fatal Contact: Bird Flu in America,2006,100+,198,4,16,5,2.6,20.0,,1,0,1,1,,
5610,tt1314645,C Me Dance,2009,500+,687,9,34,24,1.7,21.0,,6,0,6,6,2.90,0.0
5611,tt0117918,Tin Cup,1996,"25,000+",49226,2404,1304,986,3.6,65.0,,54,39,15,54,6.60,72.0
5612,tt0435612,Bush Family Fortunes: The Best Democracy Money Can Buy,2004,Fewer than 50,41,32,9,21,3.8,78.0,,2,2,0,2,,
5613,tt1653700,The Veteran,2011,500+,878,178,289,147,2.9,38.0,,20,12,8,20,5.20,60.0
5614,tt0467409,Memories of Tomorrow,2005,"1,000+",1278,192,24,80,4.2,89.0,,14,12,2,14,6.80,86.0
5615,tt0327210,Uncle Nino,2003,250+,290,37,17,24,3.7,69.0,,33,7,26,33,4.40,21.0
5616,tt0061784,Hot Rods to Hell,1966,250+,318,21,32,24,3,40.0,,3,2,1,3,,
5617,tt0114214,The Quick and the Dead,1995,"50,000+",65555,3807,3312,1939,3.3,53.0,,40,23,17,40,5.90,58.0
5618,tt0107147,A House in the Hills,1993,Fewer than 50,43,2,12,4,2.6,14.0,,2,1,1,2,,
5619,tt1391894,Siddharth: The Prisoner,2009,Fewer than 50,45,3,4,3,3.1,43.0,,0,0,0,0,,
5620,tt0120042,Running Time,1997,500+,873,71,27,43,3.6,72.0,,2,2,0,2,,
5621,tt0317132,Because of Winn-Dixie,2005,"25,000+",42178,1401,828,994,3.6,63.0,,121,67,54,121,5.90,55.0
5622,tt0119809,Nowhere,1997,"5,000+",6511,792,257,344,3.9,76.0,,15,7,8,15,4.30,47.0
5623,tt0115678,Big Night,1996,"5,000+",8241,1442,281,501,4.1,84.0,,58,56,2,58,8.10,97.0
5624,tt0082764,Modern Romance,1981,"1,000+",1696,198,78,74,3.8,72.0,,22,18,4,22,6.40,82.0
5625,tt1227787,London River,2009,"10,000+",10179,309,151,102,3.5,67.0,,34,31,3,34,6.80,91.0
5626,tt0109075,Alegre ma non troppo,1994,0,0,0,0,0,,,,0,0,0,0,,
5627,tt0352248,Cinderella Man,2005,"250,000+",282392,26601,2554,9035,4.2,91.0,,211,169,42,211,7.40,80.0
5628,tt0080391,Attack of the Killer Tomatoes!,1978,"25,000+",34755,674,915,977,3,42.0,,11,3,8,11,4.30,27.0
5629,tt0246002,Kingdom Come,2001,"5,000+",7655,293,113,131,3.8,72.0,,66,18,48,66,4.40,27.0
5630,tt0301231,Duniya,1984,Fewer than 50,10,3,2,0,3.5,60.0,,0,0,0,0,,
5631,tt0228486,King Kung Fu,1976,50+,73,21,13,16,3.5,62.0,,0,0,0,0,,
5632,tt0053683,The Bulldog Breed,1960,250+,479,20,11,13,3.7,65.0,,0,0,0,0,,
5633,tt0063194,Kona Coast,1968,Fewer than 50,25,1,7,4,2,12.0,,0,0,0,0,,
5634,tt0122474,Elvis Meets Nixon,1997,250+,378,40,13,15,3.9,75.0,,1,0,1,1,,
5635,tt0117786,Mr. Nice Guy,1997,"25,000+",41066,773,974,495,3.2,44.0,,30,13,17,30,5.50,43.0
5636,tt0373883,Halloween,2007,"250,000+",361524,24374,17153,23534,3.4,59.0,,122,34,88,122,4.40,28.0
5637,tt0065009,Some Girls Do,1969,Fewer than 50,4,0,4,2,,,,0,0,0,0,,
5638,tt0864354,Perpetual Motion,2003,Fewer than 50,3,1,0,0,,,,2,1,1,2,,
5639,tt0093583,Murder Ordained,1987,Fewer than 50,30,0,2,1,,,,0,0,0,0,,
5640,tt0306892,George and the Dragon,2004,"2,500+",3082,174,190,183,3.2,48.0,,0,0,0,0,,
5641,tt0114240,A Reason to Believe,1995,250+,316,7,4,5,3.6,64.0,,0,0,0,0,,
5642,tt0275719,Tape,2001,"5,000+",8692,1327,415,485,3.7,76.0,,100,77,23,100,6.70,77.0
5643,tt0818165,The Alphabet Killer,2008,"5,000+",7549,219,741,378,2.5,23.0,,8,1,7,8,4.70,13.0
5644,tt0471862,Pournami,2006,50+,73,9,5,1,3.9,64.0,,0,0,0,0,,
5645,tt0089877,Rainbow Brite and the Star Stealer,1985,"5,000+",6020,284,74,207,4.1,79.0,,7,0,7,7,3.30,0.0
5646,tt0158092,Piya Ka Ghar,1972,0,0,0,0,0,,,,0,0,0,0,,
5647,tt0382718,The God King,1974,0,0,0,0,0,,,,0,0,0,0,,
5648,tt0116756,Kazaam,1996,"25,000+",40150,348,1373,1172,2,20.0,,37,2,35,37,3.20,5.0
5649,tt0093201,Ghost Chase,1987,250+,368,10,28,9,2.6,26.0,,2,0,2,2,,
5650,tt0455915,Black Irish,2007,"1,000+",1689,201,149,133,3.4,58.0,,13,4,9,13,4.90,31.0
5651,tt0765446,Escape from Planet Earth,2012,"25,000+",35378,5738,4935,814,3.4,54.0,,42,14,28,42,4.70,33.0
5652,tt0324213,Terror Toons,2002,"1,000+",1681,54,113,104,2.3,32.0,,1,0,1,1,,
5653,tt0082276,Don't Go Near the Park,1979,500+,590,9,44,29,1.9,17.0,,1,0,1,1,,
5654,tt0256692,Chori Chori Chupke Chupke,2001,"2,500+",4395,122,89,53,3.5,58.0,,0,0,0,0,,
5655,tt0402894,Casanova,2005,"100,000+",190606,4609,3409,3202,3.4,58.0,,137,61,76,137,5.60,45.0
5656,tt0380500,Little Marines,1991,50+,50,7,5,2,3.7,58.0,,0,0,0,0,,
5657,tt0315255,Bangarada Manushya,1972,Fewer than 50,1,1,0,1,,,,0,0,0,0,,
5658,tt0093137,Hamburger Hill,1987,"25,000+",33134,1658,635,684,3.8,72.0,,12,12,0,12,7.40,100.0
5659,tt0088998,Deadly Messages,1985,Fewer than 50,11,3,4,2,2.9,43.0,,0,0,0,0,,
5660,tt1596365,The Woman in Black,2012,"50,000+",97957,19050,16105,6691,3.3,54.0,,197,130,67,197,6.10,66.0
5661,tt0834951,Seachd: The Inaccessible Pinnacle,2007,250+,344,37,13,25,3.7,74.0,,0,0,0,0,,
5662,tt0265666,The Royal Tenenbaums,2001,"250,000+",256441,49091,6244,14421,4.2,89.0,,217,176,41,217,7.50,81.0
5663,tt0057001,La diosa impura,1963,0,0,0,0,0,,,,0,0,0,0,,
5664,tt0113249,Innocent Lies,1995,500+,746,4,23,6,2.3,15.0,,1,0,1,1,,
5665,tt0418810,Kulimlim,2004,Fewer than 50,29,1,1,1,,,,0,0,0,0,,
5666,tt0070734,Steptoe and Son Ride Again,1973,Fewer than 50,43,28,15,9,3.7,66.0,,0,0,0,0,,
5667,tt0361411,Bride & Prejudice,2004,"50,000+",79143,4107,1756,3500,3.7,70.0,,134,86,48,134,6.10,64.0
5668,tt0104823,Martial Law II: Undercover,1991,Fewer than 50,2,0,2,1,,,,0,0,0,0,,
5669,tt0070734,Steptoe and Son Ride Again,1973,Fewer than 50,43,28,15,9,3.7,66.0,,0,0,0,0,,
5670,tt0061744,Hamraaz,1967,Fewer than 50,30,3,0,0,,,,0,0,0,0,,
5671,tt1384926,The Christmas Hope,2009,50+,90,26,10,5,3.8,72.0,,0,0,0,0,,
5672,tt0871512,Disengagement,2007,250+,406,20,51,21,2.7,29.0,,1,1,0,1,,
5673,tt0120735,"Lock, Stock and Two Smoking Barrels",1998,"250,000+",308632,58427,4153,14192,4.3,93.0,,67,50,17,67,6.70,75.0
5674,tt0055230,Night Tide,1961,500+,775,62,57,49,3.3,52.0,,7,6,1,7,7.40,86.0
5675,tt0892899,Outpost,2008,"2,500+",3925,532,1045,847,2.9,34.0,,3,1,2,3,,
5676,tt1684913,Microphone,2010,50+,67,30,8,3,3.9,79.0,,3,1,2,3,,
5677,tt0109647,Don't Talk to Strangers,1994,250+,364,7,14,6,2.8,33.0,,0,0,0,0,,
5678,tt0068850,Love and Pain and the Whole Damn Thing,1973,50+,58,13,7,8,3.9,65.0,,3,2,1,3,,
5679,tt0471042,Tower Heist,2011,"50,000+",57730,13220,14114,4129,3.3,48.0,,201,135,66,201,6.20,67.0
5680,tt0765443,Eastern Promises,2007,"100,000+",149492,38227,7784,20511,3.9,83.0,,202,180,22,202,7.60,89.0
5681,tt0402294,Iznogoud,2005,100+,240,9,46,8,2.1,16.0,,0,0,0,0,,
5682,tt0290429,Ashaant,1993,0,0,0,0,0,,,,0,0,0,0,,
5683,tt0414036,Game Box 1.0,2004,50+,70,9,27,14,2.2,25.0,,1,1,0,1,,
5684,tt0059079,Come Drink with Me,1966,"1,000+",1299,234,83,117,3.7,74.0,,8,8,0,8,7.70,100.0
5685,tt0139872,Avvai Shanmugi,1996,50+,59,13,3,0,3.9,81.0,,0,0,0,0,,
5686,tt0094869,The Chocolate War,1988,"1,000+",1064,150,75,86,3.5,67.0,,13,11,2,13,7.10,85.0
5687,tt0799916,Al Franken: God Spoke,2006,"10,000+",24006,114,146,61,2.9,44.0,,55,32,23,55,5.90,58.0
5688,tt2215719,Katy Perry: Part of Me,2012,"25,000+",47170,5395,2112,999,3.9,72.0,,88,66,22,88,6.30,75.0
5689,tt0121533,May Madham,1994,0,0,0,0,0,,,,0,0,0,0,,
5690,tt1841542,Chillar Party,2011,250+,274,106,31,40,3.9,77.0,,2,2,0,2,,
5691,tt1185412,Veer,2010,"1,000+",1157,138,150,87,3.1,48.0,,5,2,3,5,6.30,40.0
5692,tt0112462,Batman Forever,1995,"250,000+",609692,10174,21189,18286,2.8,32.0,,70,28,42,70,5.20,40.0
5693,tt0804235,Black Aura on an Angel,2004,0,0,0,0,0,,,,0,0,0,0,,
5694,tt0255295,Kannezhuthi Pottum Thottu,1999,0,0,0,0,0,,,,0,0,0,0,,
5695,tt0065525,Carry on Up the Jungle,1970,"1,000+",1131,72,78,40,3.3,48.0,,0,0,0,0,,
5696,tt1867093,The Samaritan,2012,"5,000+",5366,462,691,163,3,40.0,,34,9,25,34,4.20,26.0
5697,tt0354836,Podium,2004,250+,416,51,43,11,3.4,54.0,,0,0,0,0,,
5698,tt0103837,Blinky Bill,1992,Fewer than 50,7,1,2,0,,,,0,0,0,0,,
5699,tt1922545,Anjathe,2008,Fewer than 50,2,2,0,0,,,,0,0,0,0,,
5700,tt0254942,Akkare Akkare Akkare,1990,0,0,0,0,0,,,,0,0,0,0,,
5701,tt0099762,Henry & June,1990,"5,000+",7884,788,371,274,3.7,68.0,,25,15,10,25,6.10,60.0
5702,tt0097038,The Challengers,1991,Fewer than 50,18,3,4,3,3.6,43.0,,0,0,0,0,,
5703,tt0056581,Thérèse Desqueyroux,1962,Fewer than 50,2,2,0,1,,,,1,1,0,1,,
5704,tt0183649,Phone Booth,2002,"250,000+",410959,12308,6884,12214,3.5,64.0,,188,135,53,188,6.50,72.0
5705,tt0183649,Phone Booth,2002,"250,000+",410959,12308,6884,12214,3.5,64.0,,188,135,53,188,6.50,72.0
5706,tt1757944,Princess and the Pony,2011,50+,72,7,1,1,4.2,88.0,,1,0,1,1,,
5707,tt0425123,Just Like Heaven,2005,"250,000+",541593,30364,10121,21574,3.9,75.0,,151,82,69,151,5.60,54.0
5708,tt0093105,"Good Morning, Vietnam",1987,"100,000+",131686,7908,1741,2843,3.9,82.0,,47,42,5,47,7.40,89.0
5709,tt0329297,American Girl,2002,"2,500+",2780,78,82,75,3.2,49.0,,2,0,2,2,,
5710,tt0403056,The Garden of Earthly Delights,2004,100+,219,19,10,13,3.7,66.0,,6,4,2,6,6.80,67.0
5711,tt0159272,Beautiful People,1999,0,0,0,0,0,,,,0,0,0,0,,
5712,tt0285879,Passionada,2002,"1,000+",1439,60,53,52,3.3,53.0,,46,26,20,46,5.60,57.0
5713,tt0059793,That Darn Cat!,1965,"10,000+",11791,478,189,299,3.8,72.0,,16,15,1,16,6.90,94.0
5714,tt2088847,Oh My Friend,2011,Fewer than 50,37,10,8,2,3.7,56.0,,0,0,0,0,,
5715,tt1667076,F.A.L.T.U,2011,Fewer than 50,15,6,6,0,3,50.0,,1,1,0,1,,
5716,tt0817177,Flipped,2010,"10,000+",20368,3803,1046,1047,3.9,78.0,,77,42,35,77,6.00,55.0
5717,tt0364343,The Final Cut,2004,"2,500+",2729,1226,1503,1027,3.1,45.0,,79,29,50,79,5.30,37.0
5718,tt1045778,Year One,2009,"250,000+",337122,4957,16125,8474,2.4,24.0,,173,24,149,173,3.90,14.0
5719,tt0107805,Perdido por perdido,1993,0,0,0,0,0,,,,0,0,0,0,,
5720,tt0892109,Trailer Park of Terror,2008,"1,000+",1644,185,274,251,2.9,40.0,,2,0,2,2,,
5721,tt0805559,Jump In!,2007,"50,000+",64427,4075,2622,2659,3.5,61.0,,8,5,3,8,5.60,63.0
5722,tt6827430,Ninaithen Vandhai,1998,0,0,0,0,0,,,,0,0,0,0,,
5723,tt1105263,Bleach: Memories of Nobody,2006,"10,000+",11166,1772,276,793,4.3,87.0,,0,0,0,0,,
5724,tt0095599,Masquerade,1988,"1,000+",1546,88,86,53,3.2,51.0,,16,8,8,16,5.40,50.0
5725,tt0259877,Bandh Darwaza,1990,0,0,0,0,0,,,,0,0,0,0,,
5726,tt0091583,My Little Girl,1986,100+,125,3,5,3,2.9,38.0,,0,0,0,0,,
5727,tt0092618,Barfly,1987,"5,000+",7729,1422,314,495,4,82.0,,25,19,6,25,6.70,76.0
5728,tt0493409,Devil's Den,2006,500+,706,20,66,49,2.5,23.0,,1,1,0,1,,
5729,tt0400675,Mystic India,2005,250+,434,26,8,13,3.9,76.0,,7,6,1,7,7.40,86.0
5730,tt0067280,Journey Back to Oz,1972,500+,501,25,22,22,3.4,53.0,,1,1,0,1,,
5731,tt0057241,Ladies Who Do,1963,Fewer than 50,1,0,1,0,,,,0,0,0,0,,
5732,tt0379375,Matrubhoomi: A Nation Without Women,2003,500+,610,92,13,37,4.1,88.0,,1,1,0,1,,
5733,tt0063105,Golden Swallow,1968,0,0,0,0,0,,,,0,0,0,0,,
5734,tt0098637,When We Were Young,1989,0,0,0,0,0,,,,0,0,0,0,,
5735,tt0104765,Love Field,1992,"1,000+",1994,90,72,42,3.4,55.0,,10,4,6,10,5.70,40.0
5736,tt0083701,Bugs Bunny's 3rd Movie: 1001 Rabbit Tales,1982,500+,665,65,38,22,3.6,63.0,,1,0,1,1,,
5737,tt0452625,Good Luck Chuck,2007,"250,000+",318855,26210,20052,18893,3.3,57.0,,117,6,111,117,3.10,5.0
5738,tt2263430,Christmas Grace,2013,Fewer than 50,15,2,9,5,2.4,18.0,,1,0,1,1,,
5739,tt0211661,Terror Tract,2000,500+,586,32,60,29,2.9,35.0,,5,3,2,5,4.60,60.0
5740,tt0115907,City Hall,1996,"10,000+",11477,445,749,215,3,37.0,,26,15,11,26,6.00,58.0
5741,tt0058060,Ensign Pulver,1964,250+,472,22,25,16,3,47.0,,0,0,0,0,,
5742,tt0091875,Running Scared,1986,"5,000+",8406,468,338,269,3.5,58.0,,23,14,9,23,5.40,61.0
5743,tt0988084,Do It for Johnny,2007,0,0,0,0,0,,,,0,0,0,0,,
5744,tt0166924,Mulholland Drive,2001,"100,000+",189705,30876,4455,10328,4.2,87.0,,262,219,43,262,7.80,84.0
5745,tt0325042,Bagets,1984,0,0,0,0,0,,,,0,0,0,0,,
5746,tt0273452,Bandhan,1998,50+,77,1,6,0,2.4,14.0,,0,0,0,0,,
5747,tt0063260,The Magus,1968,250+,469,33,31,24,3.2,52.0,,6,3,3,6,6.70,50.0
5748,tt0068502,Dr Jekyll & Sister Hyde,1971,"1,000+",1152,74,43,50,3.5,63.0,,7,6,1,7,6.80,86.0
5749,tt0091836,Reform School Girls,1986,"2,500+",3941,107,64,92,3.6,63.0,,8,2,6,8,4.40,25.0
5750,tt0323849,Rudy: The Rudy Giuliani Story,2003,"1,000+",1000,11,30,17,2.4,27.0,,3,0,3,3,,
5751,tt0055394,Sail a Crooked Ship,1961,0,0,0,0,0,,,,0,0,0,0,,
5752,tt1695994,The Virginity Hit,2010,"10,000+",13743,336,753,318,2.6,31.0,,48,13,35,48,4.50,27.0
5753,tt0101751,Dollman,1991,500+,638,58,101,68,3,36.0,,6,3,3,6,5.90,50.0
5754,tt0480255,The Losers,2010,0,0,0,0,0,,,,0,0,0,0,,
5755,tt0157075,The Suburbans,1999,"1,000+",2032,39,141,54,2.4,22.0,,10,0,10,10,3.00,0.0
5756,tt0310952,Riverworld,2003,"1,000+",1415,31,53,35,2.9,37.0,,1,0,1,1,,
5757,tt0156711,Kiss Toledo Goodbye,1999,500+,836,8,15,6,2.9,35.0,,3,1,2,3,,
5758,tt0235846,Unnikrishnante Adyathe Christmas,1988,0,0,0,0,0,,,,0,0,0,0,,
5759,tt0141105,Free Enterprise,1998,"2,500+",4805,317,83,205,3.9,79.0,,24,20,4,24,6.50,83.0
5760,tt0117604,Seven Servants,1996,Fewer than 50,33,3,1,1,,,,0,0,0,0,,
5761,tt0119578,Love! Valour! Compassion!,1997,"2,500+",3418,226,69,92,3.9,77.0,,24,17,7,24,6.50,71.0
5762,tt0338427,Shopgirl,2005,"50,000+",68106,3119,2292,2580,3.4,58.0,,155,94,61,155,6.30,61.0
5763,tt0113497,Jumanji,1995,"250,000+",976139,19926,11905,20773,3.5,63.0,,46,24,22,46,6.00,52.0
5764,tt0407269,The Truth About Love,2005,"5,000+",6646,207,302,201,3,41.0,,11,0,11,11,2.50,0.0
5765,tt0164212,Under Suspicion,2000,"5,000+",8399,515,555,266,3.2,48.0,,45,22,23,45,5.30,49.0
5766,tt0098068,Parents,1989,"2,500+",4393,313,269,240,3.3,54.0,,15,9,6,15,6.10,60.0
5767,tt0069226,Savages,1972,Fewer than 50,14,2,1,2,,,,0,0,0,0,,
5768,tt0069226,Savages,1972,Fewer than 50,14,2,1,2,,,,0,0,0,0,,
5769,tt0382936,Recess: All Growed Down,2003,50+,80,16,21,10,3.4,43.0,,1,1,0,1,,
5770,tt0079727,The Plumber,1979,250+,369,53,34,29,3.4,61.0,,3,3,0,3,,
5771,tt1152836,Public Enemies,2009,"250,000+",634025,28204,19283,20428,3.4,59.0,,281,192,89,281,6.40,68.0
5772,tt0101565,Changes,1991,100+,145,6,7,1,3.5,46.0,,0,0,0,0,,
5773,tt0099388,Deathstalker IV: Match of Titans,1991,Fewer than 50,29,3,10,6,2.3,23.0,,0,0,0,0,,
5774,tt1336006,The Revenant,2009,"1,000+",2245,315,316,151,3.2,50.0,,25,14,11,25,5.70,56.0
5775,tt0108358,Tombstone,1993,"100,000+",195843,26293,1824,10904,4.4,94.0,,47,34,13,47,6.30,72.0
5776,tt0099422,Dick Tracy,1990,"50,000+",77349,2955,2580,1884,3.3,53.0,,57,35,22,57,5.90,61.0
5777,tt0093660,Nuts,1987,"2,500+",4212,252,101,123,3.8,71.0,,27,11,16,27,5.30,41.0
5778,tt0114733,Tromeo and Juliet,1996,"5,000+",7637,486,309,318,3.5,61.0,,3,2,1,3,,
5779,tt1509803,Griff the Invisible,2010,"2,500+",2739,404,371,187,3.3,52.0,,58,37,21,58,5.90,64.0
5780,tt6494130,The Hunt for Red October,1991,"100,000+",173067,13410,1742,4620,4.1,88.0,,76,67,9,76,7.70,88.0
5781,tt0256259,Pauline & Paulette,2001,500+,692,79,19,30,3.8,81.0,,55,46,9,55,6.90,84.0
5782,tt0095177,Freeway,1988,250+,268,2,9,11,3.1,18.0,,0,0,0,0,,
5783,tt0779768,Teesri Aankh: The Hidden Camera,2006,50+,74,0,4,1,,,,0,0,0,0,,
5784,tt0086102,Phar Lap,1983,"2,500+",3517,240,18,123,4.5,93.0,,8,7,1,8,6.40,88.0
5785,tt1201557,Acid Factory,2009,100+,159,13,26,15,2.8,34.0,,1,0,1,1,,
5786,tt0423455,Hemingway & Gellhorn,2012,"1,000+",1068,264,389,113,3,40.0,,49,24,25,49,5.30,49.0
5787,tt0084485,Penitentiary II,1982,0,0,0,0,0,,,,1,0,1,1,,
5788,tt0376127,Anniyan,2005,250+,311,80,9,14,4.2,90.0,,1,1,0,1,,
5789,tt0860835,Closet Space,2008,Fewer than 50,1,0,1,0,,,,0,0,0,0,,
5790,tt1047494,Meet the Browns,2008,"25,000+",29773,1632,175,690,4.5,90.0,,58,19,39,58,4.90,33.0
5791,tt1546036,The Drawn Together Movie: The Movie!,2010,"1,000+",1077,201,209,146,3.1,49.0,,0,0,0,0,,
5792,tt1188729,Pandorum,2009,"100,000+",105010,6959,7317,5104,3.2,49.0,,91,27,64,91,4.60,30.0
5793,tt0359517,Johnson Family Vacation,2004,"25,000+",38280,542,701,570,3,44.0,,89,5,84,89,3.40,6.0
5794,tt0493322,The Veteran,2006,100+,103,7,11,9,2.6,39.0,,1,0,1,1,,
5795,tt1596346,Soul Surfer,2011,"25,000+",41740,8971,2930,2479,3.9,75.0,,106,48,58,106,5.40,45.0
5796,tt1500818,Maafa 21,2009,0,0,0,0,0,,,,0,0,0,0,,
5797,tt0094828,Camille Claudel,1988,"5,000+",5089,679,92,194,4.2,88.0,,12,11,1,12,8.40,92.0
5798,tt2575568,Aadum Koothu,2006,0,0,0,0,0,,,,0,0,0,0,,
5799,tt1053818,Butch Jamie,2007,100+,189,10,8,6,3.5,56.0,,0,0,0,0,,
5800,tt0184894,Shanghai Noon,2000,"250,000+",415102,9549,5095,7471,3.5,65.0,,134,107,27,134,6.60,80.0
5801,tt0099237,Challenger,1990,100+,228,6,8,3,3.1,43.0,,0,0,0,0,,
5802,tt0910905,In the Electric Mist,2009,"50,000+",60866,627,1245,814,2.9,34.0,,13,7,6,13,5.80,54.0
5803,tt0424435,Shake Hands with the Devil: The Journey of Roméo Dallaire,2004,"1,000+",1271,228,22,116,4.4,91.0,,49,43,6,49,7.50,88.0
5804,tt1239459,Star Runners,2009,100+,125,6,45,20,2,12.0,,0,0,0,0,,
5805,tt1591615,World Cupp 2011,2009,0,0,0,0,0,,,,0,0,0,0,,
5806,tt0364236,Billa,1980,Fewer than 50,1,1,0,0,,,,0,0,0,0,,
5807,tt0084477,Partners,1982,250+,402,13,26,17,2.8,33.0,,4,0,4,4,,
5808,tt0403455,Roll Bounce,2005,"50,000+",56455,2549,1097,1443,3.8,70.0,,90,59,31,90,6.00,66.0
5809,tt0283026,Swimfan,2002,"25,000+",49909,851,1840,1207,2.7,32.0,,93,14,79,93,3.90,15.0
5810,tt0178171,Aakhri Baazi,1989,0,0,0,0,0,,,,0,0,0,0,,
5811,tt1166085,120,2008,0,0,0,0,0,,,,0,0,0,0,,
5812,tt0472221,The Care Bears Big Wish Movie,2005,100+,137,7,7,6,3.5,50.0,,1,1,0,1,,
5813,tt1213917,Un'estate al mare,2008,0,0,0,0,0,,,,0,0,0,0,,
5814,tt1846444,2012: Ice Age,2011,250+,459,42,233,102,1.7,15.0,,0,0,0,0,,
5815,tt0815244,Sydney White,2007,"250,000+",789595,16600,7041,9945,3.8,70.0,,85,30,55,85,5.10,35.0
5816,tt0056420,Rocío de La Mancha,1963,0,0,0,0,0,,,,0,0,0,0,,
5817,tt0317751,Janwar,1965,0,0,0,0,0,,,,0,0,0,0,,
5818,tt0107833,A Place to Be Loved,1993,0,0,0,0,0,,,,1,0,1,1,,
5819,tt0445935,Bordertown,2007,"10,000+",17836,943,542,600,3.5,64.0,,3,2,1,3,,
5820,tt0058145,A Global Affair,1964,50+,54,3,7,5,3.1,30.0,,0,0,0,0,,
5821,tt0418599,Christmas in Love,2004,Fewer than 50,31,1,8,2,2.2,11.0,,0,0,0,0,,
5822,tt1034320,Major Movie Star,2008,"1,000+",1779,134,221,133,2.8,38.0,,2,0,2,2,,
5823,tt0337592,Love Don't Cost a Thing,2003,"25,000+",48103,1206,647,1001,3.7,65.0,,72,9,63,72,3.70,13.0
5824,tt0095853,Permanent Record,1988,"2,500+",2705,117,50,81,3.7,70.0,,15,7,8,15,6.60,47.0
5825,tt0490086,Big Stan,2007,"5,000+",6029,946,1173,806,3.1,45.0,,9,1,8,9,3.00,11.0
5826,tt0055627,X-15,1961,"1,000+",1460,6,7,4,3,46.0,,0,0,0,0,,
5827,tt0408181,Shankar Dada MBBS,2004,0,0,0,0,0,,,,0,0,0,0,,
5828,tt0284837,Ali G Indahouse,2002,"50,000+",87998,3243,2771,2112,3.3,54.0,,16,9,7,16,5.30,56.0
5829,tt0310907,Con Express,2002,250+,305,8,18,6,2.6,31.0,,4,0,4,4,,
5830,tt0350146,SpiderBabe,2003,"1,000+",1647,43,60,56,3,42.0,,1,1,0,1,,
5831,tt0331218,The Chubbchubbs!,2002,100+,226,37,17,17,3.6,68.0,,1,0,1,1,,
5832,tt0295238,Personal Velocity: Three Portraits,2002,"2,500+",2723,186,116,87,3.4,62.0,,104,72,32,104,6.50,69.0
5833,tt0283090,29 Palms,2002,500+,881,31,54,28,2.7,36.0,,5,0,5,5,3.50,0.0
5834,tt0131704,The Adventures of Rocky & Bullwinkle,2000,"50,000+",52001,407,1577,840,2.3,21.0,,101,43,58,101,4.90,43.0
5835,tt0113010,Fair Game,1995,"5,000+",9424,99,615,209,2.1,14.0,,26,3,23,26,3.10,12.0
5836,tt0066551,The Way We Live Now,1970,0,0,0,0,0,,,,0,0,0,0,,
5837,tt1145852,Daniel's Daughter,2008,100+,158,10,17,10,3.1,37.0,,0,0,0,0,,
5838,tt0294425,Cadet Kelly,2002,"50,000+",63202,1474,1525,1389,3.3,49.0,,4,3,1,4,,
5839,tt0457920,Goopy Bagha Phire Elo,1991,0,0,0,0,0,,,,0,0,0,0,,
5840,tt1912996,Barely Legal,2011,250+,324,23,89,15,2.1,21.0,,0,0,0,0,,
5841,tt0808904,Pachakuthira,2006,Fewer than 50,1,0,1,0,,,,0,0,0,0,,
5842,tt0463873,Back in Business,2007,Fewer than 50,11,0,3,0,,,,0,0,0,0,,
5843,tt0433422,Odd Girl Out,2005,"5,000+",7753,599,158,407,4,79.0,,0,0,0,0,,
5844,tt1436372,Elle: A Modern Cinderella Tale,2010,250+,370,41,76,24,2.6,35.0,,0,0,0,0,,
5845,tt0085380,Cross Creek,1983,500+,953,54,18,30,3.8,75.0,,17,10,7,17,5.40,59.0
5846,tt0094063,Student Exchange,1987,250+,358,15,6,7,4,71.0,,0,0,0,0,,
5847,tt0120213,Slappy and the Stinkers,1998,"1,000+",2088,117,75,71,3.5,61.0,,4,0,4,4,,
5848,tt0388139,It's All Gone Pete Tong,2004,"10,000+",17260,2567,353,1053,4.2,88.0,,71,54,17,71,6.40,76.0
5849,tt0475967,Have No Fear: The Life of Pope John Paul II,2005,Fewer than 50,6,1,0,0,,,,1,1,0,1,,
5850,tt0350195,Teri Meherbaniyan,1985,0,0,0,0,0,,,,0,0,0,0,,
5851,tt0107042,Great Moments in Aviation,1994,Fewer than 50,46,1,3,1,,,,1,1,0,1,,
5852,tt0071395,The Dead Don't Die,1975,50+,72,2,3,3,2.9,40.0,,2,1,1,2,,
5853,tt0139362,High Art,1998,"5,000+",8132,976,292,321,3.9,77.0,,50,38,12,50,6.80,76.0
5854,tt1047459,Dharm,2007,100+,183,39,3,12,4.2,93.0,,1,1,0,1,,
5855,tt0200435,Anari No. 1,1999,Fewer than 50,11,2,1,1,,,,0,0,0,0,,
5856,tt0124819,Orgazmo,1997,"50,000+",52520,3889,1967,2369,3.6,66.0,,33,16,17,33,4.90,48.0
5857,tt0251426,Tarazu,1997,0,0,0,0,0,,,,0,0,0,0,,
5858,tt1153690,Ballast,2008,"2,500+",4185,315,125,171,3.7,72.0,,80,74,6,80,7.40,93.0
5859,tt0382942,Rescue Heroes: The Movie,2003,"1,000+",1288,8,7,7,3.4,53.0,,0,0,0,0,,
5860,tt0405159,Million Dollar Baby,2004,"250,000+",405500,42848,4895,15873,4.2,90.0,,270,244,26,270,8.40,90.0
5861,tt0102746,Kurbaan,1991,0,0,0,0,0,,,,0,0,0,0,,
5862,tt0089880,Rambo: First Blood Part II,1985,"100,000+",100126,6675,4404,2948,3.5,60.0,,46,15,31,46,4.60,33.0
5863,tt0065390,The Amazing Transplant,1970,Fewer than 50,11,0,7,3,1.6,0.0,,0,0,0,0,,
5864,tt1274296,Listen to Your Heart,2010,"1,000+",1134,436,137,108,3.9,76.0,,0,0,0,0,,
5865,tt0109327,Brainscan,1994,"5,000+",9954,496,329,371,3.5,60.0,,16,2,14,16,3.80,13.0
5866,tt0119142,For Richer or Poorer,1997,"25,000+",44232,645,762,615,3.1,46.0,,23,3,20,23,3.80,13.0
5867,tt0065966,The Last Escape,1970,Fewer than 50,3,0,2,0,,,,0,0,0,0,,
5868,tt1640116,Christmas with a Capital C,2011,50+,54,20,20,7,2.9,50.0,,1,0,1,1,,
5869,tt0499554,Reno 911!: Miami,2007,"100,000+",196571,8036,7808,8146,3.2,51.0,,99,34,65,99,5.00,34.0
5870,tt0087886,Paroma,1985,0,0,0,0,0,,,,0,0,0,0,,
5871,tt0234215,The Matrix Reloaded,2003,"250,000+",943802,47668,18508,27962,3.7,72.0,,244,180,64,244,6.80,74.0
5872,tt0162212,Brink!,1998,"2,500+",4720,583,191,231,3.9,75.0,,4,3,1,4,,
5873,tt0093231,Hunk,1987,250+,355,15,48,23,2.6,24.0,,2,0,2,2,,
5874,tt1063034,Anne of Green Gables: A New Beginning,2008,250+,344,18,27,20,2.9,40.0,,0,0,0,0,,
5875,tt0062355,The Terrornauts,1967,Fewer than 50,22,3,8,8,2.6,27.0,,0,0,0,0,,
5876,tt1132595,Maan Gaye Mughall-E-Azam,2008,250+,257,6,26,18,2.1,19.0,,1,0,1,1,,
5877,tt0365677,Red Water,2003,500+,505,29,125,50,2.2,18.0,,4,2,2,4,,
5878,tt0384116,G.O.R.A.,2004,"2,500+",2824,385,111,55,3.9,78.0,,0,0,0,0,,
5879,tt0087942,Prime Risk,1985,Fewer than 50,22,2,6,3,3,25.0,,1,0,1,1,,
5880,tt0078228,The Seniors,1978,50+,63,0,5,1,2.5,0.0,,0,0,0,0,,
5881,tt0425610,Vadakkum Nathan,2006,0,0,0,0,0,,,,0,0,0,0,,
5882,tt0489853,The Ten Commandments: The Musical,2006,500+,797,17,24,29,3,41.0,,0,0,0,0,,
5883,tt0058708,The Unsinkable Molly Brown,1964,"5,000+",6811,230,99,153,3.8,70.0,,9,7,2,9,5.50,78.0
5884,tt0783518,Flight of Fury,2007,"2,500+",3819,66,214,126,2.3,24.0,,2,0,2,2,,
5885,tt0076578,Pumping Iron,1977,"5,000+",9872,2231,433,768,4.2,84.0,,37,34,3,37,7.00,92.0
5886,tt0087578,Wheels on Meals,1984,"5,000+",6897,603,139,276,4,81.0,,4,2,2,4,,
5887,tt1632702,Bouncing Cats,2010,Fewer than 50,9,3,0,1,,,,0,0,0,0,,
5888,tt1236470,Jahan Jaaeyega Hamen Paaeyega,2007,0,0,0,0,0,,,,0,0,0,0,,
5889,tt0075617,ABBA: The Movie,1977,"1,000+",1282,186,87,115,3.8,68.0,,2,2,0,2,,
5890,tt0119163,Full Blast,1999,0,0,0,0,0,,,,0,0,0,0,,
5891,tt0060408,The Fighting Prince of Donegal,1966,Fewer than 50,27,2,10,4,2.7,17.0,,0,0,0,0,,
5892,tt0114717,Trancers 5: Sudden Deth,1994,500+,868,9,37,21,2.5,20.0,,0,0,0,0,,
5893,tt0790816,Pumpkinhead: Blood Feud,2007,500+,719,38,128,71,2.5,23.0,,3,0,3,3,,
5894,tt0099397,Defenseless,1991,500+,690,10,16,7,2.9,38.0,,4,3,1,4,,
5895,tt0058610,The Spy with My Face,1965,Fewer than 50,24,4,7,3,3.4,36.0,,0,0,0,0,,
5896,tt0066907,Chato's Land,1972,"1,000+",1753,96,72,63,3.4,57.0,,1,1,0,1,,
5897,tt1561768,Essential Killing,2010,"2,500+",2598,310,368,172,3,46.0,,53,41,12,53,6.30,77.0
5898,tt0856288,Inside,2007,0,0,0,0,0,,,,0,0,0,0,,
5899,tt0085693,House of the Long Shadows,1983,500+,558,57,81,48,3.2,41.0,,3,3,0,3,,
5900,tt1034402,Pattiyal,2006,0,0,0,0,0,,,,0,0,0,0,,
5901,tt0416496,Bandidas,2006,"10,000+",24982,1356,1783,1137,3.1,43.0,,16,9,7,16,5.40,56.0
5902,tt0263725,Me Without You,2001,"5,000+",6858,638,182,287,4,78.0,,67,45,22,67,6.20,67.0
5903,tt0192006,Eyes Beyond Seeing,1995,100+,170,6,2,6,4.2,75.0,,0,0,0,0,,
5904,tt0458364,Fast Track,2006,0,0,0,0,0,,,,0,0,0,0,,
5905,tt0068317,Brother John,1971,100+,151,20,18,12,3.4,53.0,,2,2,0,2,,
5906,tt0430659,A Tale of Two Sisters,2004,"25,000+",33482,5099,1072,2296,4,83.0,,63,54,9,63,7.10,86.0
5907,tt0200550,Coyote Ugly,2000,"250,000+",699039,20863,8673,15928,3.8,71.0,,103,24,79,103,3.90,23.0
5908,tt0282827,Pappan Priyappetta Pappan,1986,0,0,0,0,0,,,,0,0,0,0,,
5909,tt0235015,Running Mates,2000,250+,406,8,20,10,3.1,30.0,,7,1,6,7,3.70,14.0
5910,tt1451797,Rann,2010,100+,226,35,30,15,3.4,54.0,,1,0,1,1,,
5911,tt0064064,Bambi Meets Godzilla,1969,"1,000+",2475,215,85,121,3.8,72.0,,0,0,0,0,,
5912,tt0077179,Arvind Desai Ki Ajeeb Dastaan,1978,0,0,0,0,0,,,,0,0,0,0,,
5913,tt0339071,Girls Will Be Girls,2003,"5,000+",6483,294,74,159,4.1,80.0,,32,19,13,32,5.60,59.0
5914,tt0062155,Privilege,1967,250+,407,56,18,31,3.8,76.0,,20,11,9,20,7.50,55.0
5915,tt1435529,Laadam,2009,0,0,0,0,0,,,,0,0,0,0,,
5916,tt0082558,The Incredible Shrinking Woman,1981,"5,000+",6052,156,150,149,3.3,51.0,,11,3,8,11,4.20,27.0
5917,tt0364530,Mr. Romeo,1996,Fewer than 50,2,1,1,0,,,,0,0,0,0,,
5918,tt1265633,Arasatchi,2004,Fewer than 50,39,0,2,0,,,,0,0,0,0,,
5919,tt0077532,FM,1978,500+,801,33,20,23,3.6,62.0,,10,2,8,10,5.30,20.0
5920,tt0077655,Last Hurrah for Chivalry,1979,"1,000+",1588,101,19,54,4,84.0,,10,10,0,10,6.70,100.0
5921,tt0402606,Suno Sasurjee,2004,50+,75,0,2,1,,,,0,0,0,0,,
5922,tt0963178,The International,2009,"100,000+",165500,4437,7593,5596,3,37.0,,212,122,90,212,5.80,58.0
5923,tt0168449,The Adventures of Sebastian Cole,1998,"2,500+",2511,157,68,76,3.7,70.0,,24,11,13,24,5.80,46.0
5924,tt0963178,The International,2009,"100,000+",165500,4437,7593,5596,3,37.0,,212,122,90,212,5.80,58.0
5925,tt0298130,The Ring,2002,"250,000+",32459459,40927,43711,1231294,3,48.0,,209,149,60,209,6.60,71.0
5926,tt0203009,Moulin Rouge!,2001,"250,000+",505634,77625,9269,35606,4.3,89.0,,259,193,66,259,7.10,75.0
5927,tt0314063,Immortel (ad vitam),2004,"5,000+",8368,778,681,584,3.2,53.0,,8,3,5,8,4.60,38.0
5928,tt0066256,Pufnstuf,1970,250+,367,38,14,31,3.9,73.0,,1,0,1,1,,
5929,tt0175536,Freeway II: Confessions of a Trickbaby,1999,"2,500+",3533,151,86,118,3.6,64.0,,11,4,7,11,5.40,36.0
5930,tt1939654,Bheja Fry 2,2011,100+,154,8,66,19,2.1,11.0,,1,0,1,1,,
5931,tt0057073,French Dressing,1964,Fewer than 50,5,1,3,1,,,,1,1,0,1,,
5932,tt0339485,Paarthale Paravasam,2001,50+,68,4,4,0,3.6,50.0,,0,0,0,0,,
5933,tt0177876,K-911,1999,"5,000+",5748,121,143,85,3.2,46.0,,6,1,5,6,4.70,17.0
5934,tt0109666,Dream a Little Dream 2,1995,"1,000+",1145,55,81,34,3,40.0,,0,0,0,0,,
5935,tt0110490,Men of War,1994,"2,500+",2798,72,90,57,3.1,44.0,,2,0,2,2,,
5936,tt1961652,Walls of Sand,1994,0,0,0,0,0,,,,0,0,0,0,,
5937,tt0297884,Far from Heaven,2002,"10,000+",23317,3209,835,1103,3.9,79.0,,222,194,28,222,8.20,87.0
5938,tt0074800,Linda Lovelace for President,1975,100+,176,3,5,2,2.6,38.0,,3,2,1,3,,
5939,tt0065884,Impasse,1969,Fewer than 50,9,0,7,4,2.2,0.0,,0,0,0,0,,
5940,tt0297884,Far from Heaven,2002,"10,000+",23317,3209,835,1103,3.9,79.0,,222,194,28,222,8.20,87.0
5941,tt0228808,Sallapam,1996,0,0,0,0,0,,,,0,0,0,0,,
5942,tt0112292,The Adventures of Captain Zoom in Outer Space,1995,0,0,0,0,0,,,,0,0,0,0,,
5943,tt1285216,Dark Nature,2009,50+,59,1,23,8,1.3,4.0,,1,0,1,1,,
5944,tt0364977,Bangkok Haunted,2001,"1,000+",1005,16,32,19,2.9,33.0,,2,0,2,2,,
5945,tt1206086,Rain Fall,2009,250+,309,19,91,41,2.3,17.0,,0,0,0,0,,
5946,tt0092042,Tai-Pan,1986,"1,000+",1554,33,51,34,2.8,39.0,,7,1,6,7,3.70,14.0
5947,tt0420087,A Prairie Home Companion,2006,"50,000+",84119,2453,1721,2106,3.4,59.0,,198,161,37,198,7.10,81.0
5948,tt0411806,Return of the Living Dead: Rave to the Grave,2005,"5,000+",7131,96,488,330,2,16.0,,2,0,2,2,,
5949,tt0260112,Judaai,1980,0,0,0,0,0,,,,0,0,0,0,,
5950,tt0841044,2 Days in Paris,2007,"50,000+",50682,8879,3544,4521,3.6,71.0,,120,105,15,120,6.90,88.0
5951,tt0098519,Troop Beverly Hills,1989,"25,000+",31194,930,578,725,3.6,62.0,,28,4,24,28,4.30,14.0
5952,tt0061736,A Guide for the Married Man,1967,"1,000+",2212,83,36,38,3.8,70.0,,9,4,5,9,6.00,44.0
5953,tt0066927,Cold Turkey,1971,500+,956,69,38,46,3.6,64.0,,15,9,6,15,5.90,60.0
5954,tt0057820,Advance to the Rear,1964,100+,127,6,8,5,2.9,43.0,,0,0,0,0,,
5955,tt0960749,Crazy Sexy Cancer,2007,250+,298,32,6,20,4,84.0,,0,0,0,0,,
5956,tt0375008,Remedy,2005,50+,81,3,6,2,2.8,33.0,,0,0,0,0,,
5957,tt0922547,Parasomnia,2008,500+,555,54,147,92,2.6,27.0,,0,0,0,0,,
5958,tt0431045,Eve and the Fire Horse,2005,"1,000+",1577,148,26,106,4,85.0,,13,10,3,13,7.10,77.0
5959,tt0410097,Hustle & Flow,2005,"100,000+",120254,7021,1489,3541,4,82.0,,162,133,29,162,7.30,82.0
5960,tt0274604,Kannukkul Nilavu,2000,0,0,0,0,0,,,,0,0,0,0,,
5961,tt0187559,Playing Mona Lisa,2000,"1,000+",1247,39,27,17,3.5,59.0,,14,9,5,14,5.00,64.0
5962,tt0239570,All About You,2001,"1,000+",1584,70,16,43,4.3,81.0,,3,1,2,3,,
5963,tt0479647,"Bon Cop, Bad Cop",2006,"10,000+",20418,2342,530,1517,4,82.0,,10,8,2,10,6.20,80.0
5964,tt1630036,Courageous,2011,"25,000+",27824,7781,1279,2258,4.3,86.0,,22,8,14,22,5.00,36.0
5965,tt0339806,Torremolinos 73,2003,"1,000+",1781,192,88,70,3.6,69.0,,40,28,12,40,6.40,70.0
5966,tt0291341,Mean Machine,2001,"25,000+",38187,2499,965,1174,3.8,72.0,,56,19,37,56,4.90,34.0
5967,tt0072596,Aaron Loves Angela,1975,Fewer than 50,19,5,1,1,3.8,83.0,,2,1,1,2,,
5968,tt0331421,Akhiyon Se Goli Maare,2002,0,0,0,0,0,,,,0,0,0,0,,
5969,tt0064915,Saat Hindustani,1969,0,0,0,0,0,,,,0,0,0,0,,
5970,tt0109484,"Corrina, Corrina",1994,"25,000+",48344,1182,527,753,3.7,69.0,,19,7,12,19,5.30,37.0
5971,tt0093743,Pinocchio and the Emperor of the Night,1987,500+,887,30,20,23,3.4,60.0,,6,3,3,6,4.90,50.0
5972,tt1351177,Last of the Living,2009,250+,430,37,135,95,2.4,22.0,,1,0,1,1,,
5973,tt2325539,Bagavathi,2002,0,0,0,0,0,,,,0,0,0,0,,
5974,tt0102687,Poison,1991,0,0,0,0,0,,,,0,0,0,0,,
5975,tt0125249,Inspirations,1997,Fewer than 50,42,1,0,0,,,,3,1,2,3,,
5976,tt0758789,Tsunami: The Aftermath,2006,"1,000+",1176,134,59,88,3.7,69.0,,3,1,2,3,,
5977,tt0095943,Quelques jours avec moi,1988,0,0,0,0,0,,,,0,0,0,0,,
5978,tt0471561,Fire Serpent,2007,250+,432,5,64,36,1.7,7.0,,1,0,1,1,,
5979,tt0412523,Boa vs. Python,2004,"5,000+",7745,111,288,234,2.3,28.0,,2,0,2,2,,
5980,tt0275947,Avenging Angelo,2002,"5,000+",5110,110,220,90,2.8,33.0,,8,1,7,8,4.40,13.0
5981,tt0057453,Return to Oz,1964,Fewer than 50,1,1,0,1,,,,1,1,0,1,,
5982,tt2359290,Sudigaadu,2012,Fewer than 50,25,2,4,0,3.2,33.0,,0,0,0,0,,
5983,tt1411238,No Strings Attached,2011,"50,000+",89280,15084,14412,4977,3.3,51.0,,173,82,91,173,5.30,47.0
5984,tt0338109,Homeless to Harvard: The Liz Murray Story,2003,"1,000+",1914,289,68,101,4.1,81.0,,0,0,0,0,,
5985,tt1129381,Lower Learning,2008,"1,000+",1122,56,265,135,2.1,17.0,,1,0,1,1,,
5986,tt0918927,Doubt,2008,"100,000+",162643,17977,5010,10481,3.8,78.0,,219,173,46,219,7.00,79.0
5987,tt0068744,Intimate Confessions of a Chinese Courtesan,1972,100+,217,22,8,19,3.8,73.0,,0,0,0,0,,
5988,tt0449077,The Net 2.0,2006,"2,500+",3374,99,181,102,2.8,35.0,,1,0,1,1,,
5989,tt0178821,Passing Glory,1999,100+,130,12,3,1,4.1,79.0,,3,2,1,3,,
5990,tt0056405,Reptilicus,1961,"1,000+",1303,49,154,80,2.2,24.0,,8,2,6,8,3.90,25.0
5991,tt0290098,Varnapakittu,1997,0,0,0,0,0,,,,0,0,0,0,,
5992,tt0100248,The Night Brings Charlie,1990,50+,92,3,8,3,2.5,27.0,,0,0,0,0,,
5993,tt1015470,A Single Woman,2008,Fewer than 50,22,2,3,3,2.5,40.0,,1,0,1,1,,
5994,tt1086216,Uncertainty,2008,"1,000+",2484,314,651,264,2.9,33.0,,26,13,13,26,5.40,50.0
5995,tt0268126,Adaptation.,2002,"100,000+",188978,26840,4667,8495,4,85.0,,210,190,20,210,8.20,90.0
5996,tt0079550,Meteor,1979,500+,949,32,196,85,2.2,14.0,,22,1,21,22,3.70,5.0
5997,tt0850667,Faith Like Potatoes,2006,"1,000+",1435,330,107,143,4,76.0,,0,0,0,0,,
5998,tt0083352,Dreadnaugh,1981,"1,000+",1496,47,8,24,3.9,85.0,,6,4,2,6,5.00,67.0
5999,tt0368226,The Room,2003,"10,000+",10054,2900,3275,2607,2.8,47.0,,33,8,25,33,3.60,24.0
6000,tt0246578,Donnie Darko,2001,"250,000+",30984568,116799,28573,871660,3.1,80.0,,119,104,15,119,7.60,87.0
6001,tt1029235,Max Manus,2008,"2,500+",3135,801,168,278,3.9,83.0,,34,27,7,34,6.70,79.0
6002,tt0116928,Love Is All There Is,1996,"2,500+",3262,55,63,45,3.2,47.0,,2,0,2,2,,
6003,tt1292642,Allah Ke Banday,2010,Fewer than 50,19,2,5,4,2.1,29.0,,1,0,1,1,,
6004,tt0155180,Sindhu Bhairavi,1985,0,0,0,0,0,,,,0,0,0,0,,
6005,tt0102835,Sanam Bewafa,1991,50+,90,7,6,1,3.3,54.0,,0,0,0,0,,
6006,tt1305879,Annan Thambi,2008,Fewer than 50,15,1,1,0,,,,0,0,0,0,,
6007,tt0140673,Veera,1994,Fewer than 50,1,1,0,0,,,,0,0,0,0,,
6008,tt1920986,Khuda Kasam,2010,0,0,0,0,0,,,,0,0,0,0,,
6009,tt0248169,Manna from Heaven,2002,"1,000+",1030,9,8,8,3.4,53.0,,23,5,18,23,4.20,22.0
6010,tt1261945,Sex and the City 2,2010,"250,000+",324374,8155,10699,5700,3,43.0,,221,34,187,221,3.80,15.0
6011,tt0339534,Prison-a-Go-Go!,2003,100+,208,12,5,7,3.4,71.0,,2,1,1,2,,
6012,tt0104575,Just Another Girl on the I.R.T.,1992,"1,000+",1406,168,35,60,4.2,83.0,,49,33,16,49,6.00,67.0
6013,tt0113443,It's My Party,1996,"2,500+",4165,242,63,132,4,79.0,,16,8,8,16,5.70,50.0
6014,tt0433963,Dark Ride,2006,"5,000+",6404,271,658,544,2.7,29.0,,3,0,3,3,,
6015,tt0140348,Mahanadhi,1994,Fewer than 50,2,2,0,0,,,,0,0,0,0,,
6016,tt0204175,Boys and Girls,2000,"25,000+",28234,870,876,548,3.3,50.0,,63,7,56,63,3.90,11.0
6017,tt1629440,Sharpay's Fabulous Adventure,2011,"1,000+",1072,197,261,87,3.1,43.0,,5,3,2,5,5.60,60.0
6018,tt0938291,A Stranger's Heart,2007,100+,237,18,19,11,3.2,49.0,,0,0,0,0,,
6019,tt1064884,Jesse Stone: Thin Ice,2009,250+,423,90,61,36,3.5,60.0,,1,0,1,1,,
6020,tt0800241,Transsiberian,2008,"10,000+",16320,3552,1920,2030,3.5,65.0,,101,92,9,101,7.20,91.0
6021,tt0435653,The Gravedancers,2006,"5,000+",7730,683,841,785,3.1,45.0,,6,6,0,6,7.00,100.0
6022,tt0278282,Adhyayam Onnu Muthal,1985,0,0,0,0,0,,,,0,0,0,0,,
6023,tt1758692,Like Crazy,2011,"10,000+",19482,5176,3242,1413,3.5,61.0,,154,110,44,154,6.60,71.0
6024,tt0214557,Burlesk King,1999,250+,346,0,4,1,,,,2,1,1,2,,
6025,tt0094077,Surf Nazis Must Die,1987,"5,000+",5011,132,306,218,2.6,30.0,,6,1,5,6,3.80,17.0
6026,tt0075754,Billy Jack Goes to Washington,1977,"1,000+",2025,16,28,16,2.7,36.0,,8,0,8,8,3.20,0.0
6027,tt2014389,Veppam,2011,0,0,0,0,0,,,,0,0,0,0,,
6028,tt0331256,Gunaah,2002,50+,93,3,8,1,2.4,27.0,,0,0,0,0,,
6029,tt0095326,Hot to Trot,1988,"2,500+",2813,98,143,105,2.9,41.0,,16,0,16,16,2.60,0.0
6030,tt1230544,Konchem Ishtam Konchem Kashtam,2009,0,0,0,0,0,,,,0,0,0,0,,
6031,tt1702443,Justin Bieber: Never Say Never,2011,"50,000+",62234,5764,3154,2359,3.5,65.0,,108,71,37,108,5.80,66.0
6032,tt0357905,Minnale,2001,100+,236,41,3,6,4.3,93.0,,0,0,0,0,,
6033,tt1398944,Bhalobasa Bhalobasa,2008,Fewer than 50,1,1,0,0,,,,0,0,0,0,,
6034,tt1400526,Lost Boys: The Thirst,2010,"1,000+",1608,244,490,297,2.8,33.0,,7,0,7,7,4.10,0.0
6035,tt0110730,Once in a Lifetime,1994,0,0,0,0,0,,,,0,0,0,0,,
6036,tt0113317,Hollywood Zap,1986,50+,72,3,2,2,3,60.0,,0,0,0,0,,
6037,tt0366435,Fear and Trembling,2004,"2,500+",2788,317,96,135,3.7,77.0,,34,31,3,34,7.30,91.0
6038,tt0843372,Sainikudu,2006,250+,340,6,7,5,3.3,46.0,,0,0,0,0,,
6039,tt0105488,Strictly Ballroom,1992,"25,000+",43373,4417,645,2111,4.2,87.0,,49,43,6,49,7.40,88.0
6040,tt1392744,Chance Pe Dance,2010,500+,750,86,123,67,3,41.0,,2,0,2,2,,
6041,tt1052027,Ratko: The Dictator's Son,2009,50+,54,4,10,4,2.5,29.0,,0,0,0,0,,
6042,tt0116952,Macadam tribu,1996,0,0,0,0,0,,,,0,0,0,0,,
6043,tt0266987,Spy Game,2001,"100,000+",114210,7459,2477,2366,3.8,75.0,,135,87,48,135,6.20,64.0
6044,tt0066415,The Strawberry Statement,1970,500+,770,54,20,25,3.9,73.0,,3,1,2,3,,
6045,tt0080596,The Day Time Ended,1979,"1,000+",1237,4,34,18,1.9,11.0,,0,0,0,0,,
6046,tt0338726,Aquanoids,2003,250+,385,5,21,14,1.6,19.0,,3,0,3,3,,
6047,tt1740676,Inkosari,2010,0,0,0,0,0,,,,0,0,0,0,,
6048,tt0337881,Blind Horizon,2003,"1,000+",2169,70,151,74,2.8,32.0,,4,2,2,4,,
6049,tt1267389,The Judge and the General,2008,50+,64,2,1,1,,,,0,0,0,0,,
6050,tt0055458,Snow White and the Three Stooges,1961,250+,386,28,26,23,3.4,52.0,,2,0,2,2,,
6051,tt1523491,Kurtlar Vadisi: Gladio,2009,0,0,0,0,0,,,,0,0,0,0,,
6052,tt0920467,Off the Grid: Life on the Mesa,2007,50+,80,20,8,8,3.7,71.0,,4,4,0,4,,
6053,tt0146791,Gharana,1961,0,0,0,0,0,,,,0,0,0,0,,
6054,tt0099832,Impulse,1990,50+,79,4,17,5,2.5,19.0,,9,3,6,9,4.60,33.0
6055,tt0337899,Broke Sky,2007,50+,95,7,5,4,3.7,58.0,,0,0,0,0,,
6056,tt0149252,Tender Loving Care,1996,0,0,0,0,0,,,,0,0,0,0,,
6057,tt2246549,Abraham Lincoln vs. Zombies,2012,500+,547,84,310,158,2.2,21.0,,4,1,3,4,,
6058,tt0826613,Extraordinary Rendition,2007,250+,345,26,28,24,3.1,48.0,,0,0,0,0,,
6059,tt1446483,Luna caliente,2009,0,0,0,0,0,,,,0,0,0,0,,
6060,tt0169140,Porkkalam,1998,0,0,0,0,0,,,,0,0,0,0,,
6061,tt0419160,Spirit Trap,2005,500+,890,43,119,93,2.6,27.0,,5,1,4,5,4.20,20.0
6062,tt0086489,Twice Upon a Time,1983,500+,567,105,11,48,4.2,91.0,,2,2,0,2,,
6063,tt0338450,Sniper 2,2002,"5,000+",6846,177,246,97,3.1,42.0,,3,1,2,3,,
6064,tt1621429,S.W.A.T.: Firefight,2011,"1,000+",1197,225,444,162,2.8,34.0,,3,2,1,3,,
6065,tt0280791,The Journey of Jared Price,2000,500+,799,11,16,13,3.2,41.0,,0,0,0,0,,
6066,tt1334470,Raavan,2010,100+,100,30,34,8,3.1,47.0,,3,1,2,3,,
6067,tt1550312,Café de Flore,2011,"2,500+",4030,768,245,163,3.8,76.0,,56,36,20,56,6.40,64.0
6068,tt1235404,31 North 62 East,2009,100+,105,8,18,13,2.4,31.0,,13,1,12,13,3.00,8.0
6069,tt1869640,Rajanna,2011,100+,195,8,2,1,3.8,80.0,,0,0,0,0,,
6070,tt0087688,Mass Appeal,1984,500+,891,49,11,21,3.8,82.0,,5,5,0,5,6.80,100.0
6071,tt0860550,Till I Met You,2006,250+,323,4,2,2,4,67.0,,0,0,0,0,,
6072,tt0288427,Angaaray,1998,0,0,0,0,0,,,,0,0,0,0,,
6073,tt1091722,Adventureland,2009,"250,000+",253072,17334,11140,8603,3.4,61.0,,217,192,25,217,7.30,88.0
6074,tt0492890,The Wild Stallion,2009,250+,257,32,35,16,3.3,48.0,,0,0,0,0,,
6075,tt0107525,Martial Outlaw,1993,100+,110,4,8,5,3.1,33.0,,0,0,0,0,,
6076,tt0275258,Mothers and Daughters,2006,Fewer than 50,19,0,1,0,,,,0,0,0,0,,
6077,tt0171214,Dash and Lilly,1999,Fewer than 50,15,4,2,1,3.9,67.0,,2,1,1,2,,
6078,tt11867398,Tharle Nan Maga,1992,0,0,0,0,0,,,,0,0,0,0,,
6079,tt0362445,Bewafai,1985,Fewer than 50,43,0,1,1,,,,0,0,0,0,,
6080,tt0404388,Love Rules!,2004,50+,59,5,7,0,2.6,42.0,,0,0,0,0,,
6081,tt0462069,Zombie Night,2003,500+,521,10,88,40,1.6,10.0,,1,0,1,1,,
6082,tt0108399,True Romance,1993,"100,000+",192833,31179,2372,9531,4.4,93.0,,61,57,4,61,7.60,93.0
6083,tt0765476,Meet Dave,2008,"100,000+",159900,2236,4165,2754,2.8,35.0,,102,20,82,102,4.30,20.0
6084,tt0085390,Daffy Duck's Movie: Fantastic Island,1983,500+,632,72,35,19,3.7,67.0,,0,0,0,0,,
6085,tt2040560,The Pact,2012,"10,000+",10216,1676,2373,694,3,41.0,,40,26,14,40,5.80,65.0
6086,tt0089537,Mala Noche,1986,"1,000+",2036,301,169,128,3.5,64.0,,25,24,1,25,7.70,96.0
6087,tt0880578,Untraceable,2008,"100,000+",225184,9286,8688,9204,3.3,52.0,,147,24,123,147,4.30,16.0
6088,tt0098093,Physical Evidence,1989,"1,000+",1391,5,41,16,2.3,11.0,,18,4,14,18,3.90,22.0
6089,tt0127919,Tale of the Mummy,1998,"2,500+",3196,21,104,51,2.3,17.0,,6,1,5,6,4.20,17.0
6090,tt0391536,Wrong Number,2003,0,0,0,0,0,,,,0,0,0,0,,
6091,tt0120902,The X Files,1998,"50,000+",66613,5050,1928,2700,3.8,72.0,,74,49,25,74,6.20,66.0
6092,tt0460749,The Coffin,2008,0,0,0,0,0,,,,0,0,0,0,,
6093,tt0254845,Vasantha Maligai,1972,Fewer than 50,27,1,0,0,,,,0,0,0,0,,
6094,tt0796368,Talk to Me,2007,"25,000+",41569,3365,983,2117,3.8,77.0,,132,109,23,132,6.90,83.0
6095,tt0119694,Mondo Bobo,1997,0,0,0,0,0,,,,1,0,1,1,,
6096,tt0089444,Krush Groove,1985,"2,500+",4720,373,91,187,4.2,81.0,,7,3,4,7,5.50,43.0
6097,tt0088807,Billy the Kid and the Green Baize Vampire,1985,100+,108,7,5,4,3.8,58.0,,0,0,0,0,,
6098,tt0446298,Civic Duty,2006,"25,000+",29708,185,376,268,2.8,33.0,,57,32,25,57,5.90,56.0
6099,tt1131734,Jennifer's Body,2009,"250,000+",359638,7802,14382,8245,2.8,35.0,,214,98,116,214,5.20,46.0
6100,tt1131734,Jennifer's Body,2009,"250,000+",359638,7802,14382,8245,2.8,35.0,,214,98,116,214,5.20,46.0
6101,tt1666166,Kappalu Muthalali,2009,0,0,0,0,0,,,,0,0,0,0,,
6102,tt0796302,The Babysitters,2007,"2,500+",3730,357,843,397,2.8,30.0,,26,9,17,26,4.40,35.0
6103,tt1691453,Knockout,2011,250+,436,61,152,56,2.8,28.0,,2,2,0,2,,
6104,tt1078917,The Only Good Indian,2009,100+,106,21,9,7,3.7,70.0,,1,0,1,1,,
6105,tt0094882,Clara's Heart,1988,"1,000+",1674,96,67,37,3.5,59.0,,17,8,9,17,5.40,47.0
6106,tt0200208,The Thirteenth Year,1999,"1,000+",1135,174,150,73,3.4,54.0,,3,3,0,3,,
6107,tt0110438,Main Khiladi Tu Anari,1994,250+,342,25,13,7,3.5,66.0,,0,0,0,0,,
6108,tt0324992,American Cousins,2003,100+,234,18,19,19,3.4,49.0,,4,2,2,4,,
6109,tt0070909,Westworld,1973,"10,000+",16247,2147,928,964,3.6,70.0,,43,36,7,43,7.00,84.0
6110,tt0265343,Monsoon Wedding,2001,"25,000+",27618,3496,523,1157,4.1,87.0,,132,125,7,132,7.90,95.0
6111,tt1224373,Slovenka,2009,50+,56,15,5,3,3.7,75.0,,0,0,0,0,,
6112,tt0890885,Saturno contro,2007,"1,000+",2265,357,131,108,3.7,73.0,,2,2,0,2,,
6113,tt1525366,Grabbers,2012,"2,500+",2527,628,591,284,3.3,51.0,,33,23,10,33,6.10,70.0
6114,tt0081401,Ram Balram,1980,250+,281,9,3,3,3.9,75.0,,0,0,0,0,,
6115,tt0114558,Strange Days,1995,"25,000+",35373,3264,1230,1304,3.7,73.0,,56,38,18,56,6.50,68.0
6116,tt0357829,Kalyanaraman,2002,0,0,0,0,0,,,,0,0,0,0,,
6117,tt0319845,Mela Thiranthathu Kadhavu,1986,0,0,0,0,0,,,,0,0,0,0,,
6118,tt0972789,Changathipoocha,2007,0,0,0,0,0,,,,0,0,0,0,,
6119,tt0196106,MVP: Most Valuable Primate,2000,"5,000+",7143,102,151,115,2.9,40.0,,5,2,3,5,5.00,40.0
6120,tt0338325,Paparazzi,2004,"10,000+",18367,496,794,460,2.8,38.0,,85,15,70,85,3.80,18.0
6121,tt1640484,Jumping the Broom,2011,"10,000+",19574,2098,1499,771,3.5,58.0,,84,48,36,84,6.10,57.0
6122,tt0225009,964 Pinocchio,1991,Fewer than 50,4,4,0,2,,,,0,0,0,0,,
6123,tt1121786,Formosa Betrayed,2009,250+,436,102,85,65,3.3,55.0,,30,10,20,30,5.00,33.0
6124,tt1077012,Special People,2007,50+,54,2,0,2,,,,9,8,1,9,6.20,89.0
6125,tt0097707,The Lady and the Highwayman,1988,"1,000+",1342,30,35,26,3.1,47.0,,0,0,0,0,,
6126,tt0372532,The Wedding Date,2005,"100,000+",203109,8093,3947,4952,3.7,67.0,,142,16,126,142,3.90,11.0
6127,tt0372532,The Wedding Date,2005,"100,000+",203109,8093,3947,4952,3.7,67.0,,142,16,126,142,3.90,11.0
6128,tt0085886,Mahaan,1983,Fewer than 50,1,1,0,0,,,,0,0,0,0,,
6129,tt0154627,Idi Kathakaadu,1979,0,0,0,0,0,,,,0,0,0,0,,
6130,tt0091065,Flying,1986,100+,187,2,3,4,3.4,40.0,,0,0,0,0,,
6131,tt0893509,Blonde and Blonder,2008,"1,000+",2399,61,329,197,1.8,16.0,,4,1,3,4,,
6132,tt0233657,Epoch,2001,"1,000+",1292,20,104,42,2.3,16.0,,0,0,0,0,,
6133,tt0318374,The Cooler,2003,"10,000+",19294,1976,874,876,3.6,69.0,,173,134,39,173,6.70,77.0
6134,tt0960741,The Canyon,2009,500+,621,88,185,91,2.8,32.0,,14,4,10,14,4.60,29.0
6135,tt0112887,The Doom Generation,1995,"5,000+",9369,1083,668,623,3.4,62.0,,40,22,18,40,5.30,55.0
6136,tt2137002,Humanap ka ng panget,1991,0,0,0,0,0,,,,0,0,0,0,,
6137,tt0478304,The Tree of Life,2011,"50,000+",61116,13781,9083,6465,3.4,60.0,,298,252,46,298,8.20,85.0
6138,tt0406038,Loggerheads,2005,"10,000+",13323,113,61,63,3.7,65.0,,50,37,13,50,6.50,74.0
6139,tt0478304,The Tree of Life,2011,"50,000+",61116,13781,9083,6465,3.4,60.0,,298,252,46,298,8.20,85.0
6140,tt0096252,Tezaab,1988,500+,645,35,26,15,3.4,58.0,,0,0,0,0,,
6141,tt0095562,Macho Dancer,1988,50+,82,7,3,4,3.8,70.0,,4,4,0,4,,
6142,tt2199665,The Sleeping Soul,2012,Fewer than 50,1,1,0,1,,,,0,0,0,0,,
6143,tt0130623,Dinosaur,2000,"50,000+",71391,2178,2364,1502,3.2,48.0,,124,80,44,124,6.20,65.0
6144,tt0127702,The Night Caller,1998,50+,93,9,12,8,3.1,43.0,,3,1,2,3,,
6145,tt0378611,Punk Rock Holocaust,2004,Fewer than 50,15,2,1,1,,,,0,0,0,0,,
6146,tt1820526,Marykkundoru Kunjaadu,2010,Fewer than 50,24,4,1,0,4,80.0,,0,0,0,0,,
6147,tt0415679,Boy Eats Girl,2005,"2,500+",3548,191,381,335,2.8,33.0,,0,0,0,0,,
6148,tt0119687,Moe no Suzaku,1997,50+,99,13,2,3,3.8,87.0,,0,0,0,0,,
6149,tt0159730,The Sex Monster,1999,"2,500+",2689,64,78,63,3.1,45.0,,6,2,4,6,4.80,33.0
6150,tt0144039,Atomic Train,1999,250+,296,20,43,21,2.5,32.0,,4,0,4,4,,
6151,tt0322788,Ishtam,2001,0,0,0,0,0,,,,0,0,0,0,,
6152,tt1320296,Shank,2010,"2,500+",3587,131,278,132,2.6,32.0,,11,1,10,11,3.90,9.0
6153,tt0098168,Ram Lakhan,1989,500+,674,51,29,16,3.7,63.0,,0,0,0,0,,
6154,tt1320296,Shank,2010,"2,500+",3587,131,278,132,2.6,32.0,,11,1,10,11,3.90,9.0
6155,tt1050739,Roadside Romeo,2008,500+,580,74,73,58,3.1,50.0,,6,3,3,6,4.00,50.0
6156,tt0101812,The End of Innocence,1990,50+,66,2,3,1,2.9,40.0,,5,0,5,5,3.60,0.0
6157,tt0053911,High School Caesar,1960,50+,71,3,1,0,,,,0,0,0,0,,
6158,tt1360832,Soundless Wind Chime,2009,100+,149,28,29,20,3.2,49.0,,0,0,0,0,,
6159,tt0058092,Father Goose,1964,"5,000+",9305,1062,178,394,4.1,86.0,,15,12,3,15,6.60,80.0
6160,tt0924134,The Year of Getting to Know Us,2008,250+,490,14,101,36,2.2,12.0,,3,0,3,3,,
6161,tt0103639,Aladdin,1992,Fewer than 50,19,1,5,2,2.2,17.0,,0,0,0,0,,
6162,tt2363047,22 Female Kottayam,2012,50+,57,21,7,5,3.5,75.0,,0,0,0,0,,
6163,tt0247745,Super Troopers,2001,"250,000+",263035,35955,4183,12971,4.3,90.0,,90,32,58,90,5.20,36.0
6164,tt1023114,The Way Back,2010,0,0,0,0,0,,,,0,0,0,0,,
6165,tt0103010,Surviving Desire,1992,"1,000+",1158,132,16,35,4.1,89.0,,1,1,0,1,,
6166,tt0155775,Jawani Diwani,1972,0,0,0,0,0,,,,0,0,0,0,,
6167,tt1977713,Banglar Nayok,1995,0,0,0,0,0,,,,0,0,0,0,,
6168,tt0358992,Bedardi,1993,0,0,0,0,0,,,,0,0,0,0,,
6169,tt0098014,Offerings,1989,100+,104,7,28,15,2.5,20.0,,1,0,1,1,,
6170,tt0299108,Rehnaa Hai Terre Dil Mein,2001,0,0,0,0,0,,,,0,0,0,0,,
6171,tt0064782,Paint Your Wagon,1969,"5,000+",8389,714,343,502,3.7,68.0,,18,6,12,18,4.60,33.0
6172,tt0387678,Waisa Bhi Hota Hai Part II,2003,50+,84,8,1,2,4.2,89.0,,0,0,0,0,,
6173,tt0882978,Three Kingdoms: Resurrection of the Dragon,2008,"5,000+",7909,427,513,389,3.1,45.0,,0,0,0,0,,
6174,tt0248803,First Target,2000,100+,242,8,11,4,3.1,42.0,,0,0,0,0,,
6175,tt0443456,Breaking and Entering,2006,"50,000+",57478,2811,2562,1740,3.2,52.0,,131,45,86,131,5.20,34.0
6176,tt0484111,The Good Night,2007,"5,000+",5284,458,932,667,2.8,33.0,,43,13,30,43,4.90,30.0
6177,tt0086192,Revenge of the Ninja,1983,"2,500+",4655,250,186,214,3.4,57.0,,3,2,1,3,,
6178,tt0080854,Heart Beat,1980,Fewer than 50,49,4,6,1,3.1,40.0,,5,1,4,5,5.60,20.0
6179,tt0772185,Santa Baby,2006,500+,683,80,110,49,3.2,42.0,,1,1,0,1,,
6180,tt0291855,Devasuram,1993,0,0,0,0,0,,,,0,0,0,0,,
6181,tt0089346,Into the Night,1985,"2,500+",3449,233,245,141,3.2,49.0,,25,10,15,25,4.60,40.0
6182,tt0062819,Commandos,1968,"1,000+",1649,10,18,8,3.1,36.0,,0,0,0,0,,
6183,tt0077538,Enter the Fat Dragon,1978,"1,000+",1710,48,21,32,3.8,70.0,,1,0,1,1,,
6184,tt0102208,Killer Instinct,1991,0,0,0,0,0,,,,0,0,0,0,,
6185,tt0102208,Killer Instinct,1991,0,0,0,0,0,,,,0,0,0,0,,
6186,tt0095638,The Milagro Beanfield War,1988,"2,500+",3506,322,111,120,3.8,74.0,,33,20,13,33,6.20,61.0
6187,tt0437182,Family: Ties of Blood,2006,50+,66,8,7,6,3.6,53.0,,1,0,1,1,,
6188,tt1521787,Haunting of Winchester House,2009,500+,562,24,145,79,1.9,14.0,,1,0,1,1,,
6189,tt0076294,The Last Dinosaur,1977,50+,89,10,10,10,3,50.0,,4,1,3,4,,
6190,tt1941638,Sadda Adda,2012,Fewer than 50,1,0,1,0,,,,1,0,1,1,,
6191,tt0134969,Soccer Dog: The Movie,1999,"5,000+",7520,91,59,91,3.4,61.0,,1,0,1,1,,
6192,tt0321353,Baadasssss Cinema,2002,"1,000+",1176,55,26,28,3.6,68.0,,2,2,0,2,,
6193,tt0062844,Custer of the West,1967,500+,821,12,25,21,3,32.0,,8,2,6,8,4.20,25.0
6194,tt1723594,Barbie and the Three Musketeers,2009,500+,736,104,57,23,3.7,65.0,,1,1,0,1,,
6195,tt0086610,Xtro,1982,"1,000+",2128,132,230,161,2.9,36.0,,9,4,5,9,5.30,44.0
6196,tt1731697,The Lords of Salem,2012,"10,000+",14017,1526,3590,966,2.5,30.0,,67,32,35,67,5.40,48.0
6197,tt0154685,Johny Mera Naam,1970,0,0,0,0,0,,,,0,0,0,0,,
6198,tt0366777,Millions,2004,"25,000+",29753,3237,934,1697,3.8,78.0,,160,140,20,160,7.40,88.0
6199,tt19370716,H.G. Wells and the War of the Worlds,2005,500+,938,3,5,1,2.9,38.0,,0,0,0,0,,
6200,tt0222666,24 Hours in London,2000,100+,148,3,4,2,2.9,43.0,,0,0,0,0,,
6201,tt0246279,Tingu Rangadu,1982,0,0,0,0,0,,,,0,0,0,0,,
6202,tt1493886,The Wild Hunt,2009,500+,713,259,90,111,3.7,74.0,,11,9,2,11,6.70,82.0
6203,tt2071405,Aha Naa Pellanta,2011,0,0,0,0,0,,,,0,0,0,0,,
6204,tt0088196,Streetwise,1984,250+,321,86,2,23,4.5,98.0,,14,13,1,14,8.50,93.0
6205,tt0095311,Hit List,1989,50+,76,1,8,4,2.4,11.0,,0,0,0,0,,
6206,tt1403988,The Romantics,2010,"10,000+",14766,450,1667,426,2.4,21.0,,35,5,30,35,4.40,14.0
6207,tt1060255,The Horseman,2008,"1,000+",2324,288,210,215,3.4,58.0,,30,18,12,30,5.90,60.0
6208,tt0082094,The Boogens,1981,500+,528,43,98,62,2.8,30.0,,9,2,7,9,4.00,22.0
6209,tt1699720,Women Art Revolution,2010,100+,219,28,20,11,3.7,58.0,,25,21,4,25,6.90,84.0
6210,tt0059921,The World of Abbott and Costello,1965,0,0,0,0,0,,,,0,0,0,0,,
6211,tt0478213,A New Day in Old Sana'a,2005,250+,450,10,14,6,3.1,42.0,,0,0,0,0,,
6212,tt0780158,Sun Dogs,2006,0,0,0,0,0,,,,0,0,0,0,,
6213,tt0329691,Torque,2004,"50,000+",71139,1613,2359,1474,2.9,41.0,,116,26,90,116,4.30,22.0
6214,tt0155853,Manavoori Pandavulu,1978,0,0,0,0,0,,,,0,0,0,0,,
6215,tt0095658,Mortu Nega,1988,Fewer than 50,3,3,0,2,,,,0,0,0,0,,
6216,tt0186655,Universal Soldier III: Unfinished Business,1998,250+,411,22,60,23,2.2,27.0,,5,1,4,5,4.40,20.0
6217,tt0056943,The Comedy of Terrors,1963,500+,842,205,91,92,3.7,69.0,,9,8,1,9,7.20,89.0
6218,tt0492502,Wide Awake,2006,100+,115,7,13,8,3,35.0,,0,0,0,0,,
6219,tt0367188,Modigliani,2004,"2,500+",4771,719,201,223,4,78.0,,24,1,23,24,3.70,4.0
6220,tt1621444,Bill Cunningham New York,2010,"2,500+",4042,1340,122,312,4.3,92.0,,74,73,1,74,8.00,99.0
6221,tt0056676,The War Lover,1962,500+,908,30,34,26,3.3,47.0,,4,2,2,4,,
6222,tt1167638,22 Bullets,2010,"1,000+",2430,698,566,310,3.3,55.0,,13,6,7,13,5.20,46.0
6223,tt0934863,You Got Me!,2007,500+,873,66,14,53,4.2,82.0,,0,0,0,0,,
6224,tt0064002,Alice's Restaurant,1969,"2,500+",3665,241,165,141,3.5,59.0,,19,12,7,19,6.20,63.0
6225,tt1650547,T.D. Dasan Std: VI. B,2010,Fewer than 50,10,3,0,1,,,,0,0,0,0,,
6226,tt0462362,The Insatiable,2006,500+,520,40,72,59,2.9,36.0,,1,1,0,1,,
6227,tt0085361,Coolie,1983,500+,835,63,21,21,3.9,75.0,,0,0,0,0,,
6228,tt0076650,SST: Death Flight,1977,50+,58,1,12,9,1.7,8.0,,0,0,0,0,,
6229,tt0443448,O Jerusalem,2006,500+,718,70,48,34,3.4,60.0,,22,8,14,22,4.60,36.0
6230,tt1127870,Mumbai Salsa,2007,250+,371,14,34,26,2.4,29.0,,1,0,1,1,,
6231,tt0466923,The Perfect Stranger,2005,500+,990,85,14,42,4.2,86.0,,0,0,0,0,,
6232,tt0422401,Hatchet,2006,"10,000+",13876,1909,2343,2240,3,45.0,,51,29,22,51,5.60,57.0
6233,tt0094846,Casual Sex?,1988,"5,000+",6639,74,180,101,2.8,29.0,,13,4,9,13,3.80,31.0
6234,tt1081935,Baarìa,2009,"1,000+",1227,209,208,110,3.3,50.0,,11,6,5,11,5.40,55.0
6235,tt0246894,Rollerball,2002,"25,000+",36842,258,1549,759,1.9,14.0,,119,4,115,119,2.80,3.0
6236,tt0101538,Campfire Tales,1991,250+,334,2,17,10,2.6,11.0,,0,0,0,0,,
6237,tt1764200,Bhariya Onnu Makkal Moonnu,2009,0,0,0,0,0,,,,0,0,0,0,,
6238,tt0102303,Life Stinks,1991,"5,000+",7478,295,356,205,3.1,45.0,,19,4,15,19,4.10,21.0
6239,tt1471247,Road to Sangam,2009,Fewer than 50,39,12,2,6,3.9,86.0,,1,0,1,1,,
6240,tt0318803,Velai Kidaichiruchu,1990,0,0,0,0,0,,,,0,0,0,0,,
6241,tt0990404,Chop Shop,2007,"2,500+",2727,585,177,280,3.8,77.0,,61,59,2,61,7.90,97.0
6242,tt0499464,Dracula's Curse,2006,250+,294,7,18,11,2.7,29.0,,0,0,0,0,,
6243,tt0073631,Rollerball,1975,"10,000+",12350,1006,630,611,3.5,61.0,,36,24,12,36,6.20,67.0
6244,tt0870032,Bon Voyage,2006,0,0,0,0,0,,,,0,0,0,0,,
6245,tt0258871,Parallel College,1991,0,0,0,0,0,,,,0,0,0,0,,
6246,tt0057332,Mujhe Jeene Do,1963,0,0,0,0,0,,,,0,0,0,0,,
6247,tt0261601,Carnal Knowledge,1970,"5,000+",5575,643,247,261,3.7,72.0,,34,30,4,34,7.70,88.0
6248,tt0378072,Hum Tum,2004,"5,000+",9269,1280,202,417,4.2,86.0,,2,2,0,2,,
6249,tt0416449,300,2006,"250,000+",1435905,332961,42586,151549,4.3,89.0,,236,144,92,236,6.10,61.0
6250,tt0059102,Dial 'P' for Pink,1965,Fewer than 50,1,1,0,0,,,,0,0,0,0,,
6251,tt0408839,The Heartbreak Kid,2007,"250,000+",315450,12262,20951,13602,2.9,37.0,,158,46,112,158,4.70,29.0
6252,tt0093171,Hell Comes to Frogtown,1988,"2,500+",3061,223,258,232,3.1,46.0,,9,5,4,9,6.50,56.0
6253,tt0242653,The Matrix Revolutions,2003,"250,000+",793162,34716,23276,23899,3.5,60.0,,218,74,144,218,5.30,34.0
6254,tt0235333,Dead in the Water,2002,250+,266,12,26,18,2.7,32.0,,4,2,2,4,,
6255,tt0268220,China Town,1962,0,0,0,0,0,,,,0,0,0,0,,
6256,tt0109573,Deadly Target,1994,50+,74,1,6,3,2.6,14.0,,0,0,0,0,,
6257,tt1742023,Americano,2011,"1,000+",1500,20,54,8,2.6,27.0,,16,8,8,16,5.50,50.0
6258,tt0400585,Vettam,2004,Fewer than 50,1,1,0,0,,,,0,0,0,0,,
6259,tt0422320,Ghilli,2004,Fewer than 50,4,4,0,3,,,,1,1,0,1,,
6260,tt0079948,Starting Over,1979,"1,000+",1381,67,48,40,3.3,58.0,,7,6,1,7,6.90,86.0
6261,tt0408126,Pudhiya Geethai,2003,Fewer than 50,1,0,1,0,,,,0,0,0,0,,
6262,tt0410650,Species III,2004,"10,000+",10525,134,670,238,2.2,17.0,,6,1,5,6,3.60,17.0
6263,tt0414923,Crimes of Fashion,2004,500+,537,44,102,20,2.6,30.0,,0,0,0,0,,
6264,tt0410650,Species III,2004,"10,000+",10525,134,670,238,2.2,17.0,,6,1,5,6,3.60,17.0
6265,tt0102059,Hot Shots!,1991,"100,000+",157796,5678,3048,2683,3.6,65.0,,28,23,5,28,6.50,82.0
6266,tt0157044,Sitcom,1998,"2,500+",3114,268,126,103,3.6,68.0,,12,8,4,12,5.90,67.0
6267,tt0984177,Amarkalam,1999,Fewer than 50,1,1,0,0,,,,0,0,0,0,,
6268,tt0114345,The Scarlet Letter,1995,"10,000+",20478,652,931,515,3,41.0,,38,5,33,38,3.40,13.0
6269,tt0407095,Our Very Own,2005,500+,617,37,51,47,3.1,42.0,,4,2,2,4,,
6270,tt1516593,Tilva Ros,2010,Fewer than 50,45,21,6,2,3.8,78.0,,1,1,0,1,,
6271,tt0062776,Candy,1968,"1,000+",1914,77,87,58,3,47.0,,10,4,6,10,6.00,40.0
6272,tt0383518,Mouth to Mouth,2005,"10,000+",20980,252,245,210,3.3,50.0,,28,15,13,28,5.60,54.0
6273,tt0072613,Afonya,1975,50+,91,19,4,1,4.2,83.0,,0,0,0,0,,
6274,tt1982806,Open Season 2,2008,"10,000+",10217,514,941,445,2.9,35.0,,4,2,2,4,,
6275,tt0493389,Annavaram,2006,250+,331,8,6,3,3.6,57.0,,0,0,0,0,,
6276,tt0213969,Padayappa,1999,50+,99,19,3,3,4.2,86.0,,0,0,0,0,,
6277,tt0099090,Backstreet Dreams,1990,50+,56,3,3,0,3,50.0,,0,0,0,0,,
6278,tt0089457,Ladyhawke,1985,"50,000+",53576,4034,1433,2019,3.8,74.0,,30,20,10,30,5.80,67.0
6279,tt1438486,Chal Chala Chal,2009,Fewer than 50,29,2,4,2,1.9,33.0,,1,0,1,1,,
6280,tt1438176,Fright Night,2011,"50,000+",50678,12393,8746,4573,3.4,59.0,,183,132,51,183,6.30,72.0
6281,tt0105698,Universal Soldier,1992,"50,000+",70254,1938,2230,1407,3.2,46.0,,35,12,23,35,4.50,34.0
6282,tt0493450,Sixty Six,2006,"2,500+",3232,329,169,214,3.6,66.0,,52,34,18,52,6.00,65.0
6283,tt0108110,Shattered Trust: The Shari Karney Story,1993,50+,70,2,3,1,2.5,40.0,,1,1,0,1,,
6284,tt0085678,High Road to China,1983,"2,500+",3388,162,92,98,3.6,64.0,,4,1,3,4,,
6285,tt0218141,Deeply,2000,"2,500+",3296,156,107,119,3.5,59.0,,5,1,4,5,5.20,20.0
6286,tt0095895,Powaqqatsi,1988,"5,000+",5155,625,146,201,3.9,81.0,,9,5,4,9,6.50,56.0
6287,tt0070689,Siddhartha,1972,500+,760,59,42,38,3.4,58.0,,20,12,8,20,6.70,60.0
6288,tt0112606,Bye Bye Love,1995,"5,000+",6495,228,232,111,3.3,49.0,,22,5,17,22,4.70,23.0
6289,tt0313016,Saint Sinner,2002,Fewer than 50,1,0,1,1,,,,0,0,0,0,,
6290,tt2122413,Mirugam,2007,0,0,0,0,0,,,,0,0,0,0,,
6291,tt2140371,Saving Face,2012,50+,58,33,8,6,4,80.0,,1,1,0,1,,
6292,tt0448564,Irresistible,2006,"2,500+",2735,164,346,173,2.9,32.0,,10,2,8,10,5.40,20.0
6293,tt0090585,Absolute Beginners,1986,"2,500+",3290,96,158,87,3,38.0,,10,7,3,10,5.60,70.0
6294,tt0054381,This Rebel Breed,1960,Fewer than 50,8,1,2,1,,,,0,0,0,0,,
6295,tt0818940,Love & Suicide,2006,250+,337,22,24,14,3,50.0,,1,1,0,1,,
6296,tt0241914,Salim Langde Pe Mat Ro,1989,50+,60,10,4,1,3.1,71.0,,2,2,0,2,,
6297,tt1075417,Race to Witch Mountain,2009,"250,000+",348274,5899,7514,7018,3.2,44.0,,156,66,90,156,5.10,42.0
6298,tt0889162,Disney's 101 Dalmatians II: Patch's London Adventure,2003,"10,000+",10655,263,369,177,3.1,42.0,,6,4,2,6,5.00,67.0
6299,tt0250202,All Over the Guy,2001,"2,500+",4956,308,155,168,3.6,67.0,,47,20,27,47,5.00,43.0
6300,tt0056626,Two for the Seesaw,1962,100+,172,31,22,13,3.4,58.0,,7,3,4,7,5.20,43.0
6301,tt0057560,Tarzan's Three Challenges,1963,Fewer than 50,18,5,7,6,2.8,42.0,,2,1,1,2,,
6302,tt0099314,Crash: The Mystery of Flight 1501,1990,50+,98,5,7,5,3.1,42.0,,0,0,0,0,,
6303,tt0882791,Nana 2,2006,"2,500+",4845,308,366,266,3.2,46.0,,0,0,0,0,,
6304,tt0838221,The Darjeeling Limited,2007,"100,000+",136758,34881,9648,18353,3.8,78.0,,195,135,60,195,6.60,69.0
6305,tt0389726,Aanch,2003,100+,162,1,2,0,,,,0,0,0,0,,
6306,tt1132285,The Factory,2012,"1,000+",1526,356,527,185,3,40.0,,4,1,3,4,,
6307,tt0468569,The Dark Knight,2008,"250,000+",1831566,491602,32508,173380,4.4,94.0,,346,325,21,346,8.60,94.0
6308,tt0808265,The Ferryman,2007,500+,620,32,132,78,2.3,20.0,,1,1,0,1,,
6309,tt0298327,Fakira,1976,Fewer than 50,29,0,1,1,,,,0,0,0,0,,
6310,tt0375912,Layer Cake,2004,"100,000+",148236,23079,4242,7966,4,84.0,,142,115,27,142,7.10,81.0
6311,tt0375912,Layer Cake,2004,"100,000+",148236,23079,4242,7966,4,84.0,,142,115,27,142,7.10,81.0
6312,tt0462591,Urchin,2007,Fewer than 50,6,0,1,1,,,,2,0,2,2,,
6313,tt1712578,The Devil's Rock,2011,Fewer than 50,2,0,2,0,,,,0,0,0,0,,
6314,tt0084088,Honkytonk Man,1982,"5,000+",5971,293,166,107,3.6,64.0,,14,13,1,14,7.00,93.0
6315,tt2325604,Onbadhu Roobai Nottu,2007,Fewer than 50,1,1,0,0,,,,0,0,0,0,,
6316,tt1328633,A Nanny's Secret,2009,Fewer than 50,23,3,10,2,2.8,23.0,,0,0,0,0,,
6317,tt0097967,Next of Kin,1989,"5,000+",9652,351,436,185,3.2,45.0,,10,5,5,10,5.50,50.0
6318,tt0377800,Don't Come Knocking,2005,"10,000+",24133,461,312,237,3.4,60.0,,101,43,58,101,5.40,43.0
6319,tt0974014,Creation,2009,"10,000+",24742,1074,1104,700,3.2,49.0,,115,54,61,115,5.50,47.0
6320,tt0272001,Bindhaast,1999,0,0,0,0,0,,,,0,0,0,0,,
6321,tt0070093,Gawain and the Green Knight,1973,Fewer than 50,6,2,0,0,,,,2,1,1,2,,
6322,tt0320116,Naan Sigappu Manithan,1985,0,0,0,0,0,,,,0,0,0,0,,
6323,tt0490204,Reign Over Me,2007,"100,000+",150480,22673,5213,12602,3.9,81.0,,153,98,55,153,6.30,64.0
6324,tt0770753,Footsteps,2006,100+,165,5,12,16,2.4,29.0,,0,0,0,0,,
6325,tt1146321,The Note,2007,250+,485,74,22,29,3.9,77.0,,0,0,0,0,,
6326,tt0910898,Goyband,2008,0,0,0,0,0,,,,0,0,0,0,,
6327,tt0426138,Rapid Fire,2006,100+,198,8,19,11,2.8,30.0,,0,0,0,0,,
6328,tt0357470,The Battle of Shaker Heights,2003,"5,000+",6051,302,321,219,3.2,48.0,,59,23,36,59,5.10,39.0
6329,tt0368836,The Lazarus Child,2004,250+,472,20,35,10,2.9,35.0,,0,0,0,0,,
6330,tt1663662,Pacific Rim,2013,"100,000+",195172,72838,22167,12863,3.9,77.0,,298,215,83,298,6.70,72.0
6331,tt1230414,It's Complicated,2009,"100,000+",225361,13785,9340,7974,3.5,60.0,,185,109,76,185,5.80,59.0
6332,tt0061619,El Dorado,1966,"10,000+",12749,1436,214,484,4.2,87.0,,25,24,1,25,7.70,96.0
6333,tt0074559,Futureworld,1976,"1,000+",1008,119,270,130,2.7,30.0,,11,4,7,11,5.00,36.0
6334,tt0364198,Akasa Veedhilo,2001,0,0,0,0,0,,,,0,0,0,0,,
6335,tt0323033,Laws of Attraction,2004,"25,000+",36842,1161,1316,746,3.2,47.0,,147,27,120,147,4.40,18.0
6336,tt0109117,Andaz Apna Apna,1994,"5,000+",8564,2106,83,592,4.6,96.0,,1,1,0,1,,
6337,tt0090169,Thunder Run,1985,50+,89,4,6,2,3.2,40.0,,0,0,0,0,,
6338,tt0109117,Andaz Apna Apna,1994,"5,000+",8564,2106,83,592,4.6,96.0,,1,1,0,1,,
6339,tt0140399,Muthu,1995,250+,332,52,9,14,4.3,85.0,,0,0,0,0,,
6340,tt0083006,Rollover,1981,250+,385,12,24,11,3.1,33.0,,10,7,3,10,6.10,70.0
6341,tt0105107,Passion Fish,1992,"2,500+",2883,288,62,98,4,82.0,,26,26,0,26,7.80,100.0
6342,tt0430381,Musafir,2004,250+,494,38,28,20,3.4,58.0,,1,0,1,1,,
6343,tt0100469,The Reflecting Skin,1990,"2,500+",2671,416,126,162,3.9,77.0,,17,15,2,17,7.00,88.0
6344,tt1634122,Johnny English Reborn,2011,"25,000+",38789,4776,5873,1945,3.2,45.0,,92,35,57,92,4.80,38.0
6345,tt0108569,Wilder Napalm,1993,"1,000+",1051,57,48,44,3.4,54.0,,8,2,6,8,4.90,25.0
6346,tt1650062,Super 8,2011,"100,000+",135636,53265,17690,16014,3.8,75.0,,297,240,57,297,7.30,81.0
6347,tt0485861,Balram vs. Tharadas,2006,0,0,0,0,0,,,,0,0,0,0,,
6348,tt0107910,Quest of the Delta Knights,1993,500+,621,12,40,25,2,23.0,,0,0,0,0,,
6349,tt0062266,The Shuttered Room,1967,500+,555,28,39,35,3,41.0,,2,1,1,2,,
6350,tt0104136,Double Vision,1992,Fewer than 50,39,2,2,2,,,,0,0,0,0,,
6351,tt0449086,Dominion: Prequel to the Exorcist,2005,"10,000+",17706,380,1131,518,2.5,25.0,,44,13,31,44,4.70,30.0
6352,tt0376061,Pattalam,2003,0,0,0,0,0,,,,0,0,0,0,,
6353,tt1068641,The Burning Plain,2008,"5,000+",8530,1092,858,527,3.3,56.0,,80,30,50,80,5.00,38.0
6354,tt0439458,Bcuz of U,2004,0,0,0,0,0,,,,0,0,0,0,,
6355,tt0462496,Pursuit of Equality,2005,100+,141,3,1,0,,,,1,1,0,1,,
6356,tt0337636,Hellraiser: Deader,2005,"10,000+",13675,255,749,327,2.4,25.0,,8,1,7,8,3.60,13.0
6357,tt1446479,Ice Age: Dawn of the Dinosaurs,2009,"250,000+",554359,21102,12656,16626,3.6,63.0,,165,76,89,165,5.40,46.0
6358,tt1509831,Unakkaga Ellam Unakkaga,1999,0,0,0,0,0,,,,0,0,0,0,,
6359,tt0090081,Stoogemania,1985,Fewer than 50,6,1,3,1,,,,0,0,0,0,,
6360,tt0785016,Kill Kill Faster Faster,2008,250+,264,11,25,18,2.7,31.0,,0,0,0,0,,
6361,tt0148692,Safar,1970,50+,71,2,0,0,,,,0,0,0,0,,
6362,tt0076910,Welcome to L.A.,1976,100+,138,12,14,9,3,46.0,,4,2,2,4,,
6363,tt0488962,Big Bad Wolf,2006,"1,000+",1531,86,179,154,2.7,33.0,,1,0,1,1,,
6364,tt0799914,Act Normal,2006,0,0,0,0,0,,,,0,0,0,0,,
6365,tt0093857,Revenge of the Nerds II: Nerds in Paradise,1987,"25,000+",26011,428,812,404,2.9,35.0,,27,2,25,27,3.70,7.0
6366,tt0455976,Max Rules,2004,100+,212,7,7,5,3.1,50.0,,1,0,1,1,,
6367,tt0117718,The Spitfire Grill,1996,"5,000+",5052,375,120,179,3.9,76.0,,29,11,18,29,5.40,38.0
6368,tt0115743,The Boys Next Door,1996,500+,945,58,8,13,4.1,88.0,,0,0,0,0,,
6369,tt0107819,Philadelphia Experiment II,1993,"1,000+",1633,13,56,23,2.5,19.0,,0,0,0,0,,
6370,tt1535568,Douchebag,2010,500+,938,20,6,4,3.8,77.0,,23,13,10,23,5.70,57.0
6371,tt0328905,Box Head Revolution,2002,0,0,0,0,0,,,,5,1,4,5,5.10,20.0
6372,tt0391353,Mrs. Harris,2005,"2,500+",4195,59,95,73,3,39.0,,7,3,4,7,4.10,43.0
6373,tt0079635,Nocturna,1979,50+,72,2,3,3,2.8,40.0,,0,0,0,0,,
6374,tt0396592,Fat Albert,2004,"50,000+",60275,969,1231,1144,3,44.0,,91,21,70,91,4.40,23.0
6375,tt0414078,Halloweentown High,2004,"10,000+",18437,877,484,309,3.7,64.0,,3,1,2,3,,
6376,tt0110140,Insaniyat,1994,Fewer than 50,7,0,4,0,,,,0,0,0,0,,
6377,tt0068621,Garden of the Dead,1972,0,0,0,0,0,,,,1,0,1,1,,
6378,tt0274761,Halloweentown II: Kalabar's Revenge,2001,"10,000+",15324,606,375,265,3.6,62.0,,2,2,0,2,,
6379,tt0103905,Man Bites Dog,1992,"10,000+",22694,4218,466,1531,4.2,90.0,,19,14,5,19,7.20,74.0
6380,tt0094683,Assa,1987,Fewer than 50,33,15,4,0,4,79.0,,0,0,0,0,,
6381,tt0079738,Porridge,1979,500+,614,91,18,42,4,83.0,,2,0,2,2,,
6382,tt0089108,Esperando la carroza,1985,"1,000+",1296,291,12,69,4.6,96.0,,0,0,0,0,,
6383,tt0338721,Annarth,2002,50+,79,0,1,0,,,,0,0,0,0,,
6384,tt0086361,Staying Alive,1983,"10,000+",18041,563,859,495,2.9,40.0,,29,0,29,29,3.00,0.0
6385,tt0284978,Cypher,2002,"5,000+",8409,1075,593,573,3.5,65.0,,19,11,8,19,6.30,58.0
6386,tt0093507,Masters of the Universe,1987,"25,000+",48939,1471,2141,1982,3,41.0,,28,6,22,28,3.60,21.0
6387,tt1263670,Crazy Heart,2009,"100,000+",124880,11224,3511,5029,3.7,76.0,,213,191,22,213,7.40,90.0
6388,tt0110299,Lamerica,1994,500+,686,82,10,26,4.1,89.0,,11,10,1,11,8.00,91.0
6389,tt0100606,A Show of Force,1990,"1,000+",1300,5,15,5,2.6,25.0,,2,0,2,2,,
6390,tt0113538,A Kid in King Arthur's Court,1995,"50,000+",74161,306,831,642,2.6,27.0,,22,1,21,22,3.60,5.0
6391,tt0478273,South of Pico,2007,100+,182,15,21,15,3.1,42.0,,0,0,0,0,,
6392,tt0432348,Saw II,2005,"250,000+",32524689,48694,33812,1228475,3.2,59.0,,124,46,78,124,4.70,37.0
6393,tt0079432,Dirty Ho,1979,500+,907,73,19,47,3.9,79.0,,2,2,0,2,,
6394,tt1670635,Eeram,2009,50+,59,14,4,4,3.8,78.0,,0,0,0,0,,
6395,tt0780571,Mr. Brooks,2007,"250,000+",597198,38382,12152,25182,3.8,76.0,,159,88,71,159,5.70,55.0
6396,tt0199753,Red Planet,2000,"25,000+",48411,889,2286,950,2.7,28.0,,103,14,89,103,3.90,14.0
6397,tt0356129,Titli,2002,0,0,0,0,0,,,,0,0,0,0,,
6398,tt1748122,Moonrise Kingdom,2012,"100,000+",140142,37847,6053,6793,4.1,86.0,,270,252,18,270,8.20,93.0
6399,tt1552184,Honeymooner,2010,Fewer than 50,21,5,6,5,3.1,45.0,,9,6,3,9,4.80,67.0
6400,tt1529564,Playing House,2011,Fewer than 50,27,3,12,4,2.2,14.0,,0,0,0,0,,
6401,tt1097239,Joy Division,2007,"1,000+",2405,578,52,277,4.1,92.0,,5,5,0,5,8.00,100.0
6402,tt0876233,The Last Word,2008,100+,101,23,6,8,3.9,79.0,,0,0,0,0,,
6403,tt0469683,Automaton Transfusion,2006,"1,000+",1692,100,313,283,2.2,24.0,,8,3,5,8,4.90,38.0
6404,tt0337735,The Trouble with Men and Women,2005,500+,821,7,16,13,2.6,30.0,,9,3,6,9,4.30,33.0
6405,tt0251919,Padamati Sandhya Ragam,1987,Fewer than 50,6,3,0,0,,,,0,0,0,0,,
6406,tt1326945,Kicking the Dog,2009,250+,469,38,36,37,3.2,51.0,,1,0,1,1,,
6407,tt0054757,The Comancheros,1961,"5,000+",8221,351,120,111,3.8,74.0,,6,6,0,6,6.90,100.0
6408,tt0283005,Sri Shirdi Saibaba Mahathyam,1986,Fewer than 50,33,1,1,2,,,,0,0,0,0,,
6409,tt0272688,Kasoor,2001,100+,119,15,3,4,4.1,83.0,,0,0,0,0,,
6410,tt0290183,Elaan,1994,0,0,0,0,0,,,,0,0,0,0,,
6411,tt0363891,The Pirates of Penzance,1980,"5,000+",8481,496,101,357,4.1,83.0,,16,13,3,16,7.10,81.0
6412,tt0058275,Limonade Joe,1964,0,0,0,0,0,,,,0,0,0,0,,
6413,tt0280590,Mr. Deeds,2002,"250,000+",738531,20278,13925,15283,3.4,59.0,,153,33,120,153,4.20,22.0
6414,tt0329390,Monte Walsh,2003,"1,000+",1843,91,33,46,3.9,73.0,,4,2,2,4,,
6415,tt0114324,Sahara,1995,250+,361,45,28,16,3.4,62.0,,1,1,0,1,,
6416,tt0312700,The Foreigner,2003,"5,000+",6960,84,244,92,2.3,26.0,,5,0,5,5,2.50,0.0
6417,tt0457510,Nacho Libre,2006,"250,000+",417592,16049,13349,18376,3.3,55.0,,166,66,100,166,5.20,40.0
6418,tt0355702,Lords of Dogtown,2005,"50,000+",68396,7966,1915,3224,4,81.0,,146,81,65,146,6.00,55.0
6419,tt1371111,Cloud Atlas,2012,"100,000+",188081,29653,15502,7436,3.6,66.0,,292,193,99,292,6.70,66.0
6420,tt0067801,Such Good Friends,1971,50+,82,5,10,6,2.8,33.0,,2,2,0,2,,
6421,tt0049087,"Come Back, Africa",1959,Fewer than 50,40,10,5,5,3.5,67.0,,13,12,1,13,7.30,92.0
6422,tt0317301,Daadagiri,1997,0,0,0,0,0,,,,0,0,0,0,,
6423,tt0076593,Raggedy Ann & Andy: A Musical Adventure,1976,250+,308,52,42,51,3.4,56.0,,2,1,1,2,,
6424,tt0057808,3 Nuts in Search of a Bolt,1964,250+,275,2,3,1,2.8,40.0,,1,1,0,1,,
6425,tt1152850,Wendy and Lucy,2008,"10,000+",12218,1724,843,1034,3.5,67.0,,187,160,27,187,7.40,86.0
6426,tt0082399,Force: Five,1981,Fewer than 50,15,1,6,3,2.1,14.0,,0,0,0,0,,
6427,tt0069957,Deep Throat Part II,1974,Fewer than 50,1,0,1,0,,,,0,0,0,0,,
6428,tt0069952,Deadly Weapons,1974,"1,000+",1576,25,16,20,3.4,61.0,,0,0,0,0,,
6429,tt0270259,The Business of Strangers,2001,"2,500+",3627,123,118,92,3.2,51.0,,95,77,18,95,6.60,81.0
6430,tt1385473,American Faust: From Condi to Neo-Condi,2009,Fewer than 50,10,1,0,0,,,,2,2,0,2,,
6431,tt1081915,Aha!,2007,100+,165,9,9,11,3.2,50.0,,0,0,0,0,,
6432,tt0097880,The Mighty Quinn,1989,"5,000+",6264,149,164,107,3.2,48.0,,17,15,2,17,6.60,88.0
6433,tt0059661,The Rounders,1965,250+,329,26,22,19,3.7,54.0,,3,3,0,3,,
6434,tt1884268,Chalo Dilli,2011,250+,312,64,42,38,3.4,60.0,,2,1,1,2,,
6435,tt0111140,Sh'Chur,1994,50+,58,2,2,1,,,,0,0,0,0,,
6436,tt0058657,A Tiger Walks,1964,50+,86,7,6,7,3.5,54.0,,2,1,1,2,,
6437,tt0069836,Calzonzín inspector,1974,0,0,0,0,0,,,,0,0,0,0,,
6438,tt2040578,U.F.O.,2012,50+,51,3,35,15,1.4,8.0,,4,1,3,4,,
6439,tt1562859,Golmaal 3,2010,500+,999,154,155,107,3.2,50.0,,8,3,5,8,5.00,38.0
6440,tt0102705,Prem Pratigyaa,1989,100+,138,3,1,1,,,,0,0,0,0,,
6441,tt0106234,The Airzone Solution,1993,Fewer than 50,1,1,0,0,,,,0,0,0,0,,
6442,tt0467197,Max Payne,2008,"100,000+",230640,6211,14889,9623,2.6,29.0,,137,22,115,137,3.90,16.0
6443,tt0138411,Dushmun,1971,0,0,0,0,0,,,,0,0,0,0,,
6444,tt1708658,November Christmas,2010,Fewer than 50,25,12,4,4,4,75.0,,0,0,0,0,,
6445,tt0080764,Macabre,1980,250+,427,43,69,42,3,38.0,,2,1,1,2,,
6446,tt0325007,April's Shower,2003,"10,000+",11675,36,71,45,2.7,34.0,,15,3,12,15,3.60,20.0
6447,tt1739176,Engeyum Kadhal,2011,50+,73,14,12,7,3.4,54.0,,0,0,0,0,,
6448,tt0071666,Invasion from Inner Earth,1974,Fewer than 50,10,1,9,4,1.6,10.0,,1,0,1,1,,
6449,tt0106877,Father Hood,1993,"5,000+",9165,84,161,71,2.9,34.0,,20,2,18,20,3.10,10.0
6450,tt0157965,Man Pasand,1980,0,0,0,0,0,,,,0,0,0,0,,
6451,tt0120642,"A Cool, Dry Place",1998,"2,500+",3892,169,116,74,3.5,59.0,,13,7,6,13,5.50,54.0
6452,tt0053762,Desire in the Dust,1960,Fewer than 50,33,1,0,1,,,,1,0,1,1,,
6453,tt0464799,The Curse of King Tut's Tomb,2006,Fewer than 50,1,0,1,0,,,,0,0,0,0,,
6454,tt0436455,Journey to Lasta,2004,0,0,0,0,0,,,,0,0,0,0,,
6455,tt0105316,Sarafina!,1992,"5,000+",6289,432,67,229,4.4,87.0,,10,6,4,10,5.20,60.0
6456,tt0253867,The Sweetest Thing,2002,"100,000+",199822,6506,3586,5235,3.6,65.0,,111,29,82,111,4.30,26.0
6457,tt0063429,The Pink Jungle,1968,Fewer than 50,12,1,3,1,,,,1,1,0,1,,
6458,tt0061474,Chiriyakhana,1967,Fewer than 50,34,9,4,0,3.6,69.0,,0,0,0,0,,
6459,tt0099612,Frankenstein Unbound,1990,"1,000+",1454,71,143,71,2.8,33.0,,18,9,9,18,5.20,50.0
6460,tt0295721,Taxi 3,2003,"5,000+",9380,716,698,263,3.2,51.0,,1,1,0,1,,
6461,tt1999995,Would You Rather,2012,"2,500+",3035,813,1394,457,2.9,37.0,,23,14,9,23,5.50,61.0
6462,tt0473308,Waitress,2007,"250,000+",410389,21596,7746,13792,3.7,74.0,,174,155,19,174,7.30,89.0
6463,tt0096951,Blood Red,1989,500+,686,6,18,5,2.4,25.0,,0,0,0,0,,
6464,tt0113774,Margaret's Museum,1995,"1,000+",1347,128,35,50,4,79.0,,6,4,2,6,6.90,67.0
6465,tt13667194,Veerappu,2007,0,0,0,0,0,,,,0,0,0,0,,
6466,tt1179069,Shelter,2010,0,0,0,0,0,,,,0,0,0,0,,
6467,tt0433387,Harsh Times,2005,"50,000+",91258,4310,3482,3199,3.3,55.0,,99,48,51,99,5.50,48.0
6468,tt0092848,Deadly Prey,1987,250+,415,75,61,62,3.3,55.0,,1,0,1,1,,
6469,tt0115836,Carpool,1996,"5,000+",8923,171,261,154,3,40.0,,23,3,20,23,2.80,13.0
6470,tt0424472,Surge of Power: The Stuff of Heroes,2004,Fewer than 50,19,2,0,1,,,,2,1,1,2,,
6471,tt0089155,Fletch,1985,"25,000+",45237,4401,1020,1745,4,81.0,,31,24,7,31,6.80,77.0
6472,tt0410403,Only the Brave,2006,100+,137,19,20,17,3.3,49.0,,2,2,0,2,,
6473,tt0058104,Flight from Ashiya,1964,50+,66,2,5,2,2.6,29.0,,1,0,1,1,,
6474,tt1349853,Overheard,2009,"1,000+",1492,379,115,178,3.7,77.0,,0,0,0,0,,
6475,tt0067535,The Organization,1971,250+,449,18,44,24,2.9,29.0,,8,2,6,8,5.50,25.0
6476,tt0063991,Age of Consent,1969,250+,482,64,66,36,3.2,49.0,,9,9,0,9,7.10,100.0
6477,tt0456912,A Bittersweet Life,2005,"10,000+",10669,2456,262,865,4.2,90.0,,11,11,0,11,8.10,100.0
6478,tt0092035,Sweet Liberty,1986,500+,885,42,76,20,2.9,36.0,,17,13,4,17,5.70,76.0
6479,tt2219774,Sarkar Colony,2011,0,0,0,0,0,,,,0,0,0,0,,
6480,tt0089240,Gulag,1985,Fewer than 50,36,7,5,3,3.6,58.0,,1,0,1,1,,
6481,tt0795351,Case 39,2009,"50,000+",67918,4316,6618,3108,3,39.0,,77,16,61,77,4.00,21.0
6482,tt1206539,Dambé: The Mali Project,2008,Fewer than 50,27,1,0,0,,,,0,0,0,0,,
6483,tt0058355,The Misadventures of Merlin Jones,1964,"1,000+",1142,29,17,23,3.6,63.0,,2,1,1,2,,
6484,tt1129442,Transporter 3,2008,"100,000+",201972,7986,8519,7363,3.2,48.0,,115,46,69,115,4.80,40.0
6485,tt0092744,Cheerleader Camp,1988,"2,500+",3267,44,152,102,2.6,22.0,,2,0,2,2,,
6486,tt0763844,Lulu und Jimi,2009,50+,91,9,8,7,3.3,50.0,,0,0,0,0,,
6487,tt0061927,Luv,1967,50+,94,7,11,4,2.9,39.0,,3,0,3,3,,
6488,tt0305556,Evil Alien Conquerors,2003,"1,000+",1099,100,39,94,3.8,72.0,,1,0,1,1,,
6489,tt14253714,Meravanige,2008,Fewer than 50,1,0,1,0,,,,0,0,0,0,,
6490,tt0480572,Pyaar Ke Side Effects,2006,"1,000+",2429,145,55,68,3.8,72.0,,0,0,0,0,,
6491,tt0375662,Cloaca,2003,100+,115,16,5,6,3.8,76.0,,0,0,0,0,,
6492,tt0470614,Yun Hota Toh Kya Hota,2006,0,0,0,0,0,,,,0,0,0,0,,
6493,tt0061581,Divorce American Style,1967,"1,000+",1352,58,42,33,3.5,58.0,,8,8,0,8,7.40,100.0
6494,tt0093011,Fatal Beauty,1987,"5,000+",7444,80,110,81,3.1,42.0,,15,3,12,15,3.80,20.0
6495,tt1179794,TiMER,2009,"2,500+",3464,1068,637,440,3.5,63.0,,15,10,5,15,6.20,67.0
6496,tt1176724,Across the Hall,2009,"1,000+",1252,175,273,148,3,39.0,,1,0,1,1,,
6497,tt0485205,En Swasa Katre,1999,Fewer than 50,1,1,0,1,,,,0,0,0,0,,
6498,tt1658851,Toast,2010,0,0,0,0,0,,,,0,0,0,0,,
6499,tt1176724,Across the Hall,2009,"1,000+",1252,175,273,148,3,39.0,,1,0,1,1,,
6500,tt0206926,Maybe Baby,2000,"5,000+",7753,252,275,204,3.2,48.0,,28,14,14,28,5.30,50.0
6501,tt0398851,Cheerleader Queens,2003,0,0,0,0,0,,,,0,0,0,0,,
6502,tt0064667,The Mighty Gorga,1969,100+,102,1,8,7,1.7,11.0,,1,0,1,1,,
6503,tt0301179,Deewaanapan,2001,100+,153,4,8,2,2.9,33.0,,0,0,0,0,,
6504,tt1640680,Armadillo,2010,"2,500+",3948,549,131,149,3.9,81.0,,54,48,6,54,7.60,89.0
6505,tt0084099,Human Highway,1982,250+,307,18,15,15,3.4,53.0,,1,0,1,1,,
6506,tt1217070,Triage,2009,"1,000+",1660,363,321,177,3.3,53.0,,3,2,1,3,,
6507,tt0274012,Punjabi House,1998,0,0,0,0,0,,,,0,0,0,0,,
6508,tt0974629,Safe Harbour,2007,250+,343,22,36,21,3.1,38.0,,0,0,0,0,,
6509,tt1764234,Killing Them Softly,2012,"100,000+",121735,10481,13085,3582,3,44.0,,233,172,61,233,6.90,74.0
6510,tt0902265,Care Bears: Oopsy Does It!,2007,250+,429,10,14,12,3.2,43.0,,1,1,0,1,,
6511,tt0118996,Dobermann,1997,"5,000+",5618,970,242,282,3.9,80.0,,8,5,3,8,6.60,63.0
6512,tt0315824,The Big Bounce,2004,"10,000+",21246,361,1165,445,2.5,24.0,,136,21,115,136,4.20,15.0
6513,tt1212974,Bitch Slap,2009,"10,000+",10352,468,1165,609,2.5,29.0,,17,5,12,17,4.30,29.0
6514,tt0903943,The End of Poverty?,2008,250+,285,60,19,36,3.9,76.0,,23,12,11,23,6.00,52.0
6515,tt0473490,Hanbando,2006,0,0,0,0,0,,,,0,0,0,0,,
6516,tt0087065,Cloak & Dagger,1984,"5,000+",9256,448,354,283,3.5,56.0,,12,8,4,12,5.80,67.0
6517,tt1529572,Trust,2010,"10,000+",10246,2624,1425,990,3.5,65.0,,67,53,14,67,6.70,79.0
6518,tt6460188,The Japanese Wife,2012,100+,237,87,35,54,3.6,71.0,,1,1,0,1,,
6519,tt0319343,Elf,2003,"250,000+",910836,43861,11779,32293,3.9,79.0,,203,174,29,203,7.10,86.0
6520,tt1869252,Again Kasargod Khader Bhai,2010,0,0,0,0,0,,,,0,0,0,0,,
6521,tt0354766,Never Die Alone,2004,"10,000+",10423,565,366,271,3.5,61.0,,93,24,69,93,4.30,26.0
6522,tt0093258,Rouge,1987,"1,000+",1444,260,41,61,4,86.0,,6,5,1,6,7.00,83.0
6523,tt3189256,Om,1995,0,0,0,0,0,,,,1,1,0,1,,
6524,tt0068332,Cancel My Reservation,1972,50+,66,2,7,3,2.8,22.0,,2,1,1,2,,
6525,tt0115736,Bound,1996,"25,000+",33533,3364,706,1383,4,83.0,,66,57,9,66,7.90,86.0
6526,tt0381061,Casino Royale,2006,"250,000+",705014,105101,12283,55142,4.2,90.0,,267,252,15,267,7.90,94.0
6527,tt0255494,Poochakkoru Mookkuthi,1984,0,0,0,0,0,,,,0,0,0,0,,
6528,tt0091151,A Great Wall,1986,50+,86,9,8,5,3.4,53.0,,9,5,4,9,6.50,56.0
6529,tt0084555,Le père Noël est une ordure,1982,"2,500+",4475,1161,83,167,4.5,93.0,,1,1,0,1,,
6530,tt0147926,The Brave Little Toaster Goes to Mars,1998,"2,500+",3797,129,160,100,3,45.0,,6,3,3,6,5.50,50.0
6531,tt0381842,Twelve Mile Road,2003,250+,258,30,27,18,3.3,53.0,,0,0,0,0,,
6532,tt0347722,Paappi Devataa,1995,0,0,0,0,0,,,,0,0,0,0,,
6533,tt0379976,Savage Grace,2007,"10,000+",12776,634,1010,728,2.9,38.0,,96,36,60,96,5.00,38.0
6534,tt0097904,Monsieur Hire,1989,"1,000+",1458,308,51,71,4,86.0,,17,17,0,17,8.00,100.0
6535,tt0114427,Shinjuku Boys,1995,Fewer than 50,13,4,1,2,3.5,80.0,,1,1,0,1,,
6536,tt1667307,Damsels in Distress,2011,"10,000+",13406,705,1092,309,2.9,39.0,,143,108,35,143,6.70,76.0
6537,tt0465375,After Sex,2007,"2,500+",2710,205,445,185,2.8,32.0,,0,0,0,0,,
6538,tt0119001,Dogtown,1997,250+,370,21,15,13,3.6,58.0,,1,1,0,1,,
6539,tt0483578,Love and Honour,2006,"1,000+",2182,373,69,159,4,84.0,,21,17,4,21,6.80,81.0
6540,tt0249577,Here Comes Peter Cottontail,1971,"2,500+",3130,64,27,42,3.8,70.0,,2,2,0,2,,
6541,tt0454864,The Last Winter,2006,"5,000+",5342,418,811,613,2.7,34.0,,51,39,12,51,6.70,76.0
6542,tt0395443,Alien Lockdown,2004,"1,000+",1879,5,47,33,2,10.0,,0,0,0,0,,
6543,tt0183718,Rocky Marciano,1999,"1,000+",1466,59,32,33,3.7,65.0,,6,2,4,6,5.60,33.0
6544,tt0424774,The Adventures of Sharkboy and Lavagirl 3-D,2005,"25,000+",32410,1192,2418,1310,2.5,33.0,,123,24,99,123,4.40,20.0
6545,tt0337749,Zameer: The Awakening of a Soul,1997,0,0,0,0,0,,,,0,0,0,0,,
6546,tt0364970,Babylon A.D.,2008,"100,000+",152329,3026,8695,5776,2.6,26.0,,105,7,98,105,3.20,7.0
6547,tt0115964,Crash,1996,"50,000+",56275,3065,1971,1975,3.4,61.0,,63,40,23,63,6.80,63.0
6548,tt0488988,Chapter 27,2007,"5,000+",8754,723,1216,865,2.9,37.0,,49,9,40,49,4.10,18.0
6549,tt0283542,Terminal Error,2002,250+,329,12,14,11,2.9,46.0,,0,0,0,0,,
6550,tt2380288,Nee Varuvai Ena,1999,50+,52,1,2,0,,,,0,0,0,0,,
6551,tt0295427,The Master of Disguise,2002,"50,000+",59353,1759,3163,2225,2.5,36.0,,105,1,104,105,2.60,1.0
6552,tt1197613,Charlie Valentine,2009,100+,108,14,27,18,2.8,34.0,,1,0,1,1,,
6553,tt6805436,Navagraha,2008,Fewer than 50,1,1,0,0,,,,0,0,0,0,,
6554,tt0083584,Ashes and Embers,1982,Fewer than 50,14,2,0,1,,,,2,2,0,2,,
6555,tt1084950,Rachel Getting Married,2008,"25,000+",37903,7663,4637,5561,3.4,62.0,,203,171,32,203,7.50,84.0
6556,tt1043791,Dead Wood,2007,100+,170,5,41,21,1.6,11.0,,1,0,1,1,,
6557,tt0079257,H.O.T.S.,1979,"1,000+",1327,21,78,45,2.5,21.0,,7,2,5,7,3.50,29.0
6558,tt1068678,Veronika Decides to Die,2009,"2,500+",4770,648,648,311,3.2,50.0,,0,0,0,0,,
6559,tt0197273,Bartok the Magnificent,1999,"5,000+",6615,100,116,92,3.2,46.0,,3,1,2,3,,
6560,tt0069321,The Strangers in 7A,1972,Fewer than 50,10,1,2,2,,,,0,0,0,0,,
6561,tt0067168,A Gunfight,1971,500+,700,21,29,18,3.3,42.0,,3,0,3,3,,
6562,tt0469494,There Will Be Blood,2007,"250,000+",256078,73079,11850,36744,4.2,86.0,,247,226,21,247,8.50,91.0
6563,tt0469494,There Will Be Blood,2007,"250,000+",256078,73079,11850,36744,4.2,86.0,,247,226,21,247,8.50,91.0
6564,tt0295691,Who Framed Roger Rabbit,1988,"250,000+",443169,23349,4248,13296,4.1,85.0,,74,71,3,74,8.50,96.0
6565,tt1117960,Aahaa,1997,0,0,0,0,0,,,,0,0,0,0,,
6566,tt0088997,Deadly Intentions,1985,Fewer than 50,1,1,0,1,,,,0,0,0,0,,
6567,tt0995857,Mr. Bones 2: Back from the Past,2008,50+,96,7,10,4,3.1,41.0,,0,0,0,0,,
6568,tt0093072,The Garbage Pail Kids Movie,1987,"5,000+",8639,328,866,614,2.2,28.0,,14,0,14,14,2.20,0.0
6569,tt2396443,Devathayai Kanden,2005,0,0,0,0,0,,,,0,0,0,0,,
6570,tt0260337,Sadaa Suhagan,1986,0,0,0,0,0,,,,0,0,0,0,,
6571,tt1328611,Click Clack Jack,2009,0,0,0,0,0,,,,0,0,0,0,,
6572,tt0471009,Just Like the Son,2006,50+,63,6,7,5,3.2,46.0,,2,2,0,2,,
6573,tt0072962,F for Fake,1973,"5,000+",7484,1461,194,511,4.2,88.0,,52,46,6,52,7.80,88.0
6574,tt0061408,Blast-Off Girls,1967,Fewer than 50,17,2,3,0,3.2,40.0,,0,0,0,0,,
6575,tt1623649,Tortured,2008,Fewer than 50,1,0,1,1,,,,0,0,0,0,,
6576,tt0069883,Cinderella Liberty,1973,"1,000+",1144,50,29,33,3.6,63.0,,9,5,4,9,6.20,56.0
6577,tt1605778,Toh Baat Pakki!,2010,Fewer than 50,37,1,9,3,2.4,10.0,,1,0,1,1,,
6578,tt0909010,The Bad Mother's Handbook,2007,500+,681,160,88,68,3.6,65.0,,0,0,0,0,,
6579,tt0117438,Ransom,1996,"100,000+",120062,3695,2210,1803,3.5,63.0,,74,55,19,74,6.70,74.0
6580,tt0179952,Lucignolo,1999,0,0,0,0,0,,,,0,0,0,0,,
6581,tt0479750,Shake Rattle & Roll 2k5,2005,50+,77,0,5,1,1.8,0.0,,0,0,0,0,,
6582,tt0808279,Funny Games,2007,"25,000+",31059,6647,5733,5891,3.2,54.0,,144,75,69,144,5.80,52.0
6583,tt0139426,Lighthouse,1999,250+,257,18,31,17,2.8,37.0,,5,1,4,5,4.80,20.0
6584,tt0070788,That'll Be the Day,1973,"1,000+",1353,49,40,30,3.4,56.0,,2,1,1,2,,
6585,tt0433349,Bottoms Up,2006,"2,500+",4556,77,269,166,2.2,22.0,,3,0,3,3,,
6586,tt0319468,Guru Sishyan,1988,Fewer than 50,1,1,0,0,,,,0,0,0,0,,
6587,tt0486640,Postal,2007,"50,000+",81907,684,1276,933,2.6,35.0,,46,4,42,46,3.50,9.0
6588,tt0449159,15 Park Avenue,2005,500+,588,107,27,32,3.9,80.0,,1,0,1,1,,
6589,tt1410276,Un'estate ai Caraibi,2009,0,0,0,0,0,,,,0,0,0,0,,
6590,tt0066491,Tristana,1970,"2,500+",3251,558,115,110,4,83.0,,33,32,1,33,8.60,97.0
6591,tt0073941,Aloha Bobby and Rose,1975,100+,130,17,11,6,3.7,61.0,,0,0,0,0,,
6592,tt1714832,Do Dooni Chaar,2010,100+,236,54,18,24,3.6,75.0,,1,1,0,1,,
6593,tt0156651,Joroo Ka Ghulam,1972,Fewer than 50,26,2,1,0,,,,0,0,0,0,,
6594,tt0887769,Kerala Varma Pazhassi Raja,2009,0,0,0,0,0,,,,0,0,0,0,,
6595,tt0300140,Lilja 4-ever,2002,"10,000+",13445,2860,282,887,4.2,91.0,,71,60,11,71,7.50,85.0
6596,tt0094318,White Water Summer,1987,"5,000+",6960,220,190,138,3.4,54.0,,8,2,6,8,4.50,25.0
6597,tt0369053,Separate Lies,2005,"2,500+",2935,148,168,108,3.2,47.0,,89,64,25,89,6.80,72.0
6598,tt0106453,Body of Evidence,1992,"5,000+",8517,181,620,282,2.3,23.0,,39,3,36,39,3.10,8.0
6599,tt0069495,"What's Up, Doc?",1972,"10,000+",10131,1874,248,887,4.2,88.0,,45,40,5,45,7.30,89.0
6600,tt0120610,Black Dog,1998,"10,000+",21074,643,428,421,3.6,60.0,,21,3,18,21,3.70,14.0
6601,tt0069495,"What's Up, Doc?",1972,"10,000+",10131,1874,248,887,4.2,88.0,,45,40,5,45,7.30,89.0
6602,tt0093741,The Pink Chiquitas,1986,50+,77,0,3,1,,,,0,0,0,0,,
6603,tt0810823,The Deaths of Ian Stone,2007,"5,000+",5024,591,1127,833,2.8,34.0,,8,5,3,8,6.20,63.0
6604,tt0070097,Gehri Chaal,1973,0,0,0,0,0,,,,0,0,0,0,,
6605,tt0796375,You Kill Me,2007,"25,000+",30737,2512,1732,1865,3.4,59.0,,114,90,24,114,6.70,79.0
6606,tt0425483,Strange Fruit,2004,100+,213,10,14,5,3,42.0,,14,14,0,14,7.50,100.0
6607,tt0412308,Being Cyrus,2005,"1,000+",1734,161,50,69,3.7,76.0,,1,1,0,1,,
6608,tt0472615,BoyTown,2006,"1,000+",1943,80,105,134,3,43.0,,0,0,0,0,,
6609,tt0760177,The Mermaid Chair,2006,250+,401,23,34,15,3,40.0,,0,0,0,0,,
6610,tt2077851,Sleepwalk with Me,2012,"10,000+",23712,3393,1398,498,3.7,71.0,,117,98,19,117,7.10,84.0
6611,tt0056354,The Playboy of the Western World,1962,Fewer than 50,26,1,0,0,,,,0,0,0,0,,
6612,tt0089052,Dreamchild,1985,250+,444,67,17,34,3.9,80.0,,13,13,0,13,7.70,100.0
6613,tt0298814,The Core,2003,"100,000+",100880,3024,5986,3324,2.7,34.0,,160,63,97,160,5.30,39.0
6614,tt0255305,Khiladi 420,2000,250+,377,14,16,1,3.2,47.0,,0,0,0,0,,
6615,tt0205070,The Fool of the World and the Flying Ship,1991,Fewer than 50,8,5,0,1,4.1,100.0,,1,1,0,1,,
6616,tt0209246,Poor Little Rich Girl,1965,500+,647,21,16,9,3.6,57.0,,2,1,1,2,,
6617,tt0068704,Hit Man,1972,50+,50,9,12,10,2.9,43.0,,1,0,1,1,,
6618,tt12737326,A Nightmare on Elm Street 5: The Dream Child,1989,"100,000+",218037,1774,3904,2558,2.8,31.0,,33,10,23,33,4.00,30.0
6619,tt0106270,Anari,1993,Fewer than 50,27,1,1,1,,,,0,0,0,0,,
6620,tt0102185,Kamillions,1990,50+,70,3,3,2,3.1,50.0,,0,0,0,0,,
6621,tt0055946,Eegah,1962,"1,000+",2210,56,203,150,1.9,22.0,,8,0,8,8,2.30,0.0
6622,tt1113827,Toronto Stories,2008,100+,202,14,27,17,2.8,34.0,,4,2,2,4,,
6623,tt0245679,Aapathbandavudu,1992,0,0,0,0,0,,,,0,0,0,0,,
6624,tt0087090,Countdown to Looking Glass,1984,Fewer than 50,1,1,0,0,,,,0,0,0,0,,
6625,tt1308642,Desperadas 2,2008,50+,81,5,1,1,3.7,83.0,,0,0,0,0,,
6626,tt1325004,The Twilight Saga: Eclipse,2010,"250,000+",334152,43086,28724,16819,3.5,60.0,,256,120,136,256,5.50,47.0
6627,tt0092297,Zombie Nightmare,1987,500+,524,18,108,56,1.6,14.0,,1,0,1,1,,
6628,tt0238552,Replicant,2001,"10,000+",10012,283,490,199,2.9,37.0,,11,3,8,11,4.70,27.0
6629,tt0338852,The Cheetah Girls,2003,"50,000+",69792,2768,2877,2099,3.2,49.0,,8,6,2,8,5.10,75.0
6630,tt0309059,Wannabes,2000,"1,000+",1298,13,11,8,3.4,54.0,,16,3,13,16,4.40,19.0
6631,tt0114148,Pocahontas,1995,"250,000+",561321,12546,7157,12910,3.6,64.0,,57,31,26,57,6.00,54.0
6632,tt0088687,Aitbaar,1985,0,0,0,0,0,,,,0,0,0,0,,
6633,tt0089415,Kids Don't Tell,1985,100+,212,0,1,1,,,,0,0,0,0,,
6634,tt0117110,Muppet Treasure Island,1996,"50,000+",81878,3298,1007,2312,3.9,77.0,,28,20,8,28,6.30,71.0
6635,tt0114148,Pocahontas,1995,"250,000+",561321,12546,7157,12910,3.6,64.0,,57,31,26,57,6.00,54.0
6636,tt0127545,Every 9 Seconds,1997,0,0,0,0,0,,,,0,0,0,0,,
6637,tt1532561,The Happy Life,2009,0,0,0,0,0,,,,0,0,0,0,,
6638,tt1540767,Apartment 1303,2012,"1,000+",1125,34,367,133,1.4,8.0,,4,0,4,4,,
6639,tt0104569,Jonathan: The Boy Nobody Wanted,1992,50+,79,4,0,0,,,,1,1,0,1,,
6640,tt0499456,Days of Darkness,2007,"2,500+",3267,467,238,307,3.5,66.0,,5,1,4,5,5.50,20.0
6641,tt0160862,She's All That,1999,"250,000+",393347,11849,9634,8964,3.4,55.0,,63,26,37,63,5.00,41.0
6642,tt0060748,Nevada Smith,1966,"2,500+",3272,202,112,96,3.6,64.0,,8,4,4,8,6.10,50.0
6643,tt0492878,Drake and Josh Go Hollywood,2006,"10,000+",11511,823,229,397,4,78.0,,1,0,1,1,,
6644,tt1222330,The Art of Being Straight,2008,250+,324,21,46,27,2.5,31.0,,8,3,5,8,4.50,38.0
6645,tt1522203,Nightfur,2011,Fewer than 50,11,3,1,2,,,,0,0,0,0,,
6646,tt0455824,Australia,2008,"250,000+",261611,17580,9599,12216,3.5,65.0,,221,120,101,221,5.90,54.0
6647,tt0240802,The Photographer,2000,500+,710,20,15,15,3.2,57.0,,2,0,2,2,,
6648,tt1222329,Wild Cherry,2009,500+,690,35,160,44,2.3,18.0,,1,0,1,1,,
6649,tt0097892,Miss Firecracker,1989,"1,000+",1425,65,61,46,3.2,52.0,,12,9,3,12,6.20,75.0
6650,tt0103039,Talkin' Dirty After Dark,1991,"1,000+",1405,45,23,13,3.7,66.0,,1,1,0,1,,
6651,tt0399854,Vizontele Tuuba,2003,250+,424,62,50,0,3.3,55.0,,0,0,0,0,,
6652,tt0100619,Silent Scream,1990,Fewer than 50,17,3,1,0,,,,0,0,0,0,,
6653,tt0098156,R.O.T.O.R.,1987,250+,499,41,84,50,2.4,33.0,,1,0,1,1,,
6654,tt0092147,Vamp,1986,"2,500+",4753,215,224,176,3.2,49.0,,10,4,6,10,5.20,40.0
6655,tt0056209,Madison Avenue,1961,Fewer than 50,3,0,2,0,,,,0,0,0,0,,
6656,tt1292594,Front of the Class,2008,100+,162,94,21,14,4.1,82.0,,0,0,0,0,,
6657,tt0095067,The Drifter,1988,500+,736,2,12,7,2.5,14.0,,0,0,0,0,,
6658,tt1292594,Front of the Class,2008,100+,162,94,21,14,4.1,82.0,,0,0,0,0,,
6659,tt0410321,The Mindscape of Alan Moore,2003,250+,362,78,46,58,3.6,63.0,,1,1,0,1,,
6660,tt1466072,William S. Burroughs: A Man Within,2010,500+,674,144,44,35,3.8,76.0,,17,15,2,17,7.30,88.0
6661,tt0961722,Cabin Fever 2: Spring Fever,2009,"2,500+",3268,226,1204,595,2.1,16.0,,2,1,1,2,,
6662,tt0058266,Kisses for My President,1964,50+,76,5,12,4,2.6,29.0,,2,0,2,2,,
6663,tt1319704,Chatroom,2010,"2,500+",4087,289,541,210,2.7,35.0,,23,2,21,23,3.50,9.0
6664,tt1136688,Tales of an Ancient Empire,2010,100+,176,2,55,20,0.9,4.0,,1,0,1,1,,
6665,tt0248168,Manchupallaki,1982,0,0,0,0,0,,,,0,0,0,0,,
6666,tt0236951,Aadharam,1992,0,0,0,0,0,,,,0,0,0,0,,
6667,tt1493815,Little Murder,2011,100+,126,15,38,6,2.4,28.0,,0,0,0,0,,
6668,tt1826943,Vanthaan Vendraan,2011,Fewer than 50,3,0,2,0,,,,0,0,0,0,,
6669,tt0064921,Salesman,1969,"1,000+",2477,422,52,142,4.1,89.0,,26,26,0,26,8.80,100.0
6670,tt0100438,Puppet Master II,1990,"5,000+",6194,192,325,172,3,37.0,,6,2,4,6,4.60,33.0
6671,tt0810809,Congorama,2006,500+,929,136,49,65,3.6,73.0,,8,3,5,8,5.30,38.0
6672,tt0320736,Vikram,1986,0,0,0,0,0,,,,0,0,0,0,,
6673,tt0123020,Crowned and Dangerous,1997,Fewer than 50,29,1,10,1,2.6,9.0,,1,0,1,1,,
6674,tt0090581,Abodh,1984,0,0,0,0,0,,,,0,0,0,0,,
6675,tt0118365,Justice League of America,1997,250+,411,52,51,26,3,50.0,,0,0,0,0,,
6676,tt0061015,Spinout,1966,500+,927,50,53,36,3.4,49.0,,6,2,4,6,5.00,33.0
6677,tt0083156,Bloody Moon,1981,"1,000+",1022,28,72,37,2.7,28.0,,4,3,1,4,,
6678,tt1251757,Middle Men,2009,"10,000+",19302,1415,1113,552,3.4,56.0,,52,21,31,52,5.60,40.0
6679,tt0118846,A Child's Wish,1997,0,0,0,0,0,,,,0,0,0,0,,
6680,tt0057367,Now Hear This,1962,Fewer than 50,1,1,0,0,,,,0,0,0,0,,
6681,tt0056293,Nude on the Moon,1961,250+,442,8,28,16,2.4,22.0,,0,0,0,0,,
6682,tt1182937,Rab Ne Bana Di Jodi,2008,Fewer than 50,25,23,2,3,4.6,92.0,,1,1,0,1,,
6683,tt1376460,Transmorphers: Fall of Man,2009,250+,279,9,87,45,1.4,9.0,,2,0,2,2,,
6684,tt0105041,Obsessed,1992,250+,263,9,6,4,3.7,60.0,,0,0,0,0,,
6685,tt2009589,Thambikottai,2011,0,0,0,0,0,,,,0,0,0,0,,
6686,tt0324532,When in Rome,2002,"25,000+",47862,763,887,524,3.1,46.0,,3,1,2,3,,
6687,tt1143896,Holy Rollers,2010,"2,500+",3184,298,603,232,2.9,33.0,,90,47,43,90,5.40,52.0
6688,tt0475417,Unearthed,2007,"1,000+",2284,44,453,276,1.8,9.0,,4,0,4,4,,
6689,tt0959337,Revolutionary Road,2008,"100,000+",107098,18545,7597,10049,3.6,71.0,,215,143,72,215,6.60,67.0
6690,tt0114371,Search and Destroy,1995,"1,000+",1937,30,43,24,3.1,41.0,,9,3,6,9,4.80,33.0
6691,tt0085169,Anna to the Infinite Power,1983,100+,176,9,7,7,3.5,56.0,,0,0,0,0,,
6692,tt0094685,The Attic: The Hiding of Anne Frank,1988,Fewer than 50,47,4,4,1,3.5,50.0,,0,0,0,0,,
6693,tt0995035,Dhol,2007,"1,000+",1862,136,131,89,3.3,51.0,,1,0,1,1,,
6694,tt0172632,Joe Gould's Secret,2000,500+,951,43,25,19,3.7,63.0,,34,22,12,34,6.70,65.0
6695,tt1226774,In the Loop,2009,"100,000+",227084,6574,1489,2672,3.9,82.0,,179,168,11,179,7.90,94.0
6696,tt0309600,Food of Love,2002,"1,000+",1164,36,59,41,2.8,38.0,,28,13,15,28,5.30,46.0
6697,tt1203532,Subdivision,2009,Fewer than 50,33,0,6,1,2,0.0,,0,0,0,0,,
6698,tt1928337,Mine Games,2012,250+,273,56,142,36,2.7,28.0,,0,0,0,0,,
6699,tt0112702,Coldblooded,1995,500+,944,62,30,28,3.6,67.0,,1,0,1,1,,
6700,tt1623742,Cinema Verite,2011,500+,563,237,158,85,3.4,60.0,,41,25,16,41,8.50,61.0
6701,tt0410631,Soba,2004,Fewer than 50,34,1,1,1,,,,0,0,0,0,,
6702,tt0462200,Black Snake Moan,2006,"250,000+",413767,16075,7201,13728,3.6,69.0,,162,107,55,162,6.30,66.0
6703,tt0075378,The Van,1977,500+,929,12,34,26,2.5,26.0,,0,0,0,0,,
6704,tt0119730,Murder Live!,1997,Fewer than 50,47,2,3,1,2.9,40.0,,0,0,0,0,,
6705,tt1220719,Ip Man,2008,"25,000+",27807,10032,798,2858,4.3,93.0,,29,25,4,29,6.70,86.0
6706,tt1208647,Behind Enemy Lines: Colombia,2009,"1,000+",1949,116,361,191,2.6,24.0,,3,2,1,3,,
6707,tt0114068,Out-of-Sync,1995,Fewer than 50,1,0,1,0,,,,0,0,0,0,,
6708,tt1266723,"Victoire Terminus, Kinshasa",2008,0,0,0,0,0,,,,0,0,0,0,,
6709,tt0954541,Bachelor Party 2: The Last Temptation,2008,"2,500+",2596,170,338,195,2.9,33.0,,2,0,2,2,,
6710,tt0824758,The Last Station,2009,"10,000+",20693,1839,903,927,3.5,67.0,,147,104,43,147,6.70,71.0
6711,tt0251789,Ladies Tailor,1985,100+,122,3,3,0,2.8,50.0,,0,0,0,0,,
6712,tt0246464,Big Trouble,2002,"10,000+",21188,930,787,684,3.4,54.0,,111,53,58,111,5.50,48.0
6713,tt0109134,Anjaam,1994,500+,943,64,55,29,3.4,54.0,,1,1,0,1,,
6714,tt0363780,Lymelife,2008,"10,000+",18810,672,611,426,3.3,52.0,,110,70,40,110,6.00,64.0
6715,tt0110943,Rampo,1994,250+,427,11,5,5,4,69.0,,4,2,2,4,,
6716,tt0469976,Spinning Into Butter,2007,250+,361,26,54,44,2.6,32.0,,32,5,27,32,3.60,16.0
6717,tt0072317,The Trial of Billy Jack,1974,"1,000+",2102,38,41,38,3.2,48.0,,10,4,6,10,4.80,40.0
6718,tt1869671,Sione's 2: Unfinished Business,2012,50+,91,11,13,5,3,46.0,,4,2,2,4,,
6719,tt1300851,The Boondock Saints II: All Saints Day,2009,"100,000+",111518,6536,4785,3477,3.4,58.0,,45,10,35,45,4.10,22.0
6720,tt0077788,Kiss Meets the Phantom of the Park,1978,"5,000+",6612,321,208,370,3.6,61.0,,1,0,1,1,,
6721,tt1086758,Maneater,2009,50+,93,11,21,10,2.7,34.0,,0,0,0,0,,
6722,tt0118041,Unforgivable,1996,100+,135,7,4,2,3.9,64.0,,0,0,0,0,,
6723,tt0359784,Oseam,2003,0,0,0,0,0,,,,0,0,0,0,,
6724,tt0067219,How to Frame a Figg,1971,500+,747,39,15,19,3.6,72.0,,2,2,0,2,,
6725,tt0790627,Brief Interviews with Hideous Men,2009,"2,500+",3086,246,521,266,2.8,32.0,,40,16,24,40,5.00,40.0
6726,tt11891806,Waiter,2006,500+,535,79,52,44,3.4,60.0,,4,2,2,4,,
6727,tt0088885,The Care Bears Movie,1985,"10,000+",18912,425,310,442,3.5,58.0,,7,3,4,7,5.10,43.0
6728,tt0099512,Ernest Goes to Jail,1990,"25,000+",42717,647,682,733,3.2,49.0,,9,1,8,9,3.60,11.0
6729,tt0081759,Windows,1980,50+,52,2,19,5,2,10.0,,8,0,8,8,2.30,0.0
6730,tt0077547,Filming 'Othello',1978,Fewer than 50,25,8,0,1,4.5,100.0,,3,3,0,3,,
6731,tt0257044,Road to Perdition,2002,"100,000+",189259,17657,2833,6247,4,86.0,,214,174,40,214,7.50,81.0
6732,tt0252444,Rabbit-Proof Fence,2002,"10,000+",23804,3031,483,1237,4,86.0,,145,127,18,145,7.60,88.0
6733,tt0457433,Perfect Stranger,2007,"250,000+",336580,8273,7838,8671,3.2,51.0,,143,14,129,143,3.50,10.0
6734,tt0095765,Cinema Paradiso,1988,"50,000+",65792,18107,658,5154,4.6,96.0,,84,76,8,84,8.00,90.0
6735,tt0435696,The Mechanik,2005,"1,000+",1239,91,107,94,3.2,46.0,,1,0,1,1,,
6736,tt0430030,Dobara,2004,0,0,0,0,0,,,,0,0,0,0,,
6737,tt1192620,Call of the Wild,2009,100+,201,21,34,12,2.9,38.0,,3,1,2,3,,
6738,tt0058073,The Evil of Frankenstein,1964,"1,000+",1052,68,123,87,3,36.0,,7,4,3,7,5.40,57.0
6739,tt0057277,Mahanagar,1963,500+,796,134,12,28,4.2,92.0,,27,25,2,27,8.40,93.0
6740,tt0893356,Nanking,2007,"5,000+",5301,595,84,298,4.1,88.0,,47,45,2,47,7.60,96.0
6741,tt1237838,Mystery Team,2009,"5,000+",5194,1012,576,465,3.5,64.0,,20,12,8,20,5.50,60.0
6742,tt0118974,Diana & Me,1997,Fewer than 50,1,1,0,1,,,,0,0,0,0,,
6743,tt2334731,Mad Buddies,2012,Fewer than 50,33,4,11,5,2,27.0,,0,0,0,0,,
6744,tt0373653,12 Days of Terror,2004,"1,000+",1440,34,92,40,2.7,27.0,,1,1,0,1,,
6745,tt0080076,A Vacation in Hell,1979,0,0,0,0,0,,,,0,0,0,0,,
6746,tt0271349,Abkari,1988,0,0,0,0,0,,,,0,0,0,0,,
6747,tt0156096,Spring Forward,1999,500+,803,92,21,40,3.9,81.0,,24,21,3,24,7.60,88.0
6748,tt0369838,Pompeii: The Last Day,2003,250+,267,25,14,6,3.7,64.0,,0,0,0,0,,
6749,tt2343599,Kanyakumari Express,2010,0,0,0,0,0,,,,0,0,0,0,,
6750,tt0063534,Salt and Pepper,1968,100+,123,8,14,9,2.7,36.0,,4,0,4,4,,
6751,tt0059124,Dr. Goldfoot and the Bikini Machine,1965,"1,000+",1873,76,98,96,3.1,44.0,,7,2,5,7,4.70,29.0
6752,tt0082818,Nightmare,1981,500+,901,57,76,54,3,43.0,,3,0,3,3,,
6753,tt0907680,Walk All Over Me,2007,"1,000+",1644,106,201,162,2.9,35.0,,5,2,3,5,5.20,40.0
6754,tt1091751,The Longshots,2008,"10,000+",22663,600,387,390,3.6,61.0,,71,29,42,71,5.20,41.0
6755,tt0181865,Traffic,2000,"100,000+",190655,17712,3228,4677,4,85.0,,223,208,15,223,8.10,93.0
6756,tt0259484,Paid in Full,2002,"10,000+",20714,3468,250,875,4.6,93.0,,43,23,20,43,5.80,53.0
6757,tt0204322,Firecracker,2005,"1,000+",1015,80,79,80,3,49.0,,1,1,0,1,,
6758,tt0091282,Jake Speed,1986,"1,000+",1368,23,29,25,3.2,44.0,,5,1,4,5,4.50,20.0
6759,tt9330112,Ninaithale Inikkum,2009,0,0,0,0,0,,,,0,0,0,0,,
6760,tt0062036,Night Fright,1967,250+,359,5,40,18,1.8,11.0,,0,0,0,0,,
6761,tt1134664,Boogie Woogie,2009,"1,000+",1104,74,268,111,2.5,22.0,,25,8,17,25,4.40,32.0
6762,tt1178663,Whatever Works,2009,"25,000+",39762,4611,2921,2396,3.4,61.0,,169,85,84,169,5.50,50.0
6763,tt1233219,"My Son, My Son, What Have Ye Done",2009,"2,500+",3456,445,553,291,3,44.0,,42,21,21,42,5.80,50.0
6764,tt0770814,Tennessee,2008,"2,500+",3788,73,60,51,3.5,55.0,,21,7,14,21,4.60,33.0
6765,tt0460792,Fast Food Nation,2006,"50,000+",62888,2875,3908,3195,3,42.0,,147,72,75,147,5.70,49.0
6766,tt0318797,Uzhaippaali,1993,Fewer than 50,1,1,0,0,,,,0,0,0,0,,
6767,tt0246186,Raakshasudu,1986,0,0,0,0,0,,,,0,0,0,0,,
6768,tt0292176,Pavithram,1994,0,0,0,0,0,,,,0,0,0,0,,
6769,tt0145529,Time Chasers,1994,500+,805,30,129,89,1.9,19.0,,0,0,0,0,,
6770,tt0401855,Underworld: Evolution,2006,"250,000+",567407,37097,14571,21550,3.8,72.0,,104,18,86,104,3.90,17.0
6771,tt1305816,The Hide,2008,100+,205,41,27,30,3.5,60.0,,1,1,0,1,,
6772,tt1151359,Leaves of Grass,2009,"10,000+",15363,1685,1745,882,3.2,49.0,,40,25,15,40,5.80,63.0
6773,tt0266464,Deyyam,1996,0,0,0,0,0,,,,0,0,0,0,,
6774,tt0384793,Accepted,2006,"250,000+",360894,28044,10921,15167,3.8,72.0,,116,44,72,116,5.10,38.0
6775,tt0249241,Werckmeister Harmonies,2000,"2,500+",4825,909,98,280,4.4,90.0,,48,47,1,48,8.50,98.0
6776,tt0086189,The Return of Captain Invincible,1983,250+,326,21,34,34,3,38.0,,5,3,2,5,4.80,60.0
6777,tt0101327,American Shaolin,1991,100+,167,18,16,8,3.3,53.0,,1,0,1,1,,
6778,tt0475723,Shinobi,2005,"5,000+",8693,1527,493,894,3.9,76.0,,3,1,2,3,,
6779,tt1502404,Drive Angry,2011,"25,000+",40389,4239,7300,3039,2.8,37.0,,124,58,66,124,5.30,47.0
6780,tt0105444,Something to Live for: The Alison Gertz Story,1992,100+,121,30,3,4,4.6,91.0,,0,0,0,0,,
6781,tt1027810,Fantastic Four: Rise of the Silver Surfer,2007,"250,000+",1340020,70671,68247,84528,3.2,51.0,,173,65,108,173,4.80,38.0
6782,tt0058208,The Horror of Party Beach,1964,500+,978,34,100,76,2.3,25.0,,6,0,6,6,2.90,0.0
6783,tt0072820,Cooley High,1975,"2,500+",4385,508,66,238,4.4,88.0,,18,16,2,18,6.40,89.0
6784,tt1090754,Come What May,2009,50+,67,8,5,1,3.6,62.0,,0,0,0,0,,
6785,tt0139861,Arunachalam,1997,100+,226,17,6,3,4.1,74.0,,0,0,0,0,,
6786,tt2255957,Silence of the Hams,1992,"1,000+",1436,142,181,90,2.9,44.0,,8,0,8,8,2.70,0.0
6787,tt1954877,Thambikku Indha Ooru,2010,0,0,0,0,0,,,,0,0,0,0,,
6788,tt0119068,Ernest Goes to Africa,1997,"5,000+",8222,78,190,117,2.6,29.0,,2,0,2,2,,
6789,tt0092007,Star Trek IV: The Voyage Home,1986,"50,000+",67041,6777,1583,2911,3.9,81.0,,45,37,8,45,7.10,82.0
6790,tt0089280,Hobgoblins,1988,"1,000+",1625,40,321,207,1.3,11.0,,1,0,1,1,,
6791,tt0066302,The Rise and Rise of Michael Rimmer,1970,250+,312,31,15,20,3.7,67.0,,0,0,0,0,,
6792,tt1172571,The Children,2008,"2,500+",3692,792,785,689,3.1,50.0,,17,13,4,17,6.60,76.0
6793,tt1388903,Mirch,2010,50+,68,10,24,10,2.8,29.0,,1,0,1,1,,
6794,tt0343048,Surakshaa,1995,0,0,0,0,0,,,,0,0,0,0,,
6795,tt0106333,Baazigar,1993,Fewer than 50,4,4,0,1,,,,1,1,0,1,,
6796,tt0858479,Smart People,2008,"100,000+",102392,3492,5368,4525,3,39.0,,151,75,76,151,5.70,50.0
6797,tt1188703,Hookers in Revolt,2006,Fewer than 50,49,15,1,1,4.9,94.0,,0,0,0,0,,
6798,tt0357782,Imtihan,1974,0,0,0,0,0,,,,0,0,0,0,,
6799,tt0097191,Desperate for Love,1989,Fewer than 50,36,1,4,0,2.2,20.0,,0,0,0,0,,
6800,tt0094961,Dead Heat,1988,"5,000+",6226,204,216,208,3.2,49.0,,9,1,8,9,3.70,11.0
6801,tt1504300,The Parking Lot Movie,2010,500+,834,329,86,106,3.9,79.0,,9,7,2,9,6.60,78.0
6802,tt0072856,Death Race 2000,1975,"25,000+",25907,2235,1285,1390,3.6,63.0,,38,31,7,38,6.80,82.0
6803,tt0455918,The Bracelet of Bordeaux,2007,50+,74,1,7,5,1.3,12.0,,0,0,0,0,,
6804,tt0113161,Get Shorty,1995,"50,000+",62205,4192,1818,1415,3.6,70.0,,57,50,7,57,7.70,88.0
6805,tt0316188,Raising Victor Vargas,2002,"5,000+",5995,694,138,280,4,83.0,,110,106,4,110,8.00,96.0
6806,tt1232838,Triple Dog,2010,"1,000+",1072,222,194,71,3.4,53.0,,0,0,0,0,,
6807,tt0479143,Rocky Balboa,2006,"250,000+",515721,28724,8848,19519,3.9,76.0,,183,142,41,183,6.50,78.0
6808,tt1188996,My Name Is Khan,2010,"10,000+",20104,4239,880,1589,4.1,83.0,,30,25,5,30,6.70,83.0
6809,tt0203755,One Night at McCool's,2001,"10,000+",16160,594,909,383,3,39.0,,105,35,70,105,4.80,33.0
6810,tt0285006,Australian Rules,2002,500+,935,55,19,27,3.8,74.0,,0,0,0,0,,
6811,tt0064088,The Big Cube,1968,100+,236,9,33,21,2.5,21.0,,1,0,1,1,,
6812,tt0095832,Pass the Ammo,1987,100+,105,19,10,9,3.7,66.0,,0,0,0,0,,
6813,tt0108086,Session Man,1991,Fewer than 50,2,2,0,1,,,,0,0,0,0,,
6814,tt0119434,Just Write,1997,500+,789,30,23,17,3.5,57.0,,8,4,4,8,7.10,50.0
6815,tt0062029,The Naked Runner,1967,50+,72,4,5,5,3.3,44.0,,1,0,1,1,,
6816,tt1452294,Just for the Record,2010,50+,75,3,22,12,1.5,12.0,,0,0,0,0,,
6817,tt2208248,Machhli Jal Ki Rani Hai,2014,0,0,0,0,0,,,,0,0,0,0,,
6818,tt0460740,Cashback,2006,"50,000+",51347,9102,2684,4213,3.8,77.0,,53,25,28,53,5.50,47.0
6819,tt0102004,The Hard Way,1991,"10,000+",11256,535,481,302,3.4,53.0,,24,18,6,24,5.80,75.0
6820,tt0261534,My Horrible Year!,2001,50+,94,5,5,3,3.1,50.0,,0,0,0,0,,
6821,tt0885398,Anamika: The Untold Story,2008,100+,107,3,19,6,2,14.0,,0,0,0,0,,
6822,tt0364243,Mr. Brahmachari,2003,0,0,0,0,0,,,,0,0,0,0,,
6823,tt0116282,Fargo,1996,"100,000+",235007,48294,3923,12439,4.3,92.0,,106,100,6,106,8.80,94.0
6824,tt1319743,Smokin' Aces 2: Assassins' Ball,2010,"2,500+",3423,325,1146,544,2.5,22.0,,9,4,5,9,4.20,44.0
6825,tt0303830,Casa de los babys,2003,"1,000+",1755,103,101,74,3.2,50.0,,106,61,45,106,6.00,58.0
6826,tt2351177,Bhooter Bhabishyat,2012,Fewer than 50,21,14,4,3,3.9,78.0,,0,0,0,0,,
6827,tt0084602,Rocky III,1982,"250,000+",345990,16616,5926,7945,3.9,74.0,,43,28,15,43,5.60,65.0
6828,tt0084602,Rocky III,1982,"250,000+",345990,16616,5926,7945,3.9,74.0,,43,28,15,43,5.60,65.0
6829,tt0361373,Bhalevadivi Basu,2001,0,0,0,0,0,,,,0,0,0,0,,
6830,tt0482527,It's a Boy Girl Thing,2006,"25,000+",30402,2370,1542,1556,3.5,61.0,,9,6,3,9,5.10,67.0
6831,tt0065073,Taste the Blood of Dracula,1970,"2,500+",3629,205,171,141,3.4,54.0,,13,7,6,13,5.70,54.0
6832,tt0053800,Esther and the King,1960,250+,492,8,21,10,2.8,28.0,,5,2,3,5,2.30,40.0
6833,tt0127969,Walking to the Waterline,1998,0,0,0,0,0,,,,0,0,0,0,,
6834,tt0326856,Envy,2004,50+,67,11,2,1,4.5,85.0,,0,0,0,0,,
6835,tt0069808,Blume in Love,1973,100+,122,18,16,12,3.1,53.0,,20,14,6,20,7.10,70.0
6836,tt1523372,Wild Things: Foursome,2010,250+,397,35,133,50,2.4,21.0,,2,0,2,2,,
6837,tt0846073,Raja Chinna Roja,1989,0,0,0,0,0,,,,0,0,0,0,,
6838,tt1496868,Silambattam,2008,0,0,0,0,0,,,,0,0,0,0,,
6839,tt0454084,Blind Dating,2006,"10,000+",13209,810,932,630,3.2,46.0,,24,6,18,24,4.20,25.0
6840,tt1024946,Shrek the Third,2007,"250,000+",2218576,108967,99091,202695,3.4,52.0,,212,88,124,212,5.50,42.0
6841,tt0115986,The Crow: City of Angels,1996,"50,000+",64875,1459,2171,1497,2.9,40.0,,37,5,32,37,3.50,14.0
6842,tt0085473,Eddie Macon's Run,1983,100+,196,7,27,9,2.6,21.0,,3,1,2,3,,
6843,tt0248497,Suswagatham,1997,0,0,0,0,0,,,,0,0,0,0,,
6844,tt1801051,Eyyvah Eyvah 2,2011,100+,166,54,17,5,3.7,76.0,,0,0,0,0,,
6845,tt1621426,Natural Selection,2011,"1,000+",1081,168,81,49,3.6,67.0,,35,26,9,35,6.60,74.0
6846,tt0120598,Barney's Great Adventure,1998,"1,000+",2087,89,114,122,2.9,44.0,,25,8,17,25,5.00,32.0
6847,tt1535020,Peraanmai,2009,Fewer than 50,12,4,1,0,3.9,80.0,,0,0,0,0,,
6848,tt0180691,Father Christmas,1991,250+,380,66,23,25,3.8,74.0,,0,0,0,0,,
6849,tt0110875,Possessed by the Night,1994,Fewer than 50,34,0,8,3,1.9,0.0,,4,2,2,4,,
6850,tt0059894,The War Game,1966,"1,000+",1354,286,34,109,4.1,89.0,,14,13,1,14,8.50,93.0
6851,tt1379734,Repo Chick,2009,100+,136,8,45,24,2,15.0,,15,6,9,15,4.50,40.0
6852,tt0246404,The 24th Day,2004,"2,500+",3243,202,145,167,3.5,58.0,,15,4,11,15,4.30,27.0
6853,tt0410730,Taxidermia,2006,"5,000+",6222,1272,401,618,3.8,76.0,,47,38,9,47,6.70,81.0
6854,tt0265787,The Source,2001,500+,995,24,29,25,3,45.0,,1,0,1,1,,
6855,tt0473105,Vampire Bats,2005,"1,000+",1409,28,80,49,2.5,26.0,,0,0,0,0,,
6856,tt1007028,Zack and Miri Make a Porno,2008,"100,000+",237209,20642,10510,11981,3.6,66.0,,199,130,69,199,6.10,65.0
6857,tt1243939,The Two Mr. Kissels,2008,100+,161,16,17,7,3.2,48.0,,0,0,0,0,,
6858,tt1437849,Le Donk & Scor-zay-zee,2009,500+,940,214,108,113,3.5,66.0,,23,20,3,23,6.20,87.0
6859,tt0149573,Aashiqui,1990,250+,351,26,16,11,3.3,62.0,,0,0,0,0,,
6860,tt0853096,Death of a President,2006,"10,000+",12251,1015,744,961,3.4,58.0,,101,40,61,101,5.40,40.0
6861,tt0265148,Main Prem Ki Diwani Hoon,2003,"2,500+",3006,144,127,86,3.2,53.0,,1,0,1,1,,
6862,tt0432314,Leningrad,2009,250+,389,78,104,37,3,43.0,,0,0,0,0,,
6863,tt0164961,Vidocq,2001,"5,000+",5114,566,302,204,3.5,65.0,,3,2,1,3,,
6864,tt0431213,Lassie,2005,"25,000+",48207,391,218,333,3.5,64.0,,69,64,5,69,7.30,93.0
6865,tt0421143,A New Wave,2006,250+,494,7,73,41,1.8,9.0,,6,2,4,6,4.80,33.0
6866,tt0369994,Strangers with Candy,2005,"50,000+",66078,1488,1200,1548,3.3,55.0,,103,53,50,103,5.90,51.0
6867,tt1268970,The Last Rites of Ransom Pride,2010,"10,000+",19435,55,105,64,2.7,34.0,,0,0,0,0,,
6868,tt0254962,Angane Oravadhikkalathu,1999,0,0,0,0,0,,,,0,0,0,0,,
6869,tt1525890,The Caller,2011,"1,000+",1443,381,559,247,3,41.0,,8,3,5,8,5.10,38.0
6870,tt1487931,Khumba,2013,500+,746,136,170,54,3.1,44.0,,18,8,10,18,4.80,44.0
6871,tt1525890,The Caller,2011,"1,000+",1443,381,559,247,3,41.0,,8,3,5,8,5.10,38.0
6872,tt0104647,Kuffs,1992,"10,000+",10363,402,450,260,3.2,47.0,,18,5,13,18,4.50,28.0
6873,tt0221097,CryBaby Lane,2000,Fewer than 50,2,2,0,0,,,,0,0,0,0,,
6874,tt0077233,The Big Fix,1978,250+,310,28,28,18,3.2,50.0,,16,14,2,16,7.40,88.0
6875,tt0206275,Save the Last Dance,2001,"250,000+",31845749,48946,34139,991681,3.1,59.0,,100,54,46,100,5.50,54.0
6876,tt0246339,Yamudiki Mogudu,1988,50+,57,6,0,0,3.9,100.0,,0,0,0,0,,
6877,tt2126282,Ekk Deewana Tha,2012,100+,107,9,33,7,2.5,21.0,,3,0,3,3,,
6878,tt0288215,Shadow Fury,2001,"1,000+",1072,3,9,3,2.5,25.0,,0,0,0,0,,
6879,tt0425162,Kaazhcha,2004,0,0,0,0,0,,,,0,0,0,0,,
6880,tt0070628,The Hourglass Sanatorium,1973,Fewer than 50,6,5,1,1,4,83.0,,0,0,0,0,,
6881,tt1067106,A Christmas Carol,2009,Fewer than 50,8,2,2,3,,,,0,0,0,0,,
6882,tt0409847,Cowboys & Aliens,2011,"100,000+",104954,19498,25664,8988,3.1,43.0,,259,115,144,259,5.60,44.0
6883,tt0119494,The Land Girls,1998,"1,000+",2056,73,68,45,3.4,52.0,,18,11,7,18,6.50,61.0
6884,tt0169347,Undercover Angel,1999,500+,751,61,22,36,3.9,73.0,,2,2,0,2,,
6885,tt0845448,Dhamaal,2007,"2,500+",3012,318,158,177,3.7,67.0,,2,2,0,2,,
6886,tt1256626,Glago's Guest,2008,0,0,0,0,0,,,,0,0,0,0,,
6887,tt0265242,The Jet Benny Show,1986,Fewer than 50,5,1,2,1,,,,0,0,0,0,,
6888,tt0143145,The World Is Not Enough,1999,"100,000+",210591,6358,6574,5178,3.2,49.0,,148,75,73,148,5.60,51.0
6889,tt0319758,Live from Baghdad,2002,"2,500+",4582,372,72,115,3.9,84.0,,9,7,2,9,7.00,78.0
6890,tt0068273,The Big Bird Cage,1972,"1,000+",2416,122,70,69,3.6,63.0,,5,5,0,5,6.30,100.0
6891,tt0403057,Gardener of Eden,2007,250+,436,13,26,12,3,33.0,,1,0,1,1,,
6892,tt0074812,Logan's Run,1976,"25,000+",44840,3278,1642,1920,3.6,67.0,,35,21,14,35,6.10,60.0
6893,tt1065073,Boyhood,2014,"50,000+",90148,30701,7451,5128,4,80.0,,336,325,11,336,9.20,97.0
6894,tt0954914,Athidhi,2007,100+,159,9,12,5,3.5,43.0,,0,0,0,0,,
6895,tt6607552,The End of Summer,1959,500+,788,159,26,54,4.1,86.0,,8,8,0,8,8.90,100.0
6896,tt1017465,Twitches Too,2007,"2,500+",3661,320,136,135,3.8,70.0,,4,2,2,4,,
6897,tt0077343,Cleopatra Wong,1978,Fewer than 50,1,0,1,0,,,,0,0,0,0,,
6898,tt0115640,Beautiful Thing,1996,"10,000+",10439,2076,158,804,4.4,93.0,,24,22,2,24,6.70,92.0
6899,tt0183790,A Knight's Tale,2001,"250,000+",378948,52787,13817,21485,3.9,79.0,,152,90,62,152,5.90,59.0
6900,tt0233926,In Which Annie Gives It Those Ones,1989,0,0,0,0,0,,,,0,0,0,0,,
6901,tt0114709,Toy Story,1995,"250,000+",1109209,74823,6454,49719,3.8,92.0,,97,97,0,97,9.10,100.0
6902,tt0082314,Ek Duuje Ke Liye,1981,0,0,0,0,0,,,,0,0,0,0,,
6903,tt0374312,The Eliminator,2004,50+,97,4,18,10,2.3,18.0,,1,0,1,1,,
6904,tt0074455,Eaten Alive,1976,"2,500+",3406,152,353,214,2.7,30.0,,17,6,11,17,4.70,35.0
6905,tt0341495,Naked Weapon,2002,"5,000+",8429,405,350,356,3.3,54.0,,1,1,0,1,,
6906,tt0094958,Dayavan,1988,250+,250,5,3,2,3.6,62.0,,0,0,0,0,,
6907,tt1200060,The English Surgeon,2007,"2,500+",3604,59,1,26,4.2,98.0,,19,17,2,19,7.40,89.0
6908,tt0275175,Aan Paavam,1985,0,0,0,0,0,,,,0,0,0,0,,
6909,tt0300016,I Love You Baby,2001,50+,53,1,8,0,2.8,11.0,,0,0,0,0,,
6910,tt1475358,En Kadamai,1964,0,0,0,0,0,,,,0,0,0,0,,
6911,tt0463915,Gunhed,1989,250+,488,9,23,20,2.9,28.0,,1,1,0,1,,
6912,tt0114170,Power 98,1996,0,0,0,0,0,,,,0,0,0,0,,
6913,tt0209077,Ken Park,2002,"5,000+",9447,1268,1071,703,3.3,54.0,,13,6,7,13,4.80,46.0
6914,tt0100929,White Room,1990,0,0,0,0,0,,,,0,0,0,0,,
6915,tt1781767,Amy George,2011,Fewer than 50,8,2,4,1,2.7,33.0,,0,0,0,0,,
6916,tt1020978,Naqaab,2007,500+,793,74,88,89,3.1,46.0,,3,0,3,3,,
6917,tt0373935,Jaisi Karni Waisi Bharni,1989,Fewer than 50,33,0,2,0,,,,0,0,0,0,,
6918,tt0067975,What's the Matter with Helen?,1971,250+,363,36,51,42,3.3,41.0,,11,6,5,11,5.10,55.0
6919,tt0379225,The Corporation,2003,"10,000+",22769,3514,401,1379,4.2,90.0,,111,99,12,111,7.40,89.0
6920,tt0064265,Return of the One-Armed Swordsman,1969,50+,74,31,9,12,3.8,78.0,,0,0,0,0,,
6921,tt0088067,Screamplay,1984,50+,88,7,8,6,3.4,47.0,,0,0,0,0,,
6922,tt1460743,Reign of Assassins,2010,"1,000+",1407,508,188,228,3.7,73.0,,10,7,3,10,5.80,70.0
6923,tt0278493,I Am Josh Polonski's Brother,2001,0,0,0,0,0,,,,0,0,0,0,,
6924,tt0102148,Jamai Raja,1990,100+,101,3,2,2,3.3,60.0,,0,0,0,0,,
6925,tt0245573,XX/XY,2002,"2,500+",3265,162,208,101,3.1,44.0,,64,27,37,64,5.30,42.0
6926,tt0250593,Mom's Got a Date with a Vampire,2000,"5,000+",5061,201,192,116,3.3,51.0,,1,0,1,1,,
6927,tt2065924,Engeyum Eppodhum,2011,Fewer than 50,4,3,0,2,,,,0,0,0,0,,
6928,tt0475252,Jack and Jill vs. the World,2008,"1,000+",2191,146,343,178,2.8,30.0,,8,2,6,8,3.70,25.0
6929,tt0791321,Live Evil,2009,50+,92,2,7,1,2.2,22.0,,0,0,0,0,,
6930,tt1068161,Resolved,2007,250+,313,62,9,35,4,87.0,,0,0,0,0,,
6931,tt0318761,Thumbsucker,2005,"50,000+",57568,3828,1576,2055,3.7,71.0,,117,83,34,117,6.80,71.0
6932,tt0343962,Latin Dragon,2004,100+,121,2,8,3,1.6,20.0,,0,0,0,0,,
6933,tt1488015,One Nation Under God,2009,Fewer than 50,16,4,8,3,2.8,33.0,,9,3,6,9,4.50,33.0
6934,tt1496797,Maayavi,2005,0,0,0,0,0,,,,0,0,0,0,,
6935,tt0418676,Novel Romance,2006,0,0,0,0,0,,,,0,0,0,0,,
6936,tt0096794,Always,1989,"10,000+",22811,1344,914,692,3.5,59.0,,27,18,9,27,5.70,67.0
6937,tt0281889,Go for Broke,2002,250+,417,9,1,3,4.6,90.0,,1,0,1,1,,
6938,tt0099611,Frankenhooker,1990,"5,000+",5956,436,320,333,3.4,58.0,,15,9,6,15,5.20,60.0
6939,tt0360231,Zinda Dil,1975,0,0,0,0,0,,,,0,0,0,0,,
6940,tt0067805,Sunday Bloody Sunday,1971,"2,500+",2680,258,108,105,3.7,70.0,,30,26,4,30,7.70,87.0
6941,tt0109493,The Cowboy Way,1994,"10,000+",20216,713,490,357,3.5,59.0,,15,3,12,15,4.20,20.0
6942,tt0280105,Shackleton's Antarctic Adventure,2001,Fewer than 50,10,2,0,1,,,,4,3,1,4,,
6943,tt1229764,Ring of Death,2008,250+,264,12,39,19,2.5,24.0,,1,0,1,1,,
6944,tt0105569,Tetsuo II: Body Hammer,1992,"2,500+",4043,235,146,116,3.4,62.0,,4,3,1,4,,
6945,tt1844025,Sadako 3D,2012,100+,133,18,91,40,2,16.0,,2,0,2,2,,
6946,tt0353248,Full Clip,2004,Fewer than 50,16,1,6,2,2.1,14.0,,0,0,0,0,,
6947,tt0056802,"80,000 Suspects",1963,100+,165,3,6,4,3.2,33.0,,0,0,0,0,,
6948,tt0417415,Aliens of the Deep,2005,"2,500+",4146,140,147,120,3.2,49.0,,62,52,10,62,7.00,84.0
6949,tt0376205,Souli,2004,0,0,0,0,0,,,,0,0,0,0,,
6950,tt0283972,Butterfly Man,2002,50+,97,7,2,3,3.5,78.0,,0,0,0,0,,
6951,tt1474918,Thomas & Friends: Hero of the Rails,2009,100+,170,27,7,13,3.8,79.0,,1,1,0,1,,
6952,tt0071258,Buster and Billie,1974,250+,381,61,6,34,4.4,91.0,,3,1,2,3,,
6953,tt0972913,Vasthavam,2006,0,0,0,0,0,,,,0,0,0,0,,
6954,tt1074929,Adoration,2008,"1,000+",2191,289,305,210,3.2,49.0,,103,65,38,103,6.10,63.0
6955,tt0084553,Purple Haze,1982,Fewer than 50,42,8,0,3,4.4,100.0,,1,1,0,1,,
6956,tt0058456,The Patsy,1964,"1,000+",1656,74,43,37,3.6,63.0,,11,9,2,11,6.30,82.0
6957,tt0240793,Dark Prince: The True Story of Dracula,2000,"5,000+",7281,216,100,144,3.7,68.0,,5,1,4,5,4.50,20.0
6958,tt0133748,Ervinka,1967,0,0,0,0,0,,,,0,0,0,0,,
6959,tt0217629,Looking for Alibrandi,2000,"2,500+",4699,277,81,185,3.9,78.0,,3,3,0,3,,
6960,tt1318516,The Jailhouse,2009,50+,60,3,7,5,2.4,30.0,,0,0,0,0,,
6961,tt0064439,"Hook, Line and Sinker",1969,Fewer than 50,37,8,13,7,3.2,38.0,,1,0,1,1,,
6962,tt0071717,Killdozer,1974,250+,422,17,38,32,2.8,31.0,,1,0,1,1,,
6963,tt0079082,The Driller Killer,1979,"5,000+",5204,201,427,308,2.7,32.0,,14,9,5,14,5.90,64.0
6964,tt0453748,Kuchh Meetha Ho Jaye,2005,50+,80,2,6,0,2.6,25.0,,0,0,0,0,,
6965,tt1213672,Billy: The Early Years,2008,100+,234,36,24,21,3.7,60.0,,3,0,3,3,,
6966,tt0059893,Waqt,1965,100+,109,15,5,10,3.7,75.0,,0,0,0,0,,
6967,tt0126240,Chutney Popcorn,1999,"1,000+",1348,58,58,47,3.3,50.0,,13,11,2,13,6.30,85.0
6968,tt0083051,Senior Trip,1981,50+,77,8,1,0,4.1,89.0,,0,0,0,0,,
6969,tt1942884,Indie Game: The Movie,2012,"2,500+",4087,2370,227,408,4.2,91.0,,31,29,2,31,7.70,94.0
6970,tt0974959,American Pie Presents: Beta House,2007,"50,000+",65959,4250,3375,2563,3.4,56.0,,3,0,3,3,,
6971,tt0159097,The Virgin Suicides,1999,"100,000+",192723,18984,4530,6379,3.9,81.0,,110,88,22,110,7.10,80.0
6972,tt0172234,Chaahat,1996,500+,736,29,36,12,3.1,45.0,,0,0,0,0,,
6973,tt0366527,Goldfish Memory,2003,"1,000+",1907,162,105,75,3.5,61.0,,8,6,2,8,5.70,75.0
6974,tt0845955,Are You Scared,2006,"10,000+",12699,80,403,315,2,17.0,,2,0,2,2,,
6975,tt0101748,Dogfight,1991,"5,000+",7717,839,135,335,4.2,86.0,,20,16,4,20,6.70,80.0
6976,tt0095927,Punchline,1988,"5,000+",7288,245,330,129,3.1,43.0,,20,12,8,20,5.50,60.0
6977,tt0117470,Return of Jewel Thief,1996,0,0,0,0,0,,,,0,0,0,0,,
6978,tt0096535,Around the World in 80 Days,1989,0,0,0,0,0,,,,0,0,0,0,,
6979,tt0362004,Palindromes,2004,"5,000+",8929,1450,650,784,3.6,69.0,,119,51,68,119,5.50,43.0
6980,tt0497777,I Will Always Love You,2006,250+,336,12,2,4,4.1,86.0,,0,0,0,0,,
6981,tt0081376,The Private Eyes,1980,"2,500+",4858,322,66,183,4.2,83.0,,3,1,2,3,,
6982,tt0756683,The Man from Earth,2007,"10,000+",19297,6199,1086,2303,4.1,85.0,,5,5,0,5,8.10,100.0
6983,tt0756683,The Man from Earth,2007,"10,000+",19297,6199,1086,2303,4.1,85.0,,5,5,0,5,8.10,100.0
6984,tt0896522,Bah Humduck!: A Looney Tunes Christmas,2006,250+,415,68,44,41,3.7,61.0,,1,1,0,1,,
6985,tt1393742,Jesus Henry Christ,2011,"2,500+",4421,405,459,121,3.2,47.0,,23,5,18,23,4.10,22.0
6986,tt2640110,Annum Innum Ennum,2013,0,0,0,0,0,,,,0,0,0,0,,
6987,tt0176825,Homo Sapiens 1900,1998,250+,383,10,10,8,3.2,50.0,,3,0,3,3,,
6988,tt0086476,Trenchcoat,1983,Fewer than 50,7,2,4,4,2.7,33.0,,1,0,1,1,,
6989,tt0071221,Black Belt Jones,1974,"1,000+",2049,207,93,157,3.8,69.0,,2,0,2,2,,
6990,tt0111194,A Simple Twist of Fate,1994,"10,000+",10153,259,206,190,3.4,56.0,,21,9,12,21,5.40,43.0
6991,tt0110273,Knight Rider 2010,1994,"1,000+",1289,19,39,23,2.5,33.0,,0,0,0,0,,
6992,tt1176416,Tetsuo: The Bullet Man,2009,250+,385,65,101,59,2.9,39.0,,4,3,1,4,,
6993,tt0055949,Ek Musafir Ek Hasina,1962,250+,303,44,10,18,3.9,81.0,,0,0,0,0,,
6994,tt0462504,Rescue Dawn,2006,"100,000+",125853,14081,4805,8312,3.7,75.0,,162,145,17,162,7.50,90.0
6995,tt0285440,Asylum Days,2001,100+,143,4,9,6,2.9,31.0,,0,0,0,0,,
6996,tt0066561,When Dinosaurs Ruled the Earth,1970,"1,000+",1016,25,64,33,2.7,28.0,,6,1,5,6,4.70,17.0
6997,tt0412467,August Underground,2001,500+,973,118,125,119,3,49.0,,1,0,1,1,,
6998,tt0118001,Two Much,1995,"2,500+",4764,92,169,54,3,35.0,,7,1,6,7,3.60,14.0
6999,tt0069888,Class of '44,1973,Fewer than 50,14,0,6,3,2.3,0.0,,1,1,0,1,,
7000,tt1865567,Wrong Turn 4: Bloody Beginnings,2011,"1,000+",2010,368,946,310,2.6,28.0,,7,4,3,7,5.30,57.0
7001,tt0092106,The Transformers: The Movie,1986,"50,000+",74592,12595,1703,7630,4.3,88.0,,26,16,10,26,5.50,62.0
7002,tt0412467,August Underground,2001,500+,973,118,125,119,3,49.0,,1,0,1,1,,
7003,tt1630311,Butterfly Crush,2010,Fewer than 50,2,0,1,1,,,,0,0,0,0,,
7004,tt1536044,Paranormal Activity 2,2010,"100,000+",103162,12766,13723,7242,3.2,48.0,,137,78,59,137,6.00,57.0
7005,tt0337697,The Prince and Me,2004,0,0,0,0,0,,,,0,0,0,0,,
7006,tt1620933,Paan Singh Tomar,2012,500+,564,367,47,107,4.1,89.0,,2,2,0,2,,
7007,tt0057999,Dear Heart,1964,100+,126,33,13,17,3.7,72.0,,6,2,4,6,4.60,33.0
7008,tt1003023,Máncora,2008,250+,381,66,65,29,3.4,51.0,,6,2,4,6,4.60,33.0
7009,tt0095903,The Prince of Pennsylvania,1988,500+,553,33,35,20,3,49.0,,7,1,6,7,3.40,14.0
7010,tt0089749,Otaku no video,1991,"1,000+",1625,29,2,19,4,94.0,,0,0,0,0,,
7011,tt0193560,Texas Rangers,2001,"5,000+",7345,125,310,149,2.6,29.0,,51,1,50,51,3.40,2.0
7012,tt0062866,Dayton's Devils,1968,0,0,0,0,0,,,,0,0,0,0,,
7013,tt0109275,The Birds II: Land's End,1994,100+,215,6,41,14,1.8,13.0,,0,0,0,0,,
7014,tt0102825,Saajan,1991,"1,000+",1447,99,42,24,3.8,70.0,,0,0,0,0,,
7015,tt1055366,Camp Rock,2008,"50,000+",93156,8165,2742,4880,4,75.0,,22,11,11,22,4.40,50.0
7016,tt0078846,Beneath the Valley of the Ultra-Vixens,1979,"1,000+",1635,118,96,70,3.4,55.0,,4,4,0,4,,
7017,tt0480269,Interview,2007,"25,000+",25865,1833,1527,1354,3.3,55.0,,126,73,53,126,6.00,58.0
7018,tt0319622,Kaakki Sattai,1985,0,0,0,0,0,,,,0,0,0,0,,
7019,tt2101441,Spring Breakers,2012,"50,000+",62503,9114,14733,3612,2.7,38.0,,199,135,64,199,6.60,68.0
7020,tt0257475,Chhailla Babu,1977,0,0,0,0,0,,,,0,0,0,0,,
7021,tt0104511,Innocent Blood,1992,"5,000+",7201,268,329,222,3.1,45.0,,24,9,15,24,5.00,38.0
7022,tt0388710,Ammakilikkoodu,2003,0,0,0,0,0,,,,0,0,0,0,,
7023,tt0770703,What's Your Number?,2011,"25,000+",28388,4751,5969,1484,3.2,44.0,,116,27,89,116,4.40,23.0
7024,tt0093833,Redneck Zombies,1989,"2,500+",3611,166,224,192,2.8,43.0,,1,0,1,1,,
7025,tt0270846,Superbabies: Baby Geniuses 2,2004,"5,000+",7005,174,543,277,1.8,24.0,,46,0,46,46,2.50,0.0
7026,tt0114702,Total Eclipse,1995,"5,000+",7786,680,446,285,3.5,60.0,,18,4,14,18,4.50,22.0
7027,tt1626201,Red: Werewolf Hunter,2010,100+,208,29,103,25,2.4,22.0,,1,1,0,1,,
7028,tt0077296,Caravans,1978,"1,000+",1467,7,5,3,3.5,58.0,,3,1,2,3,,
7029,tt0089560,Mask,1985,"25,000+",44043,2260,462,1272,4.1,83.0,,29,27,2,29,7.50,93.0
7030,tt0076804,Telefon,1977,"1,000+",1330,78,84,45,3.2,48.0,,17,8,9,17,4.60,47.0
7031,tt0060857,Press for Time,1966,500+,781,19,20,12,3.3,49.0,,0,0,0,0,,
7032,tt0118073,A Very Brady Sequel,1996,"50,000+",62630,453,817,684,2.9,36.0,,37,21,16,37,5.90,57.0
7033,tt1241334,Saas Bahu Aur Sensex,2008,100+,191,8,21,16,2.9,28.0,,2,0,2,2,,
7034,tt0113862,Mr. Holland's Opus,1995,"50,000+",54793,4598,910,2212,4.1,84.0,,28,21,7,28,6.80,75.0
7035,tt1327827,One Hundred Mornings,2009,100+,171,15,20,8,2.9,43.0,,7,6,1,7,7.20,86.0
7036,tt0062113,Peppermint Frappé,1967,250+,301,37,12,14,3.8,76.0,,2,2,0,2,,
7037,tt0245317,The Next Big Thing,2001,"1,000+",1274,4,4,2,3.6,50.0,,17,7,10,17,4.90,41.0
7038,tt0805619,Stir of Echoes: The Homecoming,2007,500+,838,45,181,113,2.4,20.0,,0,0,0,0,,
7039,tt0848556,Vicious Circle,2009,50+,70,4,8,6,2.8,33.0,,0,0,0,0,,
7040,tt0055977,The Fast Lady,1962,Fewer than 50,7,3,3,2,3.1,50.0,,0,0,0,0,,
7041,tt0497470,Weapons,2007,250+,486,22,20,21,3.1,54.0,,10,0,10,10,3.20,0.0
7042,tt0246833,Oru Maravathoor Kanavu,1998,0,0,0,0,0,,,,0,0,0,0,,
7043,tt0439815,Slither,2006,"100,000+",103100,7189,4233,5421,3.4,63.0,,142,123,19,142,6.90,87.0
7044,tt1294688,Last Night,2010,"10,000+",14330,1844,2168,751,3.2,46.0,,71,38,33,71,5.50,54.0
7045,tt0114287,Rob Roy,1995,"25,000+",36306,2755,929,1077,3.8,75.0,,44,32,12,44,6.40,73.0
7046,tt0055082,"Léon Morin, prest",1961,500+,639,173,31,36,4,85.0,,24,23,1,24,7.80,96.0
7047,tt0059287,How to Stuff a Wild Bikini,1965,"1,000+",1564,33,67,35,2.9,33.0,,3,0,3,3,,
7048,tt0077797,Khatta Meetha,1978,0,0,0,0,0,,,,0,0,0,0,,
7049,tt0458339,Captain America: The First Avenger,2011,"100,000+",195948,76277,25049,15791,3.8,75.0,,275,219,56,275,7.00,80.0
7050,tt1018829,Super Sweet 16: The Movie,2007,"5,000+",7275,269,209,245,3.3,56.0,,1,0,1,1,,
7051,tt0790657,Everybody Wants to Be Italian,2007,"25,000+",40052,102,204,110,2.8,33.0,,22,2,20,22,3.40,9.0
7052,tt0249351,Ananda Bhairavi,1983,0,0,0,0,0,,,,0,0,0,0,,
7053,tt0072829,Crazy Mama,1975,500+,878,11,19,8,2.7,37.0,,12,11,1,12,6.50,92.0
7054,tt1691016,Tropico de Sangre,2010,100+,150,29,21,10,3.5,58.0,,0,0,0,0,,
7055,tt0113481,Johnny Mnemonic,1995,"50,000+",52002,1203,2661,1360,2.7,31.0,,38,7,31,38,4.10,18.0
7056,tt0806165,The Ramen Girl,2008,"5,000+",5105,674,662,471,3.2,50.0,,2,1,1,2,,
7057,tt0138874,Three seasons,1999,"1,000+",2487,270,33,100,4.2,89.0,,32,25,7,32,6.70,78.0
7058,tt0808508,Tom and Jerry in Shiver Me Whiskers,2006,100+,216,41,24,13,3.7,63.0,,3,2,1,3,,
7059,tt1043635,Fast Track: No Limits,2008,"1,000+",1522,67,145,80,2.9,32.0,,0,0,0,0,,
7060,tt0114592,Sweet Nothing,1995,250+,351,8,10,6,3.4,44.0,,11,4,7,11,5.10,36.0
7061,tt0207524,How to Kill Your Neighbor's Dog,2000,"1,000+",1448,206,77,97,3.8,73.0,,34,20,14,34,6.00,59.0
7062,tt0076767,Storm Boy,1976,250+,421,64,23,33,3.8,74.0,,0,0,0,0,,
7063,tt0465551,Notes on a Scandal,2006,"50,000+",77866,12099,2527,6640,3.9,83.0,,176,154,22,176,7.50,88.0
7064,tt0075449,Young Pioneers' Christmas,1976,Fewer than 50,8,0,1,0,,,,0,0,0,0,,
7065,tt0065764,Geet,1970,0,0,0,0,0,,,,0,0,0,0,,
7066,tt0377071,The Home Teachers,2004,"1,000+",1126,31,31,28,3,49.0,,0,0,0,0,,
7067,tt0896040,Something Beneath,2007,500+,720,5,64,36,1.7,7.0,,1,0,1,1,,
7068,tt0154960,Nootrukku Noor,1971,0,0,0,0,0,,,,0,0,0,0,,
7069,tt0094894,Colors,1988,"25,000+",28502,1649,659,548,3.7,71.0,,39,30,9,39,6.60,77.0
7070,tt0250012,Swathi Kiranam,1992,0,0,0,0,0,,,,0,0,0,0,,
7071,tt1185431,My One and Only,2009,"10,000+",16943,548,541,293,3.3,50.0,,71,49,22,71,6.20,69.0
7072,tt0459516,Pudhu Pettai,2006,Fewer than 50,26,19,2,6,4.4,90.0,,1,1,0,1,,
7073,tt0391229,I Want Someone to Eat Cheese With,2006,"2,500+",4710,414,657,580,2.9,38.0,,49,36,13,49,6.50,73.0
7074,tt0058019,A Distant Trumpet,1964,Fewer than 50,29,4,6,1,3.3,40.0,,8,4,4,8,6.00,50.0
7075,tt0317671,Honest Raj,1994,0,0,0,0,0,,,,0,0,0,0,,
7076,tt1014799,Holy Wars,2010,0,0,0,0,0,,,,0,0,0,0,,
7077,tt0109557,David's Mother,1994,50+,98,8,5,3,3.3,62.0,,0,0,0,0,,
7078,tt0349169,Breakin' All the Rules,2004,"10,000+",11082,465,350,269,3.5,57.0,,87,27,60,87,4.80,31.0
7079,tt0166321,The Real Macaw,1998,50+,98,15,1,5,4.2,94.0,,2,1,1,2,,
7080,tt0331042,The Utopian Society,2003,100+,103,5,6,7,3.3,45.0,,0,0,0,0,,
7081,tt0263488,Jeepers Creepers,2001,"250,000+",392444,6345,6664,9926,3.2,49.0,,115,52,63,115,5.10,45.0
7082,tt1068956,Khuda Kay Liye,2007,"2,500+",4376,879,109,472,4.3,89.0,,1,1,0,1,,
7083,tt0480048,Vacationland,2006,100+,126,5,17,7,2.6,23.0,,6,0,6,6,3.20,0.0
7084,tt0431340,Puppet Master vs Demonic Toys,2004,"1,000+",1295,74,188,111,2.3,28.0,,1,0,1,1,,
7085,tt0069165,Vengeance of the Zombies,1973,250+,274,8,21,10,2.5,25.0,,1,0,1,1,,
7086,tt0063404,Padosan,1968,500+,647,113,8,30,4.4,93.0,,0,0,0,0,,
7087,tt1151915,Nothing Like the Holidays,2008,"25,000+",32346,593,826,540,3.1,42.0,,98,52,46,98,5.70,53.0
7088,tt1150946,Krishnarjuna,2008,0,0,0,0,0,,,,0,0,0,0,,
7089,tt0810949,Born Equal,2006,250+,458,24,15,7,3.6,62.0,,0,0,0,0,,
7090,tt0110121,In Search of Dr. Seuss,1994,100+,172,27,8,8,4,77.0,,0,0,0,0,,
7091,tt0071797,Mahler,1974,500+,690,94,27,34,3.8,78.0,,7,5,2,7,8.40,71.0
7092,tt0080756,Foxes,1980,"2,500+",2772,172,137,110,3.4,56.0,,10,7,3,10,5.90,70.0
7093,tt0071486,Fantozzi,1975,Fewer than 50,10,9,1,3,4,90.0,,0,0,0,0,,
7094,tt0997218,Forest of the Dead,2007,0,0,0,0,0,,,,1,0,1,1,,
7095,tt0117739,Stella Does Tricks,1996,250+,393,14,9,12,3.4,61.0,,3,0,3,3,,
7096,tt1337350,Les mains libres,2010,Fewer than 50,7,1,3,0,,,,2,2,0,2,,
7097,tt0320126,Nagaravadhu,2001,0,0,0,0,0,,,,0,0,0,0,,
7098,tt0058933,Bad Girls Go to Hell,1965,Fewer than 50,48,4,19,9,2.3,17.0,,4,2,2,4,,
7099,tt1447972,StreetDance 3D,2010,"2,500+",2585,241,401,127,3,38.0,,27,11,16,27,4.40,41.0
7100,tt0267024,Thru the Moebius Strip,2005,50+,97,5,2,4,3,71.0,,0,0,0,0,,
7101,tt1176176,Polladhavan,1980,0,0,0,0,0,,,,0,0,0,0,,
7102,tt0083943,Firefox,1982,"10,000+",16064,643,895,366,3.1,42.0,,17,7,10,17,5.30,41.0
7103,tt6756342,Unnaruge Naan Irundhal,1999,0,0,0,0,0,,,,0,0,0,0,,
7104,tt0071437,Double Agent 73,1974,250+,488,18,35,21,2.7,35.0,,2,2,0,2,,
7105,tt0232012,Lupo the Butcher,1987,0,0,0,0,0,,,,0,0,0,0,,
7106,tt0107529,Matinee,1993,"5,000+",7050,539,324,230,3.5,62.0,,42,39,3,42,7.70,93.0
7107,tt0096918,Beverly Hills Brats,1989,100+,111,4,7,1,2.5,36.0,,0,0,0,0,,
7108,tt0105515,Tadipaar,1993,Fewer than 50,1,1,0,0,,,,0,0,0,0,,
7109,tt0407265,Transamerica,2005,"50,000+",68083,5734,1206,2839,3.9,83.0,,145,112,33,145,6.80,77.0
7110,tt1245091,Dark and Stormy Night,2009,100+,161,37,20,17,3.6,64.0,,0,0,0,0,,
7111,tt0154898,Moondru Mudichu,1976,0,0,0,0,0,,,,0,0,0,0,,
7112,tt0150488,Everybody Loves Sunshine,1998,500+,781,20,16,11,3.3,56.0,,3,1,2,3,,
7113,tt0068599,Fly Me,1973,0,0,0,0,0,,,,0,0,0,0,,
7114,tt0090898,Dallas: The Early Years,1986,Fewer than 50,33,6,1,1,3.9,86.0,,0,0,0,0,,
7115,tt0090769,The Boy in Blue,1986,500+,714,29,38,17,3.3,43.0,,0,0,0,0,,
7116,tt0154181,Avargal,1977,0,0,0,0,0,,,,0,0,0,0,,
7117,tt0367089,The Squid and the Whale,2005,"50,000+",79192,13580,3147,4847,3.9,81.0,,153,140,13,153,7.90,92.0
7118,tt0072389,Warhead,1977,Fewer than 50,3,0,1,1,,,,0,0,0,0,,
7119,tt0377752,Dear Frankie,2004,"25,000+",30723,3729,396,1825,4.2,90.0,,111,91,20,111,6.90,82.0
7120,tt0062190,The Reluctant Astronaut,1967,500+,923,107,86,66,3.4,55.0,,0,0,0,0,,
7121,tt0309326,The Backyard,2002,500+,763,26,22,23,3.2,54.0,,19,14,5,19,6.60,74.0
7122,tt0099026,The Ambulance,1990,500+,738,45,47,36,3.3,49.0,,4,3,1,4,,
7123,tt0084287,Made in Britain,1982,"2,500+",4851,523,103,232,4,83.0,,0,0,0,0,,
7124,tt1107319,Dirty Girl,2010,"5,000+",8665,742,649,195,3.3,53.0,,40,14,26,40,5.00,35.0
7125,tt1078588,My Sister's Keeper,2009,"250,000+",365414,13412,5103,8803,3.8,72.0,,139,66,73,139,5.50,47.0
7126,tt0283043,Teenage Caveman,2002,500+,952,41,215,96,2.1,16.0,,7,3,4,7,4.50,43.0
7127,tt0126189,Alice of Wonderland in Paris,1966,50+,50,2,2,1,,,,1,0,1,1,,
7128,tt1866230,Reel Love,2011,Fewer than 50,43,7,18,5,2.6,28.0,,0,0,0,0,,
7129,tt0434105,Eyarkai,2003,0,0,0,0,0,,,,0,0,0,0,,
7130,tt0055205,Murder She Said,1961,500+,614,135,38,40,3.9,78.0,,8,7,1,8,6.70,88.0
7131,tt0073451,The Nickel Ride,1974,100+,104,17,12,9,3.4,59.0,,3,2,1,3,,
7132,tt0053936,Ice Palace,1960,Fewer than 50,35,3,3,1,3.4,50.0,,1,0,1,1,,
7133,tt2113625,Book of Dragons,2011,Fewer than 50,4,2,2,3,,,,0,0,0,0,,
7134,tt0806147,Extreme Movie,2008,"10,000+",13170,182,831,378,2.1,18.0,,0,0,0,0,,
7135,tt0119231,The Junior Defenders,2007,100+,208,8,9,9,3.4,47.0,,0,0,0,0,,
7136,tt0280665,Femme Fatale,2002,"10,000+",18816,1045,1100,549,3.2,49.0,,137,67,70,137,5.50,49.0
7137,tt0087075,The Company of Wolves,1984,"5,000+",8448,1004,378,546,3.7,73.0,,20,17,3,20,6.80,85.0
7138,tt1437357,Faust,2011,"2,500+",2669,175,146,49,3.3,55.0,,38,25,13,38,6.60,66.0
7139,tt0113280,Heavy,1995,"1,000+",1715,163,82,73,3.5,66.0,,30,26,4,30,6.90,87.0
7140,tt0087229,Exterminator 2,1984,250+,377,28,62,38,2.6,31.0,,5,0,5,5,3.80,0.0
7141,tt2285529,Kazhugu,2012,0,0,0,0,0,,,,0,0,0,0,,
7142,tt0063102,How to Save a Marriage and Ruin Your Life,1968,250+,343,13,17,5,3.1,43.0,,1,0,1,1,,
7143,tt0102456,Mississippi Masala,1991,"5,000+",7151,363,203,170,3.5,64.0,,73,67,6,73,7.60,92.0
7144,tt1185376,Map of the Sounds of Tokyo,2009,500+,515,87,121,68,2.9,42.0,,1,0,1,1,,
7145,tt0102767,The Refrigerator,1991,250+,301,8,17,10,2.6,32.0,,0,0,0,0,,
7146,tt1725795,7aum Arivu,2011,250+,303,83,44,39,3.7,65.0,,1,0,1,1,,
7147,tt0094843,Casablanca Express,1989,100+,127,2,7,5,2.6,22.0,,0,0,0,0,,
7148,tt0091889,Samson og Sally,1984,0,0,0,0,0,,,,0,0,0,0,,
7149,tt0207957,Alvin and the Chipmunks Meet Frankenstein,1999,"1,000+",2061,111,70,62,3.6,61.0,,2,1,1,2,,
7150,tt1964886,Love Express,2011,Fewer than 50,4,1,1,0,,,,1,0,1,1,,
7151,tt0109969,Hail Caesar,1994,250+,497,7,45,13,2,13.0,,0,0,0,0,,
7152,tt1645080,The Art of Getting By,2011,"10,000+",12523,1723,1989,588,3.2,46.0,,112,22,90,112,4.30,20.0
7153,tt0188453,Birthday Girl,2001,"10,000+",22279,712,1100,448,3,39.0,,122,72,50,122,5.70,59.0
7154,tt0094357,A Better Tomorrow II,1987,"10,000+",10188,942,199,341,3.9,82.0,,5,4,1,5,6.50,80.0
7155,tt0106527,Casualties of Love: The Long Island Lolita Story,1993,0,0,0,0,0,,,,0,0,0,0,,
7156,tt0486674,What Just Happened,2008,"10,000+",12724,664,2301,1232,2.6,22.0,,143,71,72,143,5.70,50.0
7157,tt0816520,Return to Halloweentown,2006,"10,000+",15572,624,397,413,3.5,61.0,,4,2,2,4,,
7158,tt0179743,Crosstrap,1962,0,0,0,0,0,,,,0,0,0,0,,
7159,tt0448225,Kochi Rajavu,2005,Fewer than 50,1,1,0,0,,,,0,0,0,0,,
7160,tt0065093,The Thousand Plane Raid,1969,Fewer than 50,32,3,3,2,2.9,50.0,,0,0,0,0,,
7161,tt0092079,That's Life!,1986,"1,000+",1300,26,22,12,3.4,54.0,,15,8,7,15,5.80,53.0
7162,tt0361500,Delgo,2008,"1,000+",2336,109,307,164,2.4,26.0,,43,5,38,43,3.70,12.0
7163,tt0091429,Les longs manteaux,1986,0,0,0,0,0,,,,0,0,0,0,,
7164,tt1104836,Feast III: The Happy Finish,2009,"1,000+",1279,126,299,204,2.6,30.0,,2,2,0,2,,
7165,tt0053775,Doctor in Love,1960,50+,56,3,11,1,2.7,21.0,,2,1,1,2,,
7166,tt0074080,'Gator Bait,1973,50+,86,9,18,7,3.1,33.0,,1,1,0,1,,
7167,tt0087718,Micki + Maude,1984,"1,000+",2275,64,84,51,3.2,43.0,,10,7,3,10,5.60,70.0
7168,tt1135961,Bangkok Love Story,2007,250+,489,58,62,64,3.2,48.0,,0,0,0,0,,
7169,tt0459205,Sri Ramadasu,2006,Fewer than 50,49,0,3,0,,,,0,0,0,0,,
7170,tt0262246,Attack the Gas Station!,1999,Fewer than 50,5,4,1,1,3.8,80.0,,0,0,0,0,,
7171,tt0081664,Tuck Everlasting,1981,50+,71,10,9,3,3.5,53.0,,0,0,0,0,,
7172,tt0064000,Alfred the Great,1969,50+,73,7,4,5,3.6,64.0,,2,0,2,2,,
7173,tt1363125,Naughty @ 40,2011,0,0,0,0,0,,,,0,0,0,0,,
7174,tt0335057,Don't Ask Don't Tell,2002,"1,000+",1211,3,9,6,2.6,25.0,,11,4,7,11,4.40,36.0
7175,tt0208196,Happy Accidents,2000,"5,000+",7379,860,285,390,3.9,75.0,,63,44,19,63,6.40,70.0
7176,tt0294662,Kaante,2002,"1,000+",2449,191,55,75,3.9,78.0,,6,5,1,6,6.10,83.0
7177,tt0110478,Maverick,1994,"100,000+",161133,5480,2221,2579,3.7,71.0,,56,38,18,56,6.00,68.0
7178,tt0084735,A Stranger Is Watching,1982,"2,500+",3843,9,32,21,2.8,22.0,,1,1,0,1,,
7179,tt1084672,College Kumaran,2008,0,0,0,0,0,,,,0,0,0,0,,
7180,tt0210094,Happy Campers,2001,"2,500+",4488,197,121,118,3.5,62.0,,7,4,3,7,5.20,57.0
7181,tt1282140,Easy A,2010,"100,000+",129386,34964,10445,8493,3.8,77.0,,193,164,29,193,7.10,85.0
7182,tt1562568,Higher Ground,2011,"2,500+",2763,384,233,166,3.5,62.0,,92,75,17,92,7.10,82.0
7183,tt0169214,The Secret Life of Algernon,1998,Fewer than 50,1,0,1,0,,,,0,0,0,0,,
7184,tt1198408,Tenure,2008,500+,912,136,274,117,2.9,33.0,,1,0,1,1,,
7185,tt0082679,"Looney, Looney, Looney Bugs Bunny Movie",1981,500+,859,108,50,35,3.8,68.0,,4,3,1,4,,
7186,tt1382339,Santhosh Subramaniyam,2008,250+,277,30,5,17,4.2,86.0,,0,0,0,0,,
7187,tt0073747,The Stepford Wives,1975,"10,000+",14396,964,513,603,3.5,65.0,,38,26,12,38,6.30,68.0
7188,tt0450259,Blood Diamond,2006,"250,000+",569329,93670,10170,35243,4.2,90.0,,219,139,80,219,6.40,63.0
7189,tt0094997,Demonia,1990,"1,000+",1959,13,69,36,2.3,16.0,,0,0,0,0,,
7190,tt0298694,Saint Monica,2002,100+,200,5,7,8,2.8,42.0,,2,0,2,2,,
7191,tt0099356,A Dangerous Man: Lawrence After Arabia,1992,"1,000+",1980,28,20,16,3.7,58.0,,1,0,1,1,,
7192,tt1335986,Dahmer vs. Gacy,2010,50+,93,14,18,15,2.9,44.0,,0,0,0,0,,
7193,tt0104449,House IV,1992,Fewer than 50,4,1,3,0,,,,0,0,0,0,,
7194,tt1153100,Backwoods,2008,100+,159,29,130,64,2.3,18.0,,0,0,0,0,,
7195,tt0843875,Steel Magnolias,1990,"100,000+",175956,14043,1721,6813,4.3,89.0,,36,24,12,36,6.00,67.0
7196,tt1322282,Children of Invention,2009,500+,536,83,55,49,3.4,60.0,,14,11,3,14,6.70,79.0
7197,tt0483776,Popcorn,2007,500+,780,50,94,64,2.7,35.0,,1,0,1,1,,
7198,tt0412473,Babae sa breakwater,2003,50+,61,3,2,2,3.6,60.0,,0,0,0,0,,
7199,tt0248909,Innale,1989,0,0,0,0,0,,,,0,0,0,0,,
7200,tt0219374,Unconditional Love,2002,0,0,0,0,0,,,,0,0,0,0,,
7201,tt0088813,Black Arrow,1985,50+,85,0,4,1,,,,0,0,0,0,,
7202,tt0346156,Sky Captain and the World of Tomorrow,2004,"100,000+",119226,4317,5097,4020,3.1,46.0,,208,147,61,208,6.80,71.0
7203,tt1028558,Nadiya Kollappetta Rathri,2007,0,0,0,0,0,,,,0,0,0,0,,
7204,tt1219671,Allan Quatermain and the Temple of Skulls,2008,250+,327,7,57,30,1.5,11.0,,0,0,0,0,,
7205,tt0083655,Bingo Bongo,1982,0,0,0,0,0,,,,0,0,0,0,,
7206,tt0071721,The Klansman,1974,500+,644,13,41,26,2.6,24.0,,9,2,7,9,3.70,22.0
7207,tt0110538,Mixed Nuts,1994,"5,000+",9799,563,639,414,3.2,47.0,,31,4,27,31,3.10,13.0
7208,tt0086012,The Night the Bridge Fell Down,1980,Fewer than 50,9,1,0,0,,,,1,0,1,1,,
7209,tt0328078,Love That Boy,2003,500+,802,52,12,27,3.9,81.0,,5,4,1,5,6.80,80.0
7210,tt0317202,Brocéliande,2003,50+,90,0,11,3,1.7,0.0,,0,0,0,0,,
7211,tt0271984,Bad Karma,2001,"1,000+",1662,9,29,14,2.1,24.0,,4,0,4,4,,
7212,tt0271984,Bad Karma,2001,"1,000+",1662,9,29,14,2.1,24.0,,4,0,4,4,,
7213,tt0271984,Bad Karma,2001,"1,000+",1662,9,29,14,2.1,24.0,,4,0,4,4,,
7214,tt0081455,Scanners,1981,"25,000+",31656,2701,1522,1388,3.5,64.0,,44,30,14,44,6.70,68.0
7215,tt0271984,Bad Karma,2001,"1,000+",1662,9,29,14,2.1,24.0,,4,0,4,4,,
7216,tt0116332,For Better or Worse,1995,Fewer than 50,22,1,7,2,2.6,12.0,,0,0,0,0,,
7217,tt0097115,Courage Mountain,1990,"1,000+",1566,61,31,47,3.6,66.0,,3,2,1,3,,
7218,tt0155849,Man Vasanai,1983,0,0,0,0,0,,,,0,0,0,0,,
7219,tt0348150,Superman Returns,2006,"250,000+",517365,28455,18594,29717,3.4,61.0,,267,197,70,267,7.00,74.0
7220,tt0115530,American Buffalo,1996,"2,500+",2564,93,110,66,3.1,46.0,,27,20,7,27,6.60,74.0
7221,tt0268160,Awaaz,1984,0,0,0,0,0,,,,0,0,0,0,,
7222,tt0060679,Matira Manisha,1966,Fewer than 50,1,1,0,0,,,,0,0,0,0,,
7223,tt0081634,A Time for Miracles,1980,Fewer than 50,46,2,0,0,,,,0,0,0,0,,
7224,tt0073236,Khel Khel Mein,1975,0,0,0,0,0,,,,0,0,0,0,,
7225,tt0083366,Zorro: The Gay Blade,1981,"5,000+",8152,367,142,251,3.8,72.0,,15,7,8,15,5.10,47.0
7226,tt1233334,Pariah,2011,"5,000+",8709,1410,318,305,3.9,82.0,,124,118,6,124,7.90,95.0
7227,tt0055469,Spare the Rod,1961,0,0,0,0,0,,,,0,0,0,0,,
7228,tt0780565,Mataharis,2007,250+,430,51,43,38,3.4,54.0,,1,0,1,1,,
7229,tt0914382,Quiet City,2007,"1,000+",1885,187,108,134,3.5,63.0,,20,16,4,20,7.10,80.0
7230,tt0070114,The Girls of Huntington House,1973,Fewer than 50,18,0,2,0,,,,0,0,0,0,,
7231,tt0170691,Tigerland,2000,"25,000+",34515,1911,778,796,3.6,71.0,,47,36,11,47,7.00,77.0
7232,tt0428038,Sweet Land,2005,"5,000+",6745,970,197,561,4,83.0,,73,62,11,73,7.30,85.0
7233,tt2058107,The Railway Man,2013,"10,000+",15597,2761,1299,595,3.6,68.0,,127,86,41,127,6.40,68.0
7234,tt1587807,Mega Piranha,2009,500+,823,69,371,202,1.6,16.0,,13,1,12,13,3.00,8.0
7235,tt1449247,Sahara Jaluchi,1998,0,0,0,0,0,,,,0,0,0,0,,
7236,tt0281686,Bubba Ho-Tep,2002,"50,000+",55796,7224,1955,4534,3.9,79.0,,104,82,22,104,6.80,79.0
7237,tt1854582,The Helpers,2012,100+,239,15,67,23,2.2,18.0,,1,0,1,1,,
7238,tt0214916,Manivathoorile Ayiram Shivarathrikal,1987,0,0,0,0,0,,,,0,0,0,0,,
7239,tt0109520,D2: The Mighty Ducks,1994,"250,000+",347499,3352,2351,5367,3.5,59.0,,14,3,11,14,4.30,21.0
7240,tt0062281,Smashing Time,1967,100+,112,10,10,8,3.2,50.0,,8,7,1,8,6.80,88.0
7241,tt0083806,Deathtrap,1982,"5,000+",5563,549,234,247,3.6,70.0,,19,14,5,19,6.80,74.0
7242,tt0109520,D2: The Mighty Ducks,1994,"250,000+",347499,3352,2351,5367,3.5,59.0,,14,3,11,14,4.30,21.0
7243,tt0119008,Donnie Brasco,1997,"100,000+",204597,23010,2875,5884,4.1,89.0,,57,50,7,57,7.70,88.0
7244,tt0087957,Purple Rain,1984,"25,000+",47247,3562,993,2233,4,78.0,,57,41,16,57,6.50,72.0
7245,tt0871016,Secret of the Cave,2006,250+,413,17,41,18,2.8,30.0,,2,1,1,2,,
7246,tt0788072,The Feeding,2006,250+,343,3,49,27,1.4,6.0,,0,0,0,0,,
7247,tt0373152,Mind the Gap,2004,500+,942,108,13,40,4.1,89.0,,16,9,7,16,5.50,56.0
7248,tt2755518,Despicable Me: Minion Mayhem 3D,2012,Fewer than 50,5,4,1,3,4.3,80.0,,0,0,0,0,,
7249,tt0103923,Captain America,1990,"10,000+",10794,261,1103,527,2.1,19.0,,17,2,15,17,3.70,12.0
7250,tt0086582,The Wicked Lady,1983,100+,222,9,15,7,3,38.0,,3,2,1,3,,
7251,tt0101609,Conagher,1991,"1,000+",2030,58,19,30,4.1,75.0,,1,1,0,1,,
7252,tt0110410,Lurking Fear,1994,250+,256,9,52,26,2.4,15.0,,5,1,4,5,3.40,20.0
7253,tt0240980,Till Human Voices Wake Us,2002,"1,000+",2363,160,87,76,3.6,65.0,,72,18,54,72,5.00,25.0
7254,tt0070947,Zanjeer,1973,500+,624,61,23,23,3.7,73.0,,0,0,0,0,,
7255,tt0168819,Georgica,1998,0,0,0,0,0,,,,0,0,0,0,,
7256,tt1133985,Green Lantern,2011,"100,000+",149809,28015,34330,12641,3.1,45.0,,249,63,186,249,4.60,25.0
7257,tt0415949,Keeping Up with the Steins,2006,"50,000+",90601,237,391,355,3,38.0,,84,30,54,84,4.90,36.0
7258,tt0763831,A Thousand Words,2012,"50,000+",74997,4907,5655,1341,3.1,46.0,,58,0,58,58,3.20,0.0
7259,tt0102728,Puppet Master III: Toulon's Revenge,1991,"5,000+",6231,227,210,160,3.3,52.0,,2,1,1,2,,
7260,tt0095889,Poltergeist III,1988,"10,000+",17781,335,1180,508,2.5,22.0,,19,3,16,19,3.90,16.0
7261,tt0401742,Raptor Island,2004,250+,287,12,59,37,1.9,17.0,,1,0,1,1,,
7262,tt0063242,Love Camp 7,1969,0,0,0,0,0,,,,0,0,0,0,,
7263,tt0281157,Sakalakala Vallavan,1982,0,0,0,0,0,,,,0,0,0,0,,
7264,tt0476819,Nehlle Pe Dehlla,2007,500+,723,10,27,21,2.6,27.0,,1,0,1,1,,
7265,tt0093021,Fight for Life,1987,100+,212,3,3,4,3.4,50.0,,0,0,0,0,,
7266,tt0285728,Dahmer,2002,"5,000+",8032,434,660,397,3,40.0,,41,30,11,41,6.50,73.0
7267,tt0412915,The Librarian: Quest for the Spear,2004,"10,000+",12517,796,602,561,3.4,57.0,,5,3,2,5,6.80,60.0
7268,tt0120711,Babylon 5: In the Beginning,1998,"2,500+",3520,313,40,124,4.2,89.0,,0,0,0,0,,
7269,tt0337851,Baywatch: Hawaiian Wedding,2003,500+,771,45,55,26,2.8,45.0,,0,0,0,0,,
7270,tt0074670,"Ilsa, Harem Keeper of the Oil Sheiks",1976,"1,000+",1071,46,93,53,2.9,33.0,,4,1,3,4,,
7271,tt0454841,The Hills Have Eyes,2006,"250,000+",392776,14617,10545,17099,3.3,58.0,,140,73,67,140,5.60,52.0
7272,tt0432536,Hatya: The Murder,2004,0,0,0,0,0,,,,0,0,0,0,,
7273,tt1092086,Polis Is This: Charles Olson and the Persistence of Place,2007,0,0,0,0,0,,,,0,0,0,0,,
7274,tt0260746,Big Bad Love,2001,"1,000+",1190,39,16,30,3.8,71.0,,59,25,34,59,5.40,42.0
7275,tt1114740,Paul Blart: Mall Cop,2009,"250,000+",393414,13612,18171,16320,3,43.0,,117,40,77,117,4.60,34.0
7276,tt1815862,After Earth,2013,"100,000+",122171,14656,25956,5438,2.8,36.0,,213,25,188,213,3.90,12.0
7277,tt1170411,Victory,2009,250+,260,8,31,19,2.6,21.0,,1,0,1,1,,
7278,tt0122422,Silencing Mary,1998,100+,122,5,9,5,3.4,36.0,,0,0,0,0,,
7279,tt0361625,Flavors,2003,100+,107,17,5,10,3.9,77.0,,15,7,8,15,5.10,47.0
7280,tt0102316,Little Man Tate,1991,"10,000+",14940,803,415,251,3.6,66.0,,31,22,9,31,6.30,71.0
7281,tt0119819,Office Killer,1997,"1,000+",1212,74,71,48,3.3,51.0,,18,3,15,18,3.10,17.0
7282,tt0081235,Nijinsky,1980,50+,81,4,10,2,2.5,29.0,,8,4,4,8,4.50,50.0
7283,tt10183812,Aarilirunthu Arubathuvarai,1979,0,0,0,0,0,,,,0,0,0,0,,
7284,tt0082525,Honky Tonk Freeway,1981,250+,456,25,22,25,3.1,53.0,,3,3,0,3,,
7285,tt0065727,Flesh Feast,1970,250+,313,0,10,5,1.6,0.0,,3,0,3,3,,
7286,tt0091834,Red Headed Stranger,1986,Fewer than 50,37,2,0,1,,,,0,0,0,0,,
7287,tt1754332,Paappi Appachaa,2010,0,0,0,0,0,,,,0,0,0,0,,
7288,tt0120197,Star Maps,1997,100+,144,9,11,4,3,45.0,,18,7,11,18,5.00,39.0
7289,tt0787500,Love Comes Lately,2007,250+,308,19,19,17,3.1,50.0,,23,16,7,23,6.10,70.0
7290,tt0084737,Summer Lovers,1982,"1,000+",1980,115,102,76,3.3,53.0,,8,2,6,8,4.20,25.0
7291,tt0248808,For the Birds,2000,"1,000+",1848,433,61,92,4.2,88.0,,1,1,0,1,,
7292,tt0088934,Code Name: Emerald,1985,100+,110,7,10,2,3.3,44.0,,0,0,0,0,,
7293,tt0099180,Bride of Re-Animator,1990,"5,000+",7955,423,510,324,3.2,45.0,,19,7,12,19,5.10,37.0
7294,tt0112747,Cruel Jaws,1995,100+,179,10,41,23,2,20.0,,0,0,0,0,,
7295,tt0348843,Jism,2003,500+,628,69,42,29,3.5,62.0,,1,0,1,1,,
7296,tt1922612,Glee: The 3D Concert Movie,2011,"10,000+",17195,1598,875,491,3.6,65.0,,91,55,36,91,5.80,60.0
7297,tt0118040,Unforgettable,1996,"1,000+",1568,44,104,50,2.8,30.0,,28,6,22,28,4.40,21.0
7298,tt0482546,Miss Potter,2006,"250,000+",332649,8321,3832,6833,3.7,68.0,,131,90,41,131,6.30,69.0
7299,tt1503130,Kunguma Poovum Konjum Puravum,2009,0,0,0,0,0,,,,0,0,0,0,,
7300,tt0948547,Winged Creatures,2008,"10,000+",12677,294,700,392,2.8,29.0,,31,14,17,31,4.70,45.0
7301,tt1843335,Yutham Sei,2011,Fewer than 50,48,18,4,4,3.9,82.0,,0,0,0,0,,
7302,tt0163887,The Audrey Hepburn Story,2000,"1,000+",2303,139,149,103,3.2,48.0,,5,1,4,5,4.50,20.0
7303,tt0076745,Spectre,1977,0,0,0,0,0,,,,0,0,0,0,,
7304,tt2168910,Cocktail,2012,0,0,0,0,0,,,,0,0,0,0,,
7305,tt2168910,Cocktail,2012,0,0,0,0,0,,,,0,0,0,0,,
7306,tt0329620,Soch,2002,50+,56,0,3,1,,,,0,0,0,0,,
7307,tt0086312,Silkwood,1983,"10,000+",10023,1118,309,359,3.8,78.0,,37,28,9,37,7.70,76.0
7308,tt1361313,The Extra Man,2010,"2,500+",2533,246,417,215,2.9,37.0,,73,31,42,73,5.60,42.0
7309,tt1436481,Vel,2007,250+,311,26,15,11,3.7,63.0,,0,0,0,0,,
7310,tt0155528,Bamboo Gods and Iron Men,1974,0,0,0,0,0,,,,0,0,0,0,,
7311,tt0158587,Dhund,1973,100+,207,3,2,3,2.8,60.0,,0,0,0,0,,
7312,tt1027865,Tiyanaks,2007,Fewer than 50,46,1,0,0,,,,0,0,0,0,,
7313,tt0489486,"Good Boy, Bad Boy",2007,500+,900,39,51,39,2.9,44.0,,1,0,1,1,,
7314,tt0213965,A Holiday Romance,1999,0,0,0,0,0,,,,0,0,0,0,,
7315,tt0105003,Nightmare in the Daylight,1992,0,0,0,0,0,,,,1,0,1,1,,
7316,tt0372832,Skeleton Man,2004,"1,000+",1832,19,413,67,0.9,4.0,,1,0,1,1,,
7317,tt0273108,The Beautiful Country,2004,"1,000+",2235,258,68,98,3.8,79.0,,76,59,17,76,6.80,78.0
7318,tt0084809,The Toy,1982,"10,000+",16494,666,585,380,3.3,53.0,,30,1,29,30,4.00,3.0
7319,tt1103275,Two Lovers,2008,"50,000+",56353,2972,2078,1682,3.4,59.0,,168,138,30,168,6.80,82.0
7320,tt0158692,Juha,1999,250+,336,44,25,6,3.5,64.0,,5,2,3,5,6.40,40.0
7321,tt0462757,The Aggressives,2005,100+,165,50,15,19,4.2,77.0,,11,10,1,11,6.90,91.0
7322,tt0790713,The Minority,2006,100+,106,2,1,2,,,,0,0,0,0,,
7323,tt0459102,Import Export,2007,"1,000+",1634,339,106,133,3.8,76.0,,32,27,5,32,6.90,84.0
7324,tt0105812,White Men Can't Jump,1992,"100,000+",161972,4200,1920,2248,3.7,69.0,,107,80,27,107,6.40,75.0
7325,tt1601815,Chandamama,2007,50+,58,4,0,1,,,,1,0,1,1,,
7326,tt0325761,Luster,2002,500+,935,36,62,24,3,37.0,,10,5,5,10,4.70,50.0
7327,tt0210659,Dulhe Raja,1998,50+,96,10,6,2,3.8,62.0,,0,0,0,0,,
7328,tt0780511,Everybody's Fine,2009,"50,000+",91966,4253,3725,2189,3.3,53.0,,144,68,76,144,5.30,47.0
7329,tt0074173,Baby Blue Marine,1976,Fewer than 50,27,1,1,1,,,,3,0,3,3,,
7330,tt1714915,Only Lovers Left Alive,2013,"10,000+",21559,5352,1794,908,3.8,75.0,,209,180,29,209,7.60,86.0
7331,tt0084611,Ruckus,1980,100+,171,17,15,9,3.4,53.0,,1,0,1,1,,
7332,tt0419974,Morning Raga,2004,250+,283,14,13,12,3.4,52.0,,4,2,2,4,,
7333,tt1691323,Attenberg,2010,"1,000+",2358,221,198,77,3.2,53.0,,46,36,10,46,6.90,78.0
7334,tt0491027,The Legend of Sasquatch,2006,50+,75,2,8,6,1.9,20.0,,1,1,0,1,,
7335,tt0070833,Trick Baby,1972,250+,295,10,15,11,3,40.0,,5,4,1,5,7.80,80.0
7336,tt0326905,The Great Raid,2005,"10,000+",16851,1419,615,763,3.7,70.0,,120,46,74,120,5.30,38.0
7337,tt1744850,Let's Make a Movie,2012,Fewer than 50,4,4,0,3,,,,2,2,0,2,,
7338,tt0106426,Blind Side,1993,250+,298,15,20,7,3.1,43.0,,0,0,0,0,,
7339,tt0457572,Fido,2006,"25,000+",49274,5743,2265,4010,3.7,72.0,,78,56,22,78,6.50,72.0
7340,tt0341540,The R.M.,2003,"1,000+",1702,113,41,63,3.7,73.0,,11,7,4,11,5.70,64.0
7341,tt0061827,It's a Bikini World,1967,Fewer than 50,39,1,7,4,2,12.0,,0,0,0,0,,
7342,tt0087866,Oxford Blues,1984,250+,423,23,69,25,2.7,25.0,,0,0,0,0,,
7343,tt0179218,Hitman Hart: Wrestling with Shadows,1998,"5,000+",6504,546,68,264,4.2,89.0,,2,2,0,2,,
7344,tt0061489,Clambake,1967,"5,000+",5294,113,72,96,3.6,61.0,,5,1,4,5,5.50,20.0
7345,tt0419058,Phir Hera Pheri,2006,"1,000+",1982,198,96,67,3.7,67.0,,1,1,0,1,,
7346,tt0107384,Leningrad Cowboys Meet Moses,1994,250+,349,34,29,15,3.4,54.0,,0,0,0,0,,
7347,tt0197570,The Hungry Bachelors Club,1999,Fewer than 50,7,1,1,1,,,,3,0,3,3,,
7348,tt0450455,Life Is Ruff,2005,"5,000+",9743,181,118,137,3.5,61.0,,1,1,0,1,,
7349,tt0468580,We Go Way Back,2006,"1,000+",1350,11,6,5,3.4,65.0,,7,3,4,7,4.30,43.0
7350,tt0115951,Cosi,1996,"1,000+",2441,156,71,83,3.8,69.0,,4,2,2,4,,
7351,tt0105394,Shola Aur Shabnam,1992,0,0,0,0,0,,,,0,0,0,0,,
7352,tt1247640,District 13: Ultimatum,2009,"5,000+",5015,1216,992,653,3.3,55.0,,76,57,19,76,6.10,75.0
7353,tt0084516,Poltergeist,1982,"100,000+",182796,10639,2885,5532,3.9,79.0,,76,67,9,76,7.50,88.0
7354,tt1351784,Psychosis,2010,500+,543,17,120,37,1.7,12.0,,2,0,2,2,,
7355,tt1077248,Johnny Gaddaar,2007,"2,500+",2873,482,64,274,4,88.0,,2,2,0,2,,
7356,tt0107166,Hum Hain Rahi Pyar Ke,1993,"2,500+",3296,171,60,51,3.9,74.0,,0,0,0,0,,
7357,tt1583743,Jews and Baseball: An American Love Story,2010,100+,118,19,11,6,3.5,63.0,,13,9,4,13,6.60,69.0
7358,tt0460484,Kiltro,2006,Fewer than 50,15,5,5,4,3.4,50.0,,1,1,0,1,,
7359,tt1233227,Saw VI,2009,"250,000+",777419,130,143,56,3.3,48.0,,75,29,46,75,4.50,39.0
7360,tt0982875,Gauri: The Unborn,2007,100+,113,1,5,2,2.2,17.0,,1,0,1,1,,
7361,tt0119040,East Side Story,1997,50+,78,8,0,4,3.8,100.0,,2,2,0,2,,
7362,tt6442354,Bharathi Kannama,1997,0,0,0,0,0,,,,0,0,0,0,,
7363,tt0329393,Mr. and Mrs. Iyer,2002,"1,000+",2135,303,26,84,4.3,92.0,,0,0,0,0,,
7364,tt0075831,Checkered Flag or Crash,1977,Fewer than 50,11,0,2,1,,,,0,0,0,0,,
7365,tt0119718,Mr. Magoo,1997,"25,000+",35972,248,790,405,2.3,24.0,,31,3,28,31,2.70,10.0
7366,tt1233227,Saw VI,2009,"250,000+",777419,130,143,56,3.3,48.0,,75,29,46,75,4.50,39.0
7367,tt0303326,Derrida,2002,500+,995,88,64,62,3.4,58.0,,34,28,6,34,6.70,82.0
7368,tt0111586,Vanishing Son,1994,0,0,0,0,0,,,,0,0,0,0,,
7369,tt1704161,33 Postcards,2010,250+,405,41,56,17,3.1,42.0,,15,4,11,15,4.90,27.0
7370,tt0083820,Desh Premee,1982,250+,280,6,9,0,2.9,40.0,,0,0,0,0,,
7371,tt0094033,Steel Dawn,1987,"5,000+",5931,79,159,114,2.9,33.0,,3,1,2,3,,
7372,tt0096216,The Taking of Flight 847: The Uli Derickson Story,1988,Fewer than 50,25,1,1,0,,,,0,0,0,0,,
7373,tt13570616,Engal Aasan,2009,0,0,0,0,0,,,,0,0,0,0,,
7374,tt0103768,Barbarian Queen II: The Empress Strikes Back,1990,100+,147,3,23,13,2.2,12.0,,1,0,1,1,,
7375,tt1625346,Young Adult,2011,"25,000+",35266,8337,8667,3036,3.1,49.0,,198,159,39,198,7.00,80.0
7376,tt1756750,Starbuck,2011,"2,500+",4693,1230,309,226,3.8,80.0,,71,46,25,71,6.00,65.0
7377,tt0314564,The Real World Movie: The Lost Season,2002,Fewer than 50,1,1,0,0,,,,0,0,0,0,,
7378,tt0116007,Dallas: J.R. Returns,1996,50+,82,14,5,1,3.6,72.0,,0,0,0,0,,
7379,tt0070464,O Lucky Man!,1973,"2,500+",4303,633,98,271,4.2,87.0,,20,16,4,20,7.70,80.0
7380,tt0875702,Bury the Hatchet,2010,Fewer than 50,7,4,0,1,,,,3,3,0,3,,
7381,tt0194368,Chain of Fools,2000,"1,000+",2129,85,109,58,3.1,44.0,,0,0,0,0,,
7382,tt0092746,Cherry 2000,1987,"5,000+",7492,212,303,204,3,41.0,,21,8,13,21,4.60,38.0
7383,tt0218378,The Claim,2000,"2,500+",3529,177,185,102,3.3,49.0,,85,53,32,85,5.80,62.0
7384,tt0070622,Sssssss,1973,"1,000+",1407,50,141,80,2.7,26.0,,10,3,7,10,3.70,30.0
7385,tt0208903,Disco Dancer,1982,500+,599,58,12,33,4.1,83.0,,0,0,0,0,,
7386,tt1254207,Big Buck Bunny,2008,50+,94,24,22,12,3.4,52.0,,0,0,0,0,,
7387,tt0926380,The Boys Are Back,2009,"10,000+",21908,1193,762,616,3.4,61.0,,125,92,33,125,6.30,74.0
7388,tt1111876,Balibo,2009,500+,929,240,60,131,3.9,80.0,,12,12,0,12,7.80,100.0
7389,tt1098327,Dragonball Evolution,2009,"100,000+",210448,2277,9439,6479,2,19.0,,63,9,54,63,3.60,14.0
7390,tt1986040,Ishkq in Paris,2013,100+,111,8,18,2,2.8,31.0,,7,0,7,7,3.60,0.0
7391,tt0405963,Heartworn Highways,1976,100+,120,32,5,7,4.2,86.0,,6,6,0,6,8.30,100.0
7392,tt1361330,Santa Baby 2: Christmas Maybe,2009,100+,217,29,49,14,3,37.0,,0,0,0,0,,
7393,tt0116897,Little Witches,1996,"2,500+",3222,24,70,31,2.5,26.0,,5,2,3,5,4.70,40.0
7394,tt1523486,Kolpaçino,2009,50+,62,9,21,0,2.6,30.0,,0,0,0,0,,
7395,tt0093467,Made in Heaven,1987,"2,500+",3895,276,58,148,4.2,82.0,,16,9,7,16,5.20,56.0
7396,tt0099596,Forbidden Nights,1990,100+,144,2,2,2,,,,0,0,0,0,,
7397,tt0065150,The Undefeated,1969,"5,000+",6254,199,105,98,3.6,65.0,,9,4,5,9,5.30,44.0
7398,tt0063341,Never a Dull Moment,1968,"1,000+",1089,22,21,19,3.5,51.0,,2,2,0,2,,
7399,tt0263761,More Than Puppy Love,2002,50+,72,4,2,1,4.6,80.0,,0,0,0,0,,
7400,tt0173256,Stop! Look! and Laugh!,1960,Fewer than 50,22,7,0,2,4.4,100.0,,1,0,1,1,,
7401,tt0077728,In Praise of Older Women,1978,500+,603,6,20,6,2.8,23.0,,1,1,0,1,,
7402,tt1242447,Nativity!,2009,"1,000+",1606,600,307,285,3.6,66.0,,29,14,15,29,4.90,48.0
7403,tt1230387,Just Peck,2009,100+,143,31,40,10,3,44.0,,0,0,0,0,,
7404,tt0193007,Big Money Hustlas,2000,Fewer than 50,5,5,0,4,5,100.0,,0,0,0,0,,
7405,tt0205461,Thomas and the Magic Railroad,2000,"2,500+",3291,214,293,248,2.9,42.0,,68,14,54,68,4.00,21.0
7406,tt0455822,Unconscious,2006,500+,721,83,13,37,4.2,86.0,,26,22,4,26,7.30,85.0
7407,tt0120321,Smoke Signals,1998,"10,000+",10401,1436,319,732,4.1,82.0,,91,82,9,91,7.60,90.0
7408,tt0103747,The Babe,1992,"5,000+",7368,252,420,181,3.1,38.0,,38,18,20,38,5.00,47.0
7409,tt1301160,The Horribly Slow Murderer with the Extremely Inefficient Weapon,2008,Fewer than 50,3,3,0,1,,,,0,0,0,0,,
7410,tt0355611,Jonny Vang,2003,Fewer than 50,3,0,3,0,,,,1,0,1,1,,
7411,tt0054283,The Secret of the Purple Reef,1960,50+,50,2,2,4,,,,1,0,1,1,,
7412,tt0935075,Rabbit Hole,2010,"25,000+",31883,5793,2274,2094,3.6,72.0,,200,173,27,200,7.60,87.0
7413,tt0935075,Rabbit Hole,2010,"25,000+",31883,5793,2274,2094,3.6,72.0,,200,173,27,200,7.60,87.0
7414,tt1252507,The Way Home,2010,100+,106,20,13,12,3.5,61.0,,0,0,0,0,,
7415,tt1043860,Newcastle,2008,500+,505,94,95,57,3.3,50.0,,18,11,7,18,5.60,61.0
7416,tt0488535,Expired,2007,500+,618,88,108,89,3,45.0,,22,13,9,22,5.60,59.0
7417,tt0124294,Bice skoro propast sveta,1968,0,0,0,0,0,,,,0,0,0,0,,
7418,tt0104409,Hellraiser III: Hell on Earth,1992,"25,000+",42694,912,1662,939,2.9,35.0,,21,8,13,21,4.40,38.0
7419,tt1821641,The Congress,2013,"5,000+",7988,935,820,297,3.2,53.0,,109,80,29,109,6.70,73.0
7420,tt0459605,Eklavya,2007,0,0,0,0,0,,,,0,0,0,0,,
7421,tt1639405,Olimpius Inferno,2009,0,0,0,0,0,,,,0,0,0,0,,
7422,tt0155350,The Video Dead,1987,500+,843,73,155,114,2.7,32.0,,0,0,0,0,,
7423,tt0292040,Kalippattam,1993,0,0,0,0,0,,,,0,0,0,0,,
7424,tt0119783,Night Falls on Manhattan,1996,"1,000+",1712,167,92,67,3.5,64.0,,30,21,9,30,6.70,70.0
7425,tt0063800,Where Angels Go Trouble Follows!,1968,"1,000+",1526,65,49,57,3.5,57.0,,2,0,2,2,,
7426,tt0359614,Loha,1987,0,0,0,0,0,,,,0,0,0,0,,
7427,tt0109858,Funny Man,1994,500+,549,41,38,41,3.1,52.0,,1,1,0,1,,
7428,tt0065482,The Boatniks,1970,500+,555,20,18,21,3.1,53.0,,2,2,0,2,,
7429,tt0107179,I Love a Man in Uniform,1993,50+,87,9,5,6,3.4,64.0,,5,3,2,5,5.60,60.0
7430,tt1242544,Last Day of Summer,2009,100+,232,15,49,18,2.5,23.0,,6,1,5,6,5.20,17.0
7431,tt0057362,Nine Hours to Rama,1963,Fewer than 50,15,3,3,1,3.1,50.0,,5,4,1,5,6.00,80.0
7432,tt0090575,Aakhree Raasta,1986,100+,113,10,3,3,3.9,77.0,,0,0,0,0,,
7433,tt1105748,Zonad,2009,100+,186,12,30,9,2.7,29.0,,1,1,0,1,,
7434,tt0356176,Villmark,2003,Fewer than 50,28,7,13,1,3,35.0,,1,1,0,1,,
7435,tt0065724,Five Easy Pieces,1970,"10,000+",13237,2668,506,889,4,84.0,,55,49,6,55,8.60,89.0
7436,tt0248845,Hedwig and the Angry Inch,2001,"25,000+",49789,8000,621,3136,4.4,93.0,,116,107,9,116,7.90,92.0
7437,tt1038686,Legion,2010,"250,000+",312905,8141,17933,8972,2.7,31.0,,107,21,86,107,3.80,20.0
7438,tt0114536,Steal Big Steal Little,1995,"1,000+",1751,23,26,8,3.2,47.0,,13,2,11,13,4.50,15.0
7439,tt2232524,Mere Dost Picture Abhi Baaki Hai,2012,0,0,0,0,0,,,,0,0,0,0,,
7440,tt0139615,Slam,1998,"2,500+",2705,264,49,129,4.2,84.0,,23,14,9,23,6.80,61.0
7441,tt0133727,Ebenezer,1998,Fewer than 50,18,2,4,3,3.2,33.0,,0,0,0,0,,
7442,tt0116571,House Arrest,1996,0,0,0,0,0,,,,0,0,0,0,,
7443,tt0267736,The Matthew Shepard Story,2002,Fewer than 50,2,2,0,0,,,,0,0,0,0,,
7444,tt0115773,Buenos Aires Vice Versa,1996,50+,82,6,0,0,3.9,100.0,,0,0,0,0,,
7445,tt0954947,The Killer Inside Me,2010,"10,000+",15230,1938,2954,1536,2.9,40.0,,130,73,57,130,5.70,56.0
7446,tt0422236,Fida,2004,"5,000+",5294,115,80,86,3.4,59.0,,1,0,1,1,,
7447,tt0064718,Nell'anno del Signore,1969,Fewer than 50,7,4,2,0,4,67.0,,0,0,0,0,,
7448,tt0063348,The Night They Raided Minsky's,1968,250+,369,27,36,21,3.1,44.0,,6,4,2,6,6.10,67.0
7449,tt0307479,Solaris,2002,"25,000+",48013,4580,3233,2659,3.3,59.0,,210,139,71,210,6.60,66.0
7450,tt1094162,AVH: Alien vs. Hunter,2007,500+,763,17,137,81,1.5,11.0,,0,0,0,0,,
7451,tt0104377,Guncrazy,1992,"2,500+",2741,61,93,42,3.1,39.0,,8,5,3,8,5.50,63.0
7452,tt3343350,One Shot,2014,Fewer than 50,1,0,1,0,,,,0,0,0,0,,
7453,tt0085207,Baby Sister,1983,50+,55,0,5,1,2.5,0.0,,0,0,0,0,,
7454,tt0780126,Re-Animated,2006,100+,115,7,30,16,1.7,19.0,,1,0,1,1,,
7455,tt0784977,Colma: The Musical,2006,"1,000+",1431,99,45,96,3.6,69.0,,31,28,3,31,7.30,90.0
7456,tt0079631,Nightwing,1979,100+,247,10,31,10,2.6,24.0,,6,2,4,6,3.00,33.0
7457,tt1137439,Blue Gold: World Water Wars,2008,500+,527,156,28,65,4.1,85.0,,2,1,1,2,,
7458,tt0068682,Haunts of the Very Rich,1972,Fewer than 50,22,2,3,3,3.3,40.0,,1,1,0,1,,
7459,tt0090223,Twice in a Lifetime,1985,500+,831,27,23,16,3.4,54.0,,6,5,1,6,7.40,83.0
7460,tt0074259,Bush Mama,1979,Fewer than 50,20,5,2,0,3.6,71.0,,3,3,0,3,,
7461,tt0415965,Martian Child,2007,"50,000+",84569,7382,2851,4376,3.7,72.0,,110,38,72,110,5.10,35.0
7462,tt0091164,Half Moon Street,1986,"1,000+",1374,27,57,21,2.9,33.0,,6,3,3,6,5.60,50.0
7463,tt0178218,Abhinetri,1970,0,0,0,0,0,,,,0,0,0,0,,
7464,tt0268690,Thirteen Conversations About One Thing,2001,"5,000+",8339,770,319,307,3.6,71.0,,114,95,19,114,7.30,83.0
7465,tt0081368,Pray TV,1980,Fewer than 50,7,2,1,0,,,,0,0,0,0,,
7466,tt0248012,Fiza,2000,"2,500+",2670,108,73,48,3.5,60.0,,0,0,0,0,,
7467,tt2190256,Daal Mein Kuch Kaala Hai,2012,0,0,0,0,0,,,,0,0,0,0,,
7468,tt0423286,Sullan,2004,0,0,0,0,0,,,,0,0,0,0,,
7469,tt0090015,Shoah,1985,"1,000+",1544,386,12,119,4.7,97.0,,37,37,0,37,9.20,100.0
7470,tt5291040,Aamra,2006,0,0,0,0,0,,,,0,0,0,0,,
7471,tt0327071,Om Jai Jagadish,2002,500+,952,37,54,18,3.1,41.0,,0,0,0,0,,
7472,tt0117784,Sunset Park,1996,"2,500+",4355,249,50,86,4.1,83.0,,8,1,7,8,4.60,13.0
7473,tt0130444,Aimée & Jaguar,1999,500+,656,583,73,179,4.2,89.0,,49,44,5,49,7.20,90.0
7474,tt0403965,Dead End Run,2003,250+,328,18,15,10,3.3,55.0,,1,0,1,1,,
7475,tt0110181,Jane's House,1994,0,0,0,0,0,,,,0,0,0,0,,
7476,tt1286126,A.R.O.G,2008,500+,857,125,123,34,3.3,50.0,,0,0,0,0,,
7477,tt0116421,The Glimmer Man,1996,"10,000+",20816,396,639,354,2.9,38.0,,28,3,25,28,3.60,11.0
7478,tt0432267,The Cutter,2005,500+,881,27,86,45,2.6,24.0,,2,0,2,2,,
7479,tt0345841,Rainbow Bird & Monster Man,2002,0,0,0,0,0,,,,0,0,0,0,,
7480,tt0820911,"Kapag tumibok ang puso: Not once, but twice",2006,50+,84,1,0,0,,,,0,0,0,0,,
7481,tt0117577,The Search for One-eye Jimmy,1994,"1,000+",1111,66,31,39,3.7,69.0,,4,0,4,4,,
7482,tt0110455,A Man of No Importance,1994,250+,257,18,10,7,3.6,64.0,,16,13,3,16,7.00,81.0
7483,tt3133354,Addhuri,2012,Fewer than 50,4,0,1,0,,,,0,0,0,0,,
7484,tt2085930,Starship Troopers: Invasion,2012,"1,000+",1155,427,452,193,3.3,49.0,,4,0,4,4,,
7485,tt0151206,Khoon Bhari Maang,1988,100+,132,7,2,2,4,78.0,,2,2,0,2,,
7486,tt0988083,Killer Movie,2008,"1,000+",1498,2,1,2,3.3,67.0,,1,0,1,1,,
7487,tt1042974,Just Inès,2010,0,0,0,0,0,,,,0,0,0,0,,
7488,tt1327788,The Most Wonderful Time of the Year,2008,250+,329,92,45,43,3.7,67.0,,0,0,0,0,,
7489,tt0061667,First to Fight,1967,Fewer than 50,28,0,6,1,2.7,0.0,,1,1,0,1,,
7490,tt0496634,The Countess,2009,"1,000+",2071,311,445,204,3.1,41.0,,2,0,2,2,,
7491,tt0106763,"Double, Double Toil and Trouble",1993,500+,614,86,69,29,3.5,55.0,,1,0,1,1,,
7492,tt0097659,Kickboxer,1989,"50,000+",51463,2284,1260,1284,3.6,65.0,,11,4,7,11,4.40,36.0
7493,tt0106504,Calendar,1993,"1,000+",1039,120,45,45,3.9,73.0,,8,8,0,8,8.10,100.0
7494,tt1276434,Van Wilder: Freshman Year,2009,"1,000+",2337,236,517,203,2.7,31.0,,4,0,4,4,,
7495,tt0063103,How to Steal the World,1968,Fewer than 50,3,1,2,1,,,,0,0,0,0,,
7496,tt0470765,For Your Consideration,2006,"10,000+",19817,1529,2045,1817,3.1,43.0,,165,87,78,165,5.90,53.0
7497,tt1191130,Right Yaaa Wrong,2010,50+,68,9,16,9,2.9,36.0,,1,0,1,1,,
7498,tt0419372,Supervolcano,2005,100+,225,44,19,17,3.4,70.0,,0,0,0,0,,
7499,tt1251827,La maison jaune,2007,Fewer than 50,24,1,1,1,,,,0,0,0,0,,
7500,tt0056931,Children of the Damned,1964,"1,000+",1790,119,185,115,3.1,39.0,,11,8,3,11,5.50,73.0
7501,tt0069100,Please Don't Eat My Mother!,1973,0,0,0,0,0,,,,0,0,0,0,,
7502,tt0816462,Conan the Barbarian,2011,"25,000+",49225,4569,10507,3216,2.7,30.0,,153,37,116,153,4.20,24.0
7503,tt0140784,Aakhri Khat,1966,0,0,0,0,0,,,,0,0,0,0,,
7504,tt0775539,Stomp the Yard,2007,"250,000+",468017,35598,8089,21678,4.1,82.0,,89,24,65,89,4.60,27.0
7505,tt0162677,Summer of Sam,1999,"25,000+",32482,1719,1174,927,3.4,59.0,,104,52,52,104,5.50,50.0
7506,tt0076704,Shock Waves,1977,"1,000+",2293,145,217,174,3,40.0,,5,3,2,5,6.80,60.0
7507,tt0245686,Joe Dirt,2001,"250,000+",323786,6285,3630,4984,3.6,63.0,,76,7,69,76,3.10,9.0
7508,tt0250797,Unfaithful,2002,"50,000+",60207,5236,2469,2393,3.7,68.0,,165,83,82,165,5.80,50.0
7509,tt0120890,Wild Things,1998,"50,000+",93236,3560,3091,2712,3.3,54.0,,120,77,43,120,5.90,64.0
7510,tt0120238,SubUrbia,1996,"5,000+",5622,592,286,251,3.6,67.0,,25,17,8,25,6.40,68.0
7511,tt1158793,Sweet Nothing in My Ear,2008,250+,359,40,15,24,3.8,73.0,,0,0,0,0,,
7512,tt0432289,First Snow,2006,"5,000+",5707,376,537,424,3,41.0,,73,42,31,73,5.90,58.0
7513,tt0329717,Hollywood Homicide,2003,"25,000+",49664,806,2167,997,2.7,27.0,,162,48,114,162,4.70,30.0
7514,tt0270560,Our Lips Are Sealed,2000,"50,000+",51312,1002,885,653,3.3,53.0,,2,0,2,2,,
7515,tt1576402,Inuk,2010,50+,68,5,4,0,3.6,56.0,,5,4,1,5,5.90,80.0
7516,tt0345538,Kurukkante Kalyanam,1982,Fewer than 50,1,1,0,1,,,,0,0,0,0,,
7517,tt0315292,Bin Phere Hum Tere,1979,0,0,0,0,0,,,,0,0,0,0,,
7518,tt0352277,De-Lovely,2004,"10,000+",10435,941,494,646,3.6,66.0,,156,76,80,156,5.70,49.0
7519,tt0069510,The Woman Hunter,1972,250+,251,0,2,0,,,,0,0,0,0,,
7520,tt0068837,The Legend of Boggy Creek,1972,"1,000+",1452,98,121,123,3.2,44.0,,2,1,1,2,,
7521,tt0076060,Funeral for an Assassin,1974,Fewer than 50,9,0,3,2,,,,0,0,0,0,,
7522,tt0070155,The Harder They Come,1972,"5,000+",5616,722,162,335,4,82.0,,42,38,4,42,7.60,90.0
7523,tt0298131,Rosenstrasse,2003,"1,000+",1107,140,68,62,3.6,67.0,,63,35,28,63,5.70,56.0
7524,tt0985695,The Smell of Success,2009,100+,229,25,65,23,2.5,28.0,,1,0,1,1,,
7525,tt0247917,Akkada Ammayi Ikkada Abbayi,1996,0,0,0,0,0,,,,0,0,0,0,,
7526,tt0092038,Sword of Gideon,1986,"1,000+",1338,47,15,17,3.8,76.0,,0,0,0,0,,
7527,tt0452637,Lady in the Water,2006,"250,000+",419891,12776,13306,17691,3.1,49.0,,212,53,159,212,4.30,25.0
7528,tt0400743,Popeye's Voyage: The Quest for Pappy,2004,"1,000+",1891,13,14,12,3.1,48.0,,0,0,0,0,,
7529,tt0115781,Bullet,1996,50+,59,1,0,0,,,,0,0,0,0,,
7530,tt0905345,Jesse Stone: Sea Change,2007,500+,555,109,53,41,3.7,68.0,,0,0,0,0,,
7531,tt0092615,The Barbarians,1987,500+,897,92,106,81,3.1,47.0,,0,0,0,0,,
7532,tt0814005,The Amazing Truth About Queen Raquela,2008,100+,162,10,11,12,3.2,48.0,,9,4,5,9,5.50,44.0
7533,tt0158714,Lady Snowblood,1973,"10,000+",12456,991,167,418,4,86.0,,10,10,0,10,7.90,100.0
7534,tt0407732,Dirty Deeds,2005,"10,000+",13152,364,463,331,3.1,44.0,,14,1,13,14,2.80,7.0
7535,tt0407732,Dirty Deeds,2005,"10,000+",13152,364,463,331,3.1,44.0,,14,1,13,14,2.80,7.0
7536,tt0828376,Collier & Co.,2006,500+,524,20,9,19,3.7,71.0,,0,0,0,0,,
7537,tt0493129,A Get2Gether,2005,50+,53,3,4,1,2.9,43.0,,0,0,0,0,,
7538,tt0320262,Per Sollum Pillai,1987,0,0,0,0,0,,,,0,0,0,0,,
7539,tt0315983,House of Sand and Fog,2003,"25,000+",42576,5184,1065,2306,3.9,83.0,,183,136,47,183,7.10,74.0
7540,tt0470913,Sancharram,2004,50+,94,9,4,3,3.8,69.0,,0,0,0,0,,
7541,tt1127221,Not Forgotten,2009,"2,500+",4472,43,201,76,2.4,18.0,,13,2,11,13,3.20,15.0
7542,tt0069131,Follow Me,1972,0,0,0,0,0,,,,0,0,0,0,,
7543,tt0097166,Dead Bang,1989,"1,000+",2423,59,78,39,3.1,43.0,,12,4,8,12,4.60,33.0
7544,tt2428580,Suddenly It's Magic,2012,Fewer than 50,40,11,13,6,2.8,46.0,,0,0,0,0,,
7545,tt0159784,Takedown,2000,500+,554,27,21,17,3.4,56.0,,1,0,1,1,,
7546,tt0088242,Teachers,1984,"1,000+",1427,103,123,59,3.2,46.0,,33,20,13,33,5.70,61.0
7547,tt0844768,Wild West Comedy Show: 30 Days & 30 Nights - Hollywood to the Heartland,2006,"2,500+",2777,266,261,257,3.2,50.0,,88,52,36,88,6.00,59.0
7548,tt0059065,Crack in the World,1965,100+,175,24,31,20,3,44.0,,7,6,1,7,6.30,86.0
7549,tt0074157,At the Earth's Core,1976,"2,500+",2868,68,137,116,2.8,33.0,,9,3,6,9,4.80,33.0
7550,tt0308411,Interview with the Assassin,2002,"1,000+",1318,83,64,37,3.4,56.0,,57,38,19,57,6.50,67.0
7551,tt2578334,Molly Aunty Rocks,2012,Fewer than 50,17,2,4,2,2.8,33.0,,0,0,0,0,,
7552,tt0240336,Ammayane Sathyam,1993,0,0,0,0,0,,,,0,0,0,0,,
7553,tt0323633,Melvin Goes to Dinner,2003,"2,500+",2759,315,79,124,3.8,80.0,,12,12,0,12,7.30,100.0
7554,tt0107554,Menace II Society,1993,"50,000+",62817,7903,640,2219,4.4,93.0,,45,38,7,45,7.40,84.0
7555,tt0395429,"7 mujeres, 1 homosexual y Carlos",2004,0,0,0,0,0,,,,0,0,0,0,,
7556,tt0322659,Northfork,2003,"2,500+",4742,364,188,236,3.6,66.0,,103,59,44,103,6.00,57.0
7557,tt0082034,Asso,1981,50+,51,13,6,0,3.9,68.0,,0,0,0,0,,
7558,tt0102943,Slacker,1990,"10,000+",10343,2122,631,846,3.8,77.0,,45,37,8,45,7.30,82.0
7559,tt0104561,Jo Jeeta Wohi Sikandar,1992,"2,500+",4428,529,31,125,4.4,94.0,,0,0,0,0,,
7560,tt1045191,Reckless Behavior: Caught on Tape,2007,0,0,0,0,0,,,,0,0,0,0,,
7561,tt0970411,City of Ember,2008,"50,000+",64249,3271,3848,2687,3.2,46.0,,130,70,60,130,5.70,54.0
7562,tt0116002,Daayraa,1996,0,0,0,0,0,,,,0,0,0,0,,
7563,tt0411753,Geraldine's Fortune,2004,100+,200,4,2,4,3.8,67.0,,0,0,0,0,,
7564,tt1282045,Flu Bird Horror,2008,100+,181,2,26,16,1.6,7.0,,0,0,0,0,,
7565,tt0273406,Aashiq,2001,50+,90,5,4,2,3.6,56.0,,0,0,0,0,,
7566,tt2014263,Kavya's Diary,2009,0,0,0,0,0,,,,0,0,0,0,,
7567,tt0116344,Forgotten Silver,1995,"2,500+",4458,430,92,152,4,82.0,,10,10,0,10,7.50,100.0
7568,tt0108525,Wayne's World 2,1993,"250,000+",294864,8343,4913,6707,3.6,63.0,,45,27,18,45,5.80,60.0
7569,tt4246776,Manasukkul Mathappu,1988,0,0,0,0,0,,,,0,0,0,0,,
7570,tt0330181,Gacy,2003,"2,500+",4127,98,362,204,2.4,21.0,,6,1,5,6,3.80,17.0
7571,tt0498368,The Metrosexual,2007,100+,108,2,0,1,,,,0,0,0,0,,
7572,tt0108517,Warlock 2: The Armageddon,1993,"5,000+",7457,108,158,104,3.1,41.0,,5,0,5,5,2.70,0.0
7573,tt2794316,Awara,2012,0,0,0,0,0,,,,0,0,0,0,,
7574,tt0087397,Heartbreakers,1984,Fewer than 50,49,8,7,3,3.6,53.0,,10,8,2,10,7.00,80.0
7575,tt0064449,How to Commit Marriage,1969,250+,263,5,10,5,2.7,33.0,,0,0,0,0,,
7576,tt1618467,Booked Out,2012,Fewer than 50,24,3,0,1,,,,4,2,2,4,,
7577,tt0108342,Time Runner,1993,250+,419,3,45,18,1.8,6.0,,0,0,0,0,,
7578,tt0102322,Livin' Large!,1991,500+,849,12,20,8,2.9,35.0,,1,0,1,1,,
7579,tt1706687,Monumental: In Search of America's National Treasure,2012,250+,457,128,45,44,3.8,74.0,,2,1,1,2,,
7580,tt0111082,Scanner Cop,1994,500+,616,17,50,30,2.8,25.0,,2,1,1,2,,
7581,tt0069966,Detroit 9000,1973,"1,000+",1746,43,45,33,3.2,49.0,,8,2,6,8,5.30,25.0
7582,tt1032819,Powder Blue,2009,"5,000+",7430,547,814,531,2.9,40.0,,8,2,6,8,3.70,25.0
7583,tt0087428,The Hotel New Hampshire,1984,"5,000+",5398,291,285,160,3.2,51.0,,14,10,4,14,6.30,71.0
7584,tt1552173,Freak Dance,2010,50+,81,23,18,14,3.2,56.0,,0,0,0,0,,
7585,tt1034331,Righteous Kill,2008,"50,000+",90497,4539,7663,5553,2.9,37.0,,148,27,121,148,4.10,18.0
7586,tt0418004,Neverwas,2005,"2,500+",4067,640,350,431,3.6,65.0,,7,1,6,7,4.40,14.0
7587,tt0081280,One-Trick Pony,1980,100+,128,9,11,4,3.4,45.0,,1,1,0,1,,
7588,tt1648112,New Kids Turbo,2010,100+,229,90,74,22,3.3,55.0,,1,1,0,1,,
7589,tt0269389,Jalla! Jalla!,2000,"5,000+",5451,620,204,135,3.8,75.0,,9,5,4,9,5.60,56.0
7590,tt1290400,Double Identity,2009,500+,603,29,128,55,2.3,18.0,,0,0,0,0,,
7591,tt0099334,Cyrano de Bergerac,1990,"10,000+",16295,2283,245,714,4.3,90.0,,30,30,0,30,7.90,100.0
7592,tt1177939,Roxy Hunter and the Myth of the Mermaid,2008,100+,106,3,6,6,2.7,33.0,,1,1,0,1,,
7593,tt0171725,The Secret of NIMH 2: Timmy to the Rescue,1998,"5,000+",7049,65,192,110,2.2,25.0,,4,0,4,4,,
7594,tt1292655,The River Within,2009,50+,67,10,5,8,3.5,67.0,,0,0,0,0,,
7595,tt0387808,Idiocracy,2006,"50,000+",65386,11483,7540,8408,3.4,60.0,,52,37,15,52,6.40,71.0
7596,tt0210945,Remember the Titans,2000,"250,000+",578574,56433,4154,23317,4.4,93.0,,138,100,38,138,6.30,72.0
7597,tt1193096,Group Sex,2010,250+,424,43,147,37,2.6,23.0,,0,0,0,0,,
7598,tt0117422,The Quiet Room,1996,100+,140,19,7,4,3.7,73.0,,5,4,1,5,6.90,80.0
7599,tt0054847,El Cid,1961,"5,000+",5500,678,186,261,3.9,78.0,,14,13,1,14,6.90,93.0
7600,tt0270950,Flash Gordon: The Greatest Adventure of All,1982,50+,87,8,7,4,3.6,53.0,,0,0,0,0,,
7601,tt0187344,Naya Kadam,1984,0,0,0,0,0,,,,0,0,0,0,,
7602,tt0368233,Sahasa Veerudu Sagara Kanya,1996,Fewer than 50,1,1,0,0,,,,0,0,0,0,,
7603,tt0339294,Leprechaun 6: Back 2 Tha Hood,2003,"10,000+",11805,262,599,362,2.5,30.0,,10,2,8,10,4.20,20.0
7604,tt0382856,Monster Island,2004,"1,000+",1278,23,81,62,2.3,22.0,,0,0,0,0,,
7605,tt1096902,I've Fallen for You,2007,0,0,0,0,0,,,,0,0,0,0,,
7606,tt0113321,Home for the Holidays,1995,"10,000+",12485,1120,446,488,3.8,71.0,,50,32,18,50,6.20,64.0
7607,tt0058653,The Thrill Killers,1964,100+,189,5,9,6,3,36.0,,3,1,2,3,,
7608,tt0827735,Supergator,2006,100+,172,5,33,19,1.8,13.0,,0,0,0,0,,
7609,tt1559033,Prowl,2010,500+,555,58,268,99,2.3,18.0,,3,2,1,3,,
7610,tt0830575,Jetsam,2007,Fewer than 50,49,1,2,2,,,,15,8,7,15,5.10,53.0
7611,tt0960835,Transmorphers,2007,"1,000+",1484,39,331,210,1.4,11.0,,2,1,1,2,,
7612,tt0087513,Joy of Sex,1984,"1,000+",1765,50,52,17,3.1,49.0,,0,0,0,0,,
7613,tt0106945,The Forbidden Quest,1993,250+,288,8,3,6,3.7,73.0,,1,0,1,1,,
7614,tt0318850,Young Black Stallion,2003,"5,000+",6257,100,51,97,3.8,66.0,,39,17,22,39,5.50,44.0
7615,tt0093491,Mankillers,1987,250+,256,3,7,9,2.8,30.0,,0,0,0,0,,
7616,tt0944961,Naayi Neralu,2006,0,0,0,0,0,,,,0,0,0,0,,
7617,tt0295552,Rare Birds,2001,"1,000+",1354,92,41,52,3.6,69.0,,13,7,6,13,5.90,54.0
7618,tt0169905,Fiebre de amor,1985,250+,289,6,2,3,4.2,75.0,,0,0,0,0,,
7619,tt0770772,I Think I Love My Wife,2007,"100,000+",199459,3672,5203,4346,3,41.0,,116,22,94,116,4.60,19.0
7620,tt0783601,Trainwreck: My Life as an Idiot,2007,500+,737,87,172,108,2.9,34.0,,1,1,0,1,,
7621,tt0915463,Jackboots on Whitehall,2010,500+,797,36,102,47,2.5,26.0,,18,8,10,18,5.10,44.0
7622,tt4895498,Another Country,2015,Fewer than 50,11,1,0,0,,,,3,3,0,3,,
7623,tt0433692,Sepet,2004,"1,000+",1197,166,35,99,4,83.0,,1,1,0,1,,
7624,tt0094374,Righting Wrongs,1986,500+,663,42,9,22,4,82.0,,0,0,0,0,,
7625,tt0443594,Naina,2005,Fewer than 50,10,1,1,0,,,,1,0,1,1,,
7626,tt0090881,Crawlspace,1986,500+,997,46,174,90,2.5,21.0,,12,2,10,12,4.40,17.0
7627,tt0232169,Naukar Biwi Ka,1983,0,0,0,0,0,,,,0,0,0,0,,
7628,tt0119937,Prefontaine,1997,"5,000+",7367,839,240,304,4,78.0,,36,20,16,36,6.30,56.0
7629,tt0463953,The Cutting Edge: Going for the Gold,2006,"10,000+",11498,689,386,452,3.7,64.0,,1,0,1,1,,
7630,tt0084273,Love Child,1982,Fewer than 50,1,1,0,0,,,,0,0,0,0,,
7631,tt0062373,A Time for Killing,1967,250+,296,6,10,5,2.8,38.0,,1,1,0,1,,
7632,tt0105298,Running Wild,1995,50+,56,2,2,0,,,,0,0,0,0,,
7633,tt0294870,Rent,2005,"250,000+",341178,30517,6386,19708,4.1,83.0,,174,81,93,174,5.90,47.0
7634,tt0065720,Figures in a Landscape,1970,100+,123,14,18,2,3.3,44.0,,2,2,0,2,,
7635,tt0251174,Kevin of the North,2001,"1,000+",1278,31,56,33,2.7,35.0,,1,0,1,1,,
7636,tt1186367,Ninja Assassin,2009,"100,000+",189914,10307,8814,7547,3.3,54.0,,117,30,87,117,4.40,26.0
7637,tt1186367,Ninja Assassin,2009,"100,000+",189914,10307,8814,7547,3.3,54.0,,117,30,87,117,4.40,26.0
7638,tt0081968,36 Chowringhee Lane,1981,250+,310,23,7,5,4,77.0,,0,0,0,0,,
7639,tt0072403,The White Dawn,1974,"1,000+",1207,28,6,19,3.8,82.0,,3,2,1,3,,
7640,tt0362454,Blind Flight,2003,250+,427,23,3,10,4.1,88.0,,5,5,0,5,7.80,100.0
7641,tt0491162,Spiral,2007,Fewer than 50,27,5,2,2,3.8,71.0,,0,0,0,0,,
7642,tt0359281,Flag Wars,2003,Fewer than 50,30,17,13,13,3.4,57.0,,6,4,2,6,6.40,67.0
7643,tt0057541,Summer Holiday,1963,"1,000+",2404,99,46,72,3.8,68.0,,2,0,2,2,,
7644,tt0214839,Karpagam,1963,0,0,0,0,0,,,,0,0,0,0,,
7645,tt0082926,Polyester,1981,"5,000+",6786,898,213,412,4,81.0,,31,29,2,31,7.10,94.0
7646,tt0470077,Playing House,2006,250+,321,27,14,15,3.5,66.0,,0,0,0,0,,
7647,tt0397892,Bolt,2008,"250,000+",315642,22011,7912,11114,3.7,74.0,,190,171,19,190,7.20,90.0
7648,tt8116258,Thiruda Thirudi,2003,0,0,0,0,0,,,,0,0,0,0,,
7649,tt1608369,The Brides of Sodom,2013,Fewer than 50,15,4,4,4,2.4,50.0,,0,0,0,0,,
7650,tt1052017,Meet the Robinsons,2007,"250,000+",400364,21940,7677,14892,3.8,74.0,,143,96,47,143,6.40,67.0
7651,tt0079315,The Fearless Hyena,1979,"2,500+",4768,164,84,76,3.6,66.0,,4,4,0,4,,
7652,tt1396557,Winnebago Man,2009,"10,000+",19110,1127,285,337,3.8,80.0,,62,56,6,62,7.10,90.0
7653,tt0077848,Let Me Die a Woman,1977,50+,93,6,8,6,3.1,43.0,,1,1,0,1,,
7654,tt0102526,New Jack City,1991,"25,000+",45409,3286,831,1186,4,80.0,,35,28,7,35,6.70,80.0
7655,tt0478126,Cthulhu,2007,500+,785,58,141,108,2.6,29.0,,13,8,5,13,5.90,62.0
7656,tt0066064,The McKenzie Break,1970,100+,108,16,17,11,3.3,48.0,,1,0,1,1,,
7657,tt0056262,The Music Man,1962,"25,000+",30584,1742,304,935,4.2,85.0,,18,17,1,18,8.20,94.0
7658,tt1135517,Route 30,2007,50+,77,11,11,12,3.1,50.0,,0,0,0,0,,
7659,tt1126516,Money Hai Toh Honey Hai,2008,250+,345,9,49,27,2.1,16.0,,1,1,0,1,,
7660,tt0354213,Winter Solstice,2003,"1,000+",1498,71,95,63,3.1,43.0,,81,49,32,81,6.40,60.0
7661,tt10189716,Banda Paramasivam,2003,0,0,0,0,0,,,,0,0,0,0,,
7662,tt0292167,Pakshe,1994,0,0,0,0,0,,,,0,0,0,0,,
7663,tt2258583,Sevenes,2011,0,0,0,0,0,,,,0,0,0,0,,
7664,tt0072201,Stardust,1974,100+,132,16,18,9,3.3,47.0,,3,2,1,3,,
7665,tt0118800,Buried Alive II,1997,500+,885,22,41,27,2.9,35.0,,0,0,0,0,,
7666,tt0097045,Chandni,1989,500+,575,57,16,16,3.9,78.0,,1,1,0,1,,
7667,tt1209377,Beautiful Kate,2009,"10,000+",12643,269,149,154,3.5,64.0,,31,26,5,31,6.80,84.0
7668,tt0357091,Red Roses and Petrol,2003,250+,278,14,7,16,3.5,67.0,,14,1,13,14,3.90,7.0
7669,tt0061678,The Flim-Flam Man,1967,250+,274,29,16,8,3.5,64.0,,8,6,2,8,6.40,75.0
7670,tt1560747,The Master,2012,0,0,0,0,0,,,,0,0,0,0,,
7671,tt1560747,The Master,2012,0,0,0,0,0,,,,0,0,0,0,,
7672,tt0070337,Lost Horizon,1973,250+,463,47,56,49,3,46.0,,7,1,6,7,3.80,14.0
7673,tt1146285,Heaven on Earth,2008,250+,486,65,81,74,3.1,45.0,,6,4,2,6,6.80,67.0
7674,tt0321067,Ab Ke Baras,2002,250+,265,4,7,6,2.8,36.0,,0,0,0,0,,
7675,tt0069298,Something Evil,1972,250+,437,14,55,28,2.6,20.0,,0,0,0,0,,
7676,tt0089567,Le matou,1985,50+,51,7,2,1,3.7,78.0,,0,0,0,0,,
7677,tt2294769,Pokkisham,2009,Fewer than 50,4,2,0,0,,,,0,0,0,0,,
7678,tt0069089,Pink Flamingos,1972,"10,000+",20255,2625,1010,1636,3.7,72.0,,49,41,8,49,7.30,84.0
7679,tt0361596,Fahrenheit 9/11,2004,"100,000+",207941,11195,4878,7093,3.6,70.0,,236,194,42,236,7.40,82.0
7680,tt0361596,Fahrenheit 9/11,2004,"100,000+",207941,11195,4878,7093,3.6,70.0,,236,194,42,236,7.40,82.0
7681,tt0393109,Brick,2005,"100,000+",105863,19977,3321,9234,4.1,86.0,,143,114,29,143,7.10,80.0
7682,tt1266029,Nowhere Boy,2009,"25,000+",41281,4270,1480,1440,3.7,74.0,,149,119,30,149,6.90,80.0
7683,tt0095930,Purple People Eater,1988,"2,500+",4542,103,71,95,3.6,59.0,,0,0,0,0,,
7684,tt0391274,Kismat,2004,100+,210,3,5,1,2.6,38.0,,0,0,0,0,,
7685,tt0257076,S.W.A.T.,2003,"250,000+",273697,6723,6237,4895,3.3,52.0,,168,80,88,168,5.40,48.0
7686,tt0060345,How the Grinch Stole Christmas!,1966,250+,273,256,16,57,4.5,94.0,,28,28,0,28,9.10,100.0
7687,tt0089945,Rustlers' Rhapsody,1985,"1,000+",1639,123,21,71,4.2,85.0,,12,2,10,12,4.50,17.0
7688,tt1073510,Prayers for Bobby,2009,"1,000+",2311,938,148,315,4.2,86.0,,15,11,4,15,6.40,73.0
7689,tt0315459,Dallas 362,2003,"1,000+",1346,73,46,49,3.5,61.0,,18,10,8,18,5.60,56.0
7690,tt0055738,All Fall Down,1962,100+,216,28,24,20,3.4,54.0,,5,2,3,5,6.00,40.0
7691,tt0091054,Firefighter,1986,50+,73,1,0,0,,,,0,0,0,0,,
7692,tt0097758,Little Monsters,1989,"25,000+",48985,1412,876,1228,3.6,62.0,,9,4,5,9,4.50,44.0
7693,tt0340012,Being Julia,2004,"5,000+",7566,917,328,452,3.7,74.0,,124,95,29,124,6.80,77.0
7694,tt0437354,The Negotiator,1995,"100,000+",130558,8007,2135,2716,3.8,79.0,,57,42,15,57,6.70,74.0
7695,tt0479948,Living & Dying,2007,250+,461,10,86,43,2,11.0,,0,0,0,0,,
7696,tt0330342,Got 2 Believe,2002,250+,251,25,5,7,4.2,83.0,,0,0,0,0,,
7697,tt0056376,Private Potter,1964,100+,147,1,2,0,,,,1,1,0,1,,
7698,tt1297945,Skeleton Crew,2009,"2,500+",3506,18,114,60,1.9,13.0,,0,0,0,0,,
7699,tt1059256,Barbie of Swan Lake,2003,"10,000+",12123,247,170,216,3.5,60.0,,0,0,0,0,,
7700,tt1116184,Jackass 3D,2010,"50,000+",93833,13514,5974,4497,3.7,69.0,,113,75,38,113,5.90,66.0
7701,tt1365448,Dishyum,2006,0,0,0,0,0,,,,0,0,0,0,,
7702,tt0064276,Easy Rider,1969,"50,000+",58883,8525,1874,3084,4,82.0,,56,47,9,56,7.70,84.0
7703,tt1194271,Against the Dark,2009,"1,000+",1772,47,376,223,1.7,11.0,,1,0,1,1,,
7704,tt0455299,29th and Gay,2005,250+,417,17,22,18,2.7,44.0,,0,0,0,0,,
7705,tt0449488,Purple Heart,2005,50+,73,2,0,0,,,,0,0,0,0,,
7706,tt0843335,Desamuduru,2007,100+,152,11,5,2,3.5,69.0,,0,0,0,0,,
7707,tt2157186,Mallu Singh,2012,Fewer than 50,12,0,5,0,1.4,0.0,,0,0,0,0,,
7708,tt0083557,Android,1982,500+,725,54,85,55,3,38.0,,7,6,1,7,6.20,86.0
7709,tt0114906,Welcome to the Dollhouse,1995,"25,000+",33549,4317,716,1676,4.1,86.0,,54,50,4,54,7.80,93.0
7710,tt0088185,Strangers Kiss,1983,Fewer than 50,36,1,2,1,,,,3,2,1,3,,
7711,tt0067916,Up Pompeii,1971,50+,55,9,13,7,3.1,41.0,,0,0,0,0,,
7712,tt1648204,Lemonade Mouth,2011,"1,000+",1935,729,190,190,4.1,79.0,,5,4,1,5,6.40,80.0
7713,tt1436432,MegaFault,2009,500+,648,38,188,107,1.9,17.0,,2,1,1,2,,
7714,tt0841153,Rain: The Terror Within...,2005,0,0,0,0,0,,,,0,0,0,0,,
